Source Port,Destination Port,NAT Source Port,NAT Destination Port,Bytes,Bytes Sent,Bytes Received,Packets,Elapsed Time (sec),pkts_sent,pkts_received,Original_Action,Unsupervised_Prediction,Supervised_Prediction,Risk_label
51313,64147,0,0,66,66,0,1,0,1,0,deny,1,1,High Risk
49949,443,7206,443,4712,908,3804,18,89,9,9,allow,1,0,Potential Threat
64070,53,27144,53,258,110,148,2,30,1,1,allow,0,0,Normal
61279,445,0,0,66,66,0,1,0,1,0,drop,0,1,Known Attack
51983,443,27301,443,23955,4211,19744,42,46,21,21,allow,1,0,Potential Threat
56869,53,8171,53,198,94,104,2,31,1,1,allow,0,0,Normal
45184,80,27181,80,1718,1404,314,11,15,6,5,allow,1,0,Potential Threat
56443,53,60191,53,168,86,82,2,30,1,1,allow,0,0,Normal
55246,443,12271,443,6144,1810,4334,18,45,11,7,allow,1,0,Potential Threat
50979,445,0,0,70,70,0,1,0,1,0,drop,0,1,Known Attack
49991,443,60218,443,622,210,412,10,21,4,6,allow,1,0,Potential Threat
60491,38789,32066,38789,320,140,180,6,7,3,3,allow,1,0,Potential Threat
64237,53,55167,53,199,86,113,2,30,1,1,allow,0,0,Normal
52040,53,52040,53,251,98,153,2,31,1,1,allow,0,0,Normal
38664,37965,0,0,145,145,0,1,0,1,0,deny,1,1,High Risk
63316,445,0,0,70,70,0,1,0,1,0,drop,0,1,Known Attack
56514,445,0,0,70,70,0,1,0,1,0,drop,0,1,Known Attack
55750,53,13328,53,211,110,101,2,30,1,1,allow,0,0,Normal
65251,53,45927,53,183,98,85,3,31,2,1,allow,0,0,Normal
49589,80,33481,80,314,128,186,6,26,3,3,allow,0,0,Normal
12348,50265,0,0,62,62,0,1,0,1,0,deny,1,1,High Risk
58638,5900,0,0,62,62,0,1,0,1,0,deny,0,1,Known Attack
50625,445,0,0,70,70,0,1,0,1,0,drop,0,1,Known Attack
44856,51505,0,0,62,62,0,1,0,1,0,deny,0,1,Known Attack
50523,53,31491,53,199,102,97,2,30,1,1,allow,0,0,Normal
42379,443,23985,443,499,425,74,4,0,3,1,allow,0,0,Normal
64689,445,0,0,70,70,0,1,0,1,0,drop,0,1,Known Attack
49269,53,8382,53,198,110,88,2,30,1,1,allow,0,0,Normal
65344,46824,0,0,66,66,0,1,0,1,0,deny,1,1,High Risk
39569,443,5001,443,1784075,46752,1737323,1812,47,606,1206,allow,1,0,Potential Threat
47348,23,0,0,60,60,0,1,0,1,0,deny,0,1,Known Attack
47357,50584,0,0,66,66,0,1,0,1,0,deny,0,1,Known Attack
56803,53,43368,53,182,93,89,2,30,1,1,allow,0,0,Normal
51120,80,28128,80,366,240,126,7,21,5,2,allow,0,0,Normal
49192,445,0,0,70,70,0,1,0,1,0,drop,0,1,Known Attack
64406,25174,0,0,62,62,0,1,0,1,0,deny,0,1,Known Attack
59564,57470,0,0,66,66,0,1,0,1,0,deny,1,1,High Risk
31021,35440,0,0,146,146,0,1,0,1,0,deny,1,1,High Risk
57073,57470,0,0,62,62,0,1,0,1,0,deny,0,1,Known Attack
50076,445,0,0,70,70,0,1,0,1,0,drop,0,1,Known Attack
49978,53,47119,53,774,101,673,2,31,1,1,allow,0,0,Normal
61785,64147,0,0,62,62,0,1,0,1,0,deny,1,1,High Risk
2180,63710,0,0,66,66,0,1,0,1,0,deny,1,1,High Risk
56921,443,49898,443,8416,2142,6274,25,330,12,13,allow,1,0,Potential Threat
58638,5900,0,0,62,62,0,1,0,1,0,deny,0,1,Known Attack
64085,443,64085,443,140818,8751,132067,156,168,57,99,allow,1,0,Potential Threat
9745,26467,0,0,62,62,0,1,0,1,0,deny,0,1,Known Attack
50353,445,0,0,70,70,0,1,0,1,0,drop,0,1,Known Attack
37011,25174,0,0,146,146,0,1,0,1,0,deny,1,1,High Risk
65487,53,21256,53,184,94,90,2,30,1,1,allow,0,0,Normal
57083,53,56856,53,755,94,661,2,31,1,1,allow,0,0,Normal
55045,443,26442,443,5541,2778,2763,24,15,14,10,allow,1,0,Potential Threat
64031,445,0,0,70,70,0,1,0,1,0,drop,0,1,Known Attack
57851,445,0,0,70,70,0,1,0,1,0,drop,0,1,Known Attack
62323,443,8004,443,6383,2838,3545,17,135,9,8,allow,1,0,Potential Threat
55069,443,55069,443,4517,1610,2907,19,27,11,8,allow,1,0,Potential Threat
56663,53,55920,53,181,94,87,2,30,1,1,allow,0,0,Normal
64524,53,42733,53,184,94,90,2,31,1,1,allow,0,0,Normal
51975,80,44833,80,426,240,186,8,25,5,3,allow,0,0,Normal
63751,445,0,0,70,70,0,1,0,1,0,drop,0,1,Known Attack
49552,80,31507,80,1963,1067,896,11,15,6,5,allow,0,0,Normal
53077,80,56021,80,1352,625,727,8,75,5,3,allow,1,0,Potential Threat
48839,37807,0,0,62,62,0,1,0,1,0,deny,0,1,Known Attack
51017,80,29159,80,2654,796,1858,12,18,7,5,allow,0,0,Normal
36712,53,0,0,138,69,69,2,30,1,1,allow,0,0,Normal
63820,27441,46760,27441,70,70,0,1,4,1,0,allow,1,0,Potential Threat
50584,61421,62887,61421,166,166,0,1,1199,1,0,allow,1,0,Potential Threat
56288,53,3353,53,200,102,98,2,30,1,1,allow,0,0,Normal
35499,443,34865,443,2270,1303,967,20,102,11,9,allow,1,0,Potential Threat
80,56289,0,0,578,578,0,1,0,1,0,deny,1,1,High Risk
62890,993,29471,993,9624,4559,5065,88,196,45,43,allow,1,0,Potential Threat
12545,25174,0,0,146,146,0,1,0,1,0,deny,1,1,High Risk
49946,445,0,0,70,70,0,1,0,1,0,drop,0,1,Known Attack
50081,443,6983,443,18754,5240,13514,31,16,15,16,allow,1,0,Potential Threat
59850,445,0,0,66,66,0,1,0,1,0,drop,0,1,Known Attack
2321,53,2321,53,216,98,118,2,30,1,1,allow,1,0,Potential Threat
57071,53,20542,53,166,86,80,2,29,1,1,allow,0,0,Normal
58638,5900,0,0,62,62,0,1,0,1,0,deny,0,1,Known Attack
16522,26467,0,0,62,62,0,1,0,1,0,deny,0,1,Known Attack
58638,5900,58638,5900,66,66,0,1,4,1,0,allow,1,0,Potential Threat
49854,80,32743,80,14603,5117,9486,24,89,12,12,allow,1,0,Potential Threat
57590,80,57590,80,1165239,13055,1152184,977,149,193,784,allow,1,0,Potential Threat
51940,53,28110,53,199,94,105,2,30,1,1,allow,0,0,Normal
35570,443,53736,443,3297,2327,970,22,37,11,11,allow,1,0,Potential Threat
60883,64147,0,0,74,74,0,1,0,1,0,deny,1,1,High Risk
64416,53,56387,53,291,110,181,2,30,1,1,allow,0,0,Normal
42993,443,4203,443,7821,3237,4584,39,149,19,20,allow,1,0,Potential Threat
40521,23117,0,0,66,66,0,1,0,1,0,deny,0,1,Known Attack
50209,445,0,0,70,70,0,1,0,1,0,drop,0,1,Known Attack
51965,48708,39312,48708,70,70,0,2,8,2,0,allow,1,0,Potential Threat
9474,53,9474,53,237,91,146,2,33,1,1,allow,1,0,Potential Threat
52363,123,30662,123,184,94,90,2,30,1,1,allow,0,0,Normal
60312,57470,0,0,74,74,0,1,0,1,0,deny,1,1,High Risk
56019,53,28168,53,194,102,92,2,31,1,1,allow,0,0,Normal
11061,4229,0,0,145,145,0,1,0,1,0,deny,1,1,High Risk
45155,443,55125,443,4000,1726,2274,13,135,6,7,allow,1,0,Potential Threat
11458,2767,0,0,62,62,0,1,0,1,0,deny,0,1,Known Attack
56155,53,9599,53,199,102,97,2,30,1,1,allow,0,0,Normal
44979,443,39259,443,10311,2186,8125,26,186,14,12,allow,1,0,Potential Threat
60155,23718,0,0,66,66,0,1,0,1,0,deny,0,1,Known Attack
27209,30170,0,0,145,145,0,1,0,1,0,deny,1,1,High Risk
53470,22114,0,0,66,66,0,1,0,1,0,deny,0,1,Known Attack
53651,47758,20351,47758,70,70,0,2,7,2,0,allow,1,0,Potential Threat
49884,53,8513,53,252,102,150,2,30,1,1,allow,0,0,Normal
41052,443,41052,443,4596,1689,2907,19,27,11,8,allow,1,0,Potential Threat
65249,53,43445,53,733,94,639,2,30,1,1,allow,0,0,Normal
58370,443,50234,443,6277528,124223,6153305,5970,160,1890,4080,allow,1,0,Potential Threat
56336,53,53884,53,196,102,94,2,35,1,1,allow,0,0,Normal
50465,445,0,0,66,66,0,1,0,1,0,drop,0,1,Known Attack
50734,37965,0,0,62,62,0,1,0,1,0,deny,0,1,Known Attack
57131,35776,0,0,145,145,0,1,0,1,0,deny,1,1,High Risk
33822,57470,0,0,66,66,0,1,0,1,0,deny,1,1,High Risk
55040,53,40859,53,762,98,664,2,31,1,1,allow,0,0,Normal
60678,445,0,0,66,66,0,1,0,1,0,drop,0,1,Known Attack
33457,27015,0,0,67,67,0,1,0,1,0,deny,0,1,Known Attack
58638,5900,0,0,62,62,0,1,0,1,0,deny,0,1,Known Attack
64559,53,43720,53,168,86,82,2,30,1,1,allow,0,0,Normal
62550,51505,0,0,66,66,0,1,0,1,0,deny,0,1,Known Attack
50934,445,0,0,66,66,0,1,0,1,0,drop,0,1,Known Attack
55032,445,0,0,70,70,0,1,0,1,0,drop,0,1,Known Attack
65515,53,18245,53,195,102,93,2,31,1,1,allow,0,0,Normal
58923,445,0,0,70,70,0,1,0,1,0,drop,0,1,Known Attack
49432,5228,59843,5228,10635,3087,7548,41,3661,22,19,allow,1,0,Potential Threat
63085,445,0,0,66,66,0,1,0,1,0,drop,0,1,Known Attack
16327,55442,0,0,66,66,0,1,0,1,0,deny,1,1,High Risk
40786,53,0,0,82,82,0,1,30,1,0,allow,0,0,Normal
63000,445,0,0,66,66,0,1,0,1,0,drop,0,1,Known Attack
64819,445,0,0,66,66,0,1,0,1,0,drop,0,1,Known Attack
52306,445,0,0,70,70,0,1,0,1,0,drop,0,1,Known Attack
35596,5228,54963,5228,3235,1448,1787,26,811,8,18,allow,1,0,Potential Threat
61508,445,0,0,70,70,0,1,0,1,0,drop,0,1,Known Attack
62731,21247,0,0,66,66,0,1,0,1,0,deny,0,1,Known Attack
50967,445,0,0,70,70,0,1,0,1,0,drop,0,1,Known Attack
6881,37321,46991,37321,502,150,352,2,1199,1,1,allow,1,0,Potential Threat
50740,445,0,0,70,70,0,1,0,1,0,drop,0,1,Known Attack
49818,53,22415,53,211,102,109,2,29,1,1,allow,0,0,Normal
55830,53,64690,53,183,94,89,2,30,1,1,allow,1,0,Potential Threat
32618,53,32618,53,231,90,141,2,31,1,1,allow,0,0,Normal
44498,53,11053,53,168,78,90,2,30,1,1,allow,0,0,Normal
52501,80,52501,80,79714,5592,74122,102,23,45,57,allow,1,0,Potential Threat
60024,445,0,0,70,70,0,1,0,1,0,drop,0,1,Known Attack
10006,64147,0,0,62,62,0,1,0,1,0,deny,1,1,High Risk
49417,38558,0,0,66,66,0,1,0,1,0,deny,0,1,Known Attack
33886,65504,0,0,162,162,0,1,0,1,0,deny,1,1,High Risk
64697,37965,0,0,66,66,0,1,0,1,0,deny,0,1,Known Attack
22571,51505,0,0,66,66,0,1,0,1,0,deny,1,1,High Risk
63733,47013,29294,47013,70,70,0,1,5,1,0,allow,1,0,Potential Threat
9477,443,41654,443,7461,1448,6013,22,35,11,11,allow,1,0,Potential Threat
56802,80,23332,80,1559,762,797,14,30,7,7,allow,0,0,Normal
60008,443,9561,443,7060,1850,5210,35,110,21,14,allow,1,0,Potential Threat
42727,53,0,0,82,82,0,2,40,2,0,allow,0,0,Normal
40549,443,33434,443,5591,3194,2397,16,122,8,8,allow,1,0,Potential Threat
5357,32468,0,0,62,62,0,1,0,1,0,deny,1,1,High Risk
45908,33330,0,0,60,60,0,1,0,1,0,deny,0,1,Known Attack
56114,53,31669,53,194,86,108,2,30,1,1,allow,0,0,Normal
5588,5588,0,0,3562,1936,1626,48,192,24,24,allow,1,0,Potential Threat
55596,53,25789,53,194,102,92,2,31,1,1,allow,0,0,Normal
27110,22114,0,0,60,60,0,1,0,1,0,deny,0,1,Known Attack
49423,445,0,0,70,70,0,1,0,1,0,drop,0,1,Known Attack
52352,445,0,0,70,70,0,1,0,1,0,drop,0,1,Known Attack
58602,443,31018,443,3182,1568,1614,8,121,4,4,allow,1,0,Potential Threat
64244,53,29357,53,198,101,97,2,30,1,1,allow,0,0,Normal
44949,443,55206,443,190,70,120,4,15,2,2,allow,0,0,Normal
56478,53,62940,53,200,102,98,2,30,1,1,allow,1,0,Potential Threat
50191,445,0,0,70,70,0,1,0,1,0,drop,0,1,Known Attack
49831,53,63335,53,198,94,104,2,30,1,1,allow,1,0,Potential Threat
56308,53,37236,53,184,94,90,2,31,1,1,allow,0,0,Normal
60516,445,0,0,70,70,0,1,0,1,0,drop,0,1,Known Attack
53695,443,14454,443,4045,439,3606,11,15,5,6,allow,1,0,Potential Threat
51579,445,0,0,70,70,0,1,0,1,0,drop,0,1,Known Attack
37900,53,2466,53,78,78,0,1,30,1,0,allow,0,0,Normal
61829,443,61829,443,280243,73972,206271,309,206,142,167,allow,1,0,Potential Threat
45941,23386,0,0,60,60,0,1,0,1,0,deny,0,1,Known Attack
55207,445,0,0,70,70,0,1,0,1,0,drop,0,1,Known Attack
42345,443,8962,443,7593,2146,5447,21,10,12,9,allow,1,0,Potential Threat
55531,53,46307,53,216,110,106,2,30,1,1,allow,0,0,Normal
55719,13302,11300,13302,70,70,0,2,8,2,0,allow,1,0,Potential Threat
63002,22114,0,0,66,66,0,1,0,1,0,deny,0,1,Known Attack
62941,57470,0,0,74,74,0,1,0,1,0,deny,1,1,High Risk
45964,2666,0,0,60,60,0,1,0,1,0,deny,0,1,Known Attack
63495,50584,0,0,66,66,0,1,0,1,0,deny,1,1,High Risk
53978,27091,3798,27091,320,140,180,6,7,3,3,allow,1,0,Potential Threat
50613,80,39114,80,85306,4735,80571,120,22,55,65,allow,1,0,Potential Threat
58959,445,0,0,66,66,0,1,0,1,0,drop,0,1,Known Attack
57185,53,50357,53,784,94,690,2,30,1,1,allow,0,0,Normal
53634,443,2193,443,2005,1100,905,16,17,9,7,allow,1,0,Potential Threat
64219,53,14756,53,403,94,309,4,38,2,2,allow,0,0,Normal
56142,445,0,0,70,70,0,1,0,1,0,drop,0,1,Known Attack
64835,53,1399,53,200,102,98,2,30,1,1,allow,0,0,Normal
55895,445,0,0,70,70,0,1,0,1,0,drop,0,1,Known Attack
55087,445,0,0,66,66,0,1,0,1,0,drop,0,1,Known Attack
35207,22114,0,0,146,146,0,1,0,1,0,deny,1,1,High Risk
60394,11136,28099,11136,7512,2276,5236,39,94,21,18,allow,1,0,Potential Threat
46557,57866,0,0,62,62,0,1,0,1,0,deny,1,1,High Risk
54598,53,30660,53,168,78,90,2,30,1,1,allow,0,0,Normal
50990,23884,0,0,66,66,0,1,0,1,0,deny,0,1,Known Attack
53126,445,0,0,70,70,0,1,0,1,0,drop,0,1,Known Attack
57606,445,0,0,70,70,0,1,0,1,0,drop,0,1,Known Attack
49332,53,35822,53,276,118,158,2,30,1,1,allow,0,0,Normal
1865,25174,0,0,146,146,0,1,0,1,0,deny,1,1,High Risk
56101,57470,0,0,66,66,0,1,0,1,0,deny,0,1,Known Attack
49508,443,35365,443,4151,1015,3136,16,27,8,8,allow,1,0,Potential Threat
57306,53,25248,53,177,94,83,2,29,1,1,allow,0,0,Normal
50139,443,27090,443,72523,5814,66709,125,255,61,64,allow,1,0,Potential Threat
51793,80,57988,80,3960,2330,1630,18,47,11,7,allow,1,0,Potential Threat
49926,53,63439,53,180,94,86,2,30,1,1,allow,1,0,Potential Threat
48978,25174,0,0,66,66,0,1,0,1,0,deny,0,1,Known Attack
58638,5900,0,0,62,62,0,1,0,1,0,deny,0,1,Known Attack
56951,443,11252,443,5601,1203,4398,14,60,9,5,allow,1,0,Potential Threat
56655,443,7969,443,1272,876,396,10,26,6,4,allow,1,0,Potential Threat
62578,53,27363,53,343,168,175,3,30,2,1,allow,0,0,Normal
47808,53,24079,53,168,78,90,2,30,1,1,allow,0,0,Normal
15933,64147,0,0,62,62,0,1,0,1,0,deny,1,1,High Risk
62133,445,0,0,70,70,0,1,0,1,0,drop,0,1,Known Attack
23270,443,23270,443,5802,2592,3210,24,76,14,10,allow,1,0,Potential Threat
49573,443,42644,443,111881,6152,105729,137,139,51,86,allow,1,0,Potential Threat
37571,53,19977,53,164,78,86,2,30,1,1,allow,0,0,Normal
64029,53,26038,53,180,94,86,2,30,1,1,allow,0,0,Normal
56139,53,55354,53,306,94,212,2,30,1,1,allow,0,0,Normal
55752,53,39716,53,177,94,83,2,30,1,1,allow,0,0,Normal
38329,80,52994,80,350,210,140,6,16,4,2,allow,0,0,Normal
52903,445,0,0,70,70,0,1,0,1,0,drop,0,1,Known Attack
50387,80,54775,80,8105,3187,4918,18,24,9,9,allow,1,0,Potential Threat
54977,443,65082,443,263411,11905,251506,318,144,118,200,allow,1,0,Potential Threat
64178,53,3511,53,276,94,182,2,30,1,1,allow,0,0,Normal
58061,80,39603,80,5571,2637,2934,23,75,12,11,allow,1,0,Potential Threat
49224,80,15279,80,2999,2271,728,11,15,6,5,allow,0,0,Normal
55620,30188,0,0,66,66,0,1,0,1,0,deny,0,1,Known Attack
49880,445,0,0,70,70,0,1,0,1,0,drop,0,1,Known Attack
58188,445,0,0,70,70,0,1,0,1,0,drop,0,1,Known Attack
51324,11392,0,0,66,66,0,1,0,1,0,deny,0,1,Known Attack
10151,11809,51182,11809,481,150,331,2,1200,1,1,allow,1,0,Potential Threat
50589,53,50328,53,733,85,648,2,30,1,1,allow,0,0,Normal
59168,39004,0,0,62,62,0,1,0,1,0,deny,0,1,Known Attack
47832,443,4961,443,130090,7064,123026,184,200,92,92,allow,1,0,Potential Threat
13413,44847,0,0,66,66,0,1,0,1,0,deny,1,1,High Risk
49620,53,32011,53,198,110,88,2,30,1,1,allow,0,0,Normal
56592,53,10104,53,200,102,98,2,31,1,1,allow,0,0,Normal
55770,64147,0,0,66,66,0,1,0,1,0,deny,1,1,High Risk
49210,53,44765,53,183,94,89,2,30,1,1,allow,0,0,Normal
64900,53,55374,53,778,103,675,2,30,1,1,allow,1,0,Potential Threat
41472,443,2469,443,4500,2769,1731,29,80,14,15,allow,1,0,Potential Threat
5121,35440,0,0,62,62,0,1,0,1,0,deny,1,1,High Risk
57617,80,57617,80,542818,11392,531426,466,25,106,360,allow,1,0,Potential Threat
65486,53,61924,53,216,102,114,2,30,1,1,allow,1,0,Potential Threat
15105,25174,0,0,146,146,0,1,0,1,0,deny,1,1,High Risk
63814,81,0,0,60,60,0,1,0,1,0,deny,0,1,Known Attack
49558,445,0,0,66,66,0,1,0,1,0,drop,0,1,Known Attack
65025,53,29192,53,786,110,676,2,29,1,1,allow,0,0,Normal
49505,53,46670,53,232,110,122,2,30,1,1,allow,0,0,Normal
49271,53,54358,53,186,102,84,2,30,1,1,allow,0,0,Normal
62705,445,0,0,70,70,0,1,0,1,0,drop,0,1,Known Attack
46901,26672,0,0,60,60,0,1,0,1,0,deny,0,1,Known Attack
64811,53,21833,53,193,102,91,2,30,1,1,allow,0,0,Normal
56143,3389,56143,3389,4365,2581,1784,20,32,11,9,allow,1,0,Potential Threat
55674,48870,28202,48870,70,70,0,1,5,1,0,allow,1,0,Potential Threat
64313,445,0,0,70,70,0,1,0,1,0,drop,0,1,Known Attack
33583,443,54351,443,479444,14906,464538,489,62,173,316,allow,1,0,Potential Threat
61278,445,0,0,70,70,0,1,0,1,0,drop,0,1,Known Attack
10128,443,36900,443,22677,11756,10921,45,315,26,19,allow,1,0,Potential Threat
50439,80,32782,80,318,192,126,6,26,4,2,allow,0,0,Normal
53671,60416,30870,60416,70,70,0,1,4,1,0,allow,1,0,Potential Threat
53377,445,0,0,70,70,0,1,0,1,0,drop,0,1,Known Attack
55934,53,39869,53,196,102,94,2,31,1,1,allow,0,0,Normal
48753,80,48753,80,19937,2162,17775,36,24,19,17,allow,1,0,Potential Threat
50112,445,0,0,70,70,0,1,0,1,0,drop,0,1,Known Attack
53497,445,0,0,66,66,0,1,0,1,0,drop,0,1,Known Attack
64852,53,7184,53,248,102,146,2,29,1,1,allow,0,0,Normal
25015,64147,0,0,66,66,0,1,0,1,0,deny,1,1,High Risk
43482,443,29764,443,2316,1280,1036,20,278,11,9,allow,1,0,Potential Threat
50448,443,40818,443,1119,595,524,12,26,6,6,allow,1,0,Potential Threat
28754,50584,0,0,66,66,0,1,0,1,0,deny,1,1,High Risk
60609,445,0,0,70,70,0,1,0,1,0,drop,0,1,Known Attack
56006,23,0,0,60,60,0,1,0,1,0,deny,0,1,Known Attack
26989,80,26989,80,256062,8754,247308,297,18,124,173,allow,1,0,Potential Threat
55989,53,12123,53,198,102,96,2,30,1,1,allow,0,0,Normal
59634,445,0,0,70,70,0,1,0,1,0,drop,0,1,Known Attack
54242,443,22470,443,499,425,74,4,0,3,1,allow,0,0,Normal
64493,53,34209,53,280,97,183,4,59,2,2,allow,0,0,Normal
49172,53,32719,53,227,102,125,2,29,1,1,allow,0,0,Normal
62593,7010,62593,7010,4231,2106,2125,15,15,8,7,allow,1,0,Potential Threat
53930,445,0,0,70,70,0,1,0,1,0,drop,0,1,Known Attack
61209,445,0,0,66,66,0,1,0,1,0,drop,0,1,Known Attack
64846,445,0,0,66,66,0,1,0,1,0,drop,0,1,Known Attack
50665,445,0,0,66,66,0,1,0,1,0,drop,0,1,Known Attack
60161,445,0,0,70,70,0,1,0,1,0,drop,0,1,Known Attack
52543,445,0,0,66,66,0,1,0,1,0,drop,0,1,Known Attack
56131,37807,0,0,62,62,0,1,0,1,0,deny,0,1,Known Attack
45109,443,1117,443,11156,3899,7257,31,234,17,14,allow,1,0,Potential Threat
7110,25174,0,0,66,66,0,1,0,1,0,deny,1,1,High Risk
2037,23,2037,23,152,66,86,2,10,1,1,allow,1,0,Potential Threat
51780,21130,9712,21130,70,70,0,2,8,2,0,allow,1,0,Potential Threat
51394,445,0,0,70,70,0,1,0,1,0,drop,0,1,Known Attack
64951,53,50176,53,402,118,284,2,30,1,1,allow,0,0,Normal
34306,37965,0,0,62,62,0,1,0,1,0,deny,0,1,Known Attack
5588,5588,0,0,3354,1792,1562,46,192,23,23,allow,1,0,Potential Threat
63130,445,0,0,70,70,0,1,0,1,0,drop,0,1,Known Attack
16387,61049,0,0,60,60,0,1,0,1,0,deny,1,1,High Risk
65283,53,11652,53,333,102,231,2,29,1,1,allow,0,0,Normal
62466,53,62466,53,194,87,107,2,30,1,1,allow,1,0,Potential Threat
1091,37965,0,0,62,62,0,1,0,1,0,deny,1,1,High Risk
58894,443,56665,443,354,294,60,2,4,1,1,allow,0,0,Normal
2849,30188,0,0,66,66,0,1,0,1,0,deny,1,1,High Risk
44131,443,6596,443,6582,1943,4639,14,122,7,7,allow,1,0,Potential Threat
35269,61903,0,0,145,145,0,1,0,1,0,deny,1,1,High Risk
49767,53,48677,53,200,102,98,2,30,1,1,allow,0,0,Normal
51837,37610,19513,37610,316,136,180,6,5,3,3,allow,1,0,Potential Threat
55163,53,35742,53,194,99,95,2,31,1,1,allow,0,0,Normal
49912,445,0,0,70,70,0,1,0,1,0,drop,0,1,Known Attack
64296,53,31060,53,215,94,121,2,29,1,1,allow,0,0,Normal
55239,53,38143,53,272,94,178,2,30,1,1,allow,0,0,Normal
32299,40034,44134,40034,253,190,63,2,31,1,1,allow,1,0,Potential Threat
56745,80,35194,80,214,140,74,4,25,3,1,allow,0,0,Normal
60384,64147,0,0,62,62,0,1,0,1,0,deny,1,1,High Risk
49181,2710,53031,2710,70,70,0,2,8,2,0,allow,1,0,Potential Threat
60806,51050,0,0,62,62,0,1,0,1,0,deny,1,1,High Risk
52359,443,35892,443,13972,2550,11422,29,954,11,18,allow,1,0,Potential Threat
53661,34967,21536,34967,70,70,0,2,8,2,0,allow,1,0,Potential Threat
58841,443,62984,443,5168,700,4468,16,15,7,9,allow,1,0,Potential Threat
3964,51505,0,0,62,62,0,1,0,1,0,deny,1,1,High Risk
54961,53,55140,53,375,99,276,4,54,2,2,allow,0,0,Normal
51548,80,13460,80,1861,1219,642,10,15,5,5,allow,1,0,Potential Threat
63602,445,0,0,70,70,0,1,0,1,0,drop,0,1,Known Attack
53403,443,55979,443,38342,14090,24252,83,159,40,43,allow,1,0,Potential Threat
50466,80,50466,80,78335,7114,71221,114,22,60,54,allow,1,0,Potential Threat
50460,445,0,0,70,70,0,1,0,1,0,drop,0,1,Known Attack
49800,53,17712,53,87,87,0,1,30,1,0,allow,0,0,Normal
50656,445,0,0,70,70,0,1,0,1,0,drop,0,1,Known Attack
56599,80,32983,80,234,234,0,4,12,4,0,allow,0,0,Normal
9731,64147,0,0,62,62,0,1,0,1,0,deny,1,1,High Risk
52097,23279,1789,23279,70,70,0,1,5,1,0,allow,1,0,Potential Threat
37555,16384,64075,16384,432,192,240,8,30,4,4,allow,1,0,Potential Threat
64144,53,47875,53,193,102,91,2,30,1,1,allow,0,0,Normal
57987,56125,0,0,90,90,0,1,0,1,0,deny,1,1,High Risk
53528,20485,38765,20485,70,70,0,2,7,2,0,allow,1,0,Potential Threat
30644,25174,0,0,62,62,0,1,0,1,0,deny,0,1,Known Attack
27005,27020,57425,27020,890,126,764,2,30,1,1,allow,1,0,Potential Threat
63201,53,63201,53,262,106,156,2,32,1,1,allow,1,0,Potential Threat
46500,443,37783,443,494,280,214,8,29,5,3,allow,0,0,Normal
56279,445,0,0,70,70,0,1,0,1,0,drop,0,1,Known Attack
40216,443,24772,443,10196,2175,8021,25,186,14,11,allow,1,0,Potential Threat
8760,22114,0,0,66,66,0,1,0,1,0,deny,0,1,Known Attack
16071,53,16071,53,832,106,726,2,30,1,1,allow,1,0,Potential Threat
60420,445,0,0,70,70,0,1,0,1,0,drop,0,1,Known Attack
65529,53,12629,53,199,102,97,2,30,1,1,allow,0,0,Normal
59696,57470,0,0,62,62,0,1,0,1,0,deny,1,1,High Risk
65199,53,15810,53,215,94,121,2,30,1,1,allow,0,0,Normal
49494,445,0,0,66,66,0,1,0,1,0,drop,0,1,Known Attack
61563,37807,0,0,66,66,0,1,0,1,0,deny,0,1,Known Attack
61304,443,62811,443,8594,1042,7552,16,120,7,9,allow,1,0,Potential Threat
37202,53,37202,53,216,90,126,2,30,1,1,allow,0,0,Normal
52437,445,0,0,70,70,0,1,0,1,0,drop,0,1,Known Attack
57470,51413,27069,51413,807,275,532,4,1200,2,2,allow,1,0,Potential Threat
56184,53,63317,53,215,94,121,2,30,1,1,allow,1,0,Potential Threat
53971,50265,0,0,66,66,0,1,0,1,0,deny,0,1,Known Attack
65130,53,36063,53,266,110,156,2,30,1,1,allow,0,0,Normal
64231,445,0,0,70,70,0,1,0,1,0,drop,0,1,Known Attack
49160,13917,61966,13917,150,150,0,1,1201,1,0,allow,1,0,Potential Threat
51071,445,0,0,66,66,0,1,0,1,0,drop,0,1,Known Attack
55634,58846,20945,58846,70,70,0,1,5,1,0,allow,1,0,Potential Threat
56979,53,3476,53,180,94,86,2,30,1,1,allow,0,0,Normal
37132,443,37132,443,4381,1474,2907,19,27,11,8,allow,1,0,Potential Threat
53076,443,8791,443,96850,6037,90813,150,177,55,95,allow,1,0,Potential Threat
51925,29587,42996,29587,70,70,0,2,8,2,0,allow,1,0,Potential Threat
2305,35440,0,0,62,62,0,1,0,1,0,deny,1,1,High Risk
56245,53,14605,53,200,102,98,2,30,1,1,allow,0,0,Normal
58662,53,17171,53,167,78,89,2,31,1,1,allow,0,0,Normal
3341,23117,0,0,62,62,0,1,0,1,0,deny,1,1,High Risk
49917,445,0,0,70,70,0,1,0,1,0,drop,0,1,Known Attack
56589,53,35173,53,199,102,97,2,30,1,1,allow,0,0,Normal
40358,443,63081,443,626,352,274,10,16,6,4,allow,1,0,Potential Threat
38476,161,0,0,3304,1560,1744,18,30,9,9,allow,1,0,Potential Threat
33305,54532,0,0,60,60,0,1,0,1,0,deny,1,1,High Risk
49265,53,12727,53,181,94,87,2,31,1,1,allow,0,0,Normal
49568,443,30225,443,6408,2531,3877,21,16,11,10,allow,1,0,Potential Threat
55238,21247,0,0,62,62,0,1,0,1,0,deny,0,1,Known Attack
64617,53,32317,53,756,95,661,2,30,1,1,allow,0,0,Normal
55745,53,20797,53,199,102,97,2,30,1,1,allow,0,0,Normal
56704,53,10036,53,194,102,92,2,31,1,1,allow,0,0,Normal
56322,80,56322,80,27189,4515,22674,34,23,14,20,allow,1,0,Potential Threat
6666,8888,0,0,60,60,0,1,0,1,0,deny,0,1,Known Attack
51358,445,0,0,70,70,0,1,0,1,0,drop,0,1,Known Attack
53727,53,60009,53,172,72,100,2,30,1,1,allow,0,0,Normal
56929,53,47625,53,177,94,83,2,30,1,1,allow,0,0,Normal
50864,80,3838,80,1888,1814,74,10,15,9,1,allow,1,0,Potential Threat
26239,25174,0,0,66,66,0,1,0,1,0,deny,0,1,Known Attack
56862,443,9641,443,7819,1662,6157,20,76,11,9,allow,1,0,Potential Threat
55542,443,7716,443,11550,3336,8214,52,130,25,27,allow,1,0,Potential Threat
56596,53,43071,53,194,102,92,2,30,1,1,allow,0,0,Normal
50595,445,0,0,66,66,0,1,0,1,0,drop,0,1,Known Attack
56812,53,46886,53,767,102,665,2,30,1,1,allow,0,0,Normal
60501,445,0,0,70,70,0,1,0,1,0,drop,0,1,Known Attack
42285,57470,0,0,62,62,0,1,0,1,0,deny,0,1,Known Attack
1025,35447,0,0,62,62,0,1,0,1,0,deny,1,1,High Risk
58638,5900,0,0,62,62,0,1,0,1,0,deny,0,1,Known Attack
49558,53,61450,53,184,94,90,2,29,1,1,allow,0,0,Normal
64811,53,57822,53,314,97,217,4,47,2,2,allow,1,0,Potential Threat
49857,80,39166,80,7800,1743,6057,20,89,11,9,allow,1,0,Potential Threat
48082,443,55722,443,5619,885,4734,17,26,9,8,allow,1,0,Potential Threat
58809,445,0,0,66,66,0,1,0,1,0,deny,0,1,Known Attack
51317,443,42808,443,3565,640,2925,16,153,7,9,allow,1,0,Potential Threat
58557,443,4317,443,114852,43911,70941,248,69,132,116,allow,1,0,Potential Threat
57333,53,36710,53,167,86,81,2,31,1,1,allow,0,0,Normal
52043,443,36100,443,7847,1904,5943,21,361,10,11,allow,1,0,Potential Threat
55353,53,1525,53,168,86,82,2,30,1,1,allow,0,0,Normal
8592,35993,0,0,62,62,0,1,0,1,0,deny,1,1,High Risk
37639,53,37639,53,245,106,139,2,29,1,1,allow,0,0,Normal
38700,443,57335,443,90113,3417,86696,95,16,30,65,allow,1,0,Potential Threat
62225,445,0,0,70,70,0,1,0,1,0,drop,0,1,Known Attack
56692,443,45896,443,7914,1925,5989,20,15,11,9,allow,1,0,Potential Threat
53640,443,55622,443,3201,1057,2144,13,135,6,7,allow,1,0,Potential Threat
54197,443,1352,443,499,425,74,4,0,3,1,allow,0,0,Normal
52087,445,0,0,66,66,0,1,0,1,0,drop,0,1,Known Attack
55866,53,0,0,86,86,0,1,30,1,0,allow,0,0,Normal
42298,40001,24361,40001,140,78,62,2,31,1,1,allow,1,0,Potential Threat
58638,5900,0,0,62,62,0,1,0,1,0,deny,0,1,Known Attack
52611,9571,0,0,62,62,0,1,0,1,0,deny,0,1,Known Attack
45363,23,0,0,60,60,0,1,0,1,0,deny,0,1,Known Attack
60421,6882,64164,6882,70,70,0,2,8,2,0,allow,1,0,Potential Threat
57269,445,0,0,70,70,0,1,0,1,0,drop,0,1,Known Attack
58881,443,10013,443,1413,876,537,12,26,6,6,allow,1,0,Potential Threat
61117,445,0,0,66,66,0,1,0,1,0,drop,0,1,Known Attack
64205,53,47320,53,178,94,84,2,31,1,1,allow,0,0,Normal
49995,53,30507,53,197,102,95,2,33,1,1,allow,0,0,Normal
7364,50584,0,0,66,66,0,1,0,1,0,deny,1,1,High Risk
50498,80,12035,80,312,192,120,6,25,4,2,allow,0,0,Normal
49605,53,37521,53,239,110,129,2,30,1,1,allow,0,0,Normal
60900,53,31593,53,181,86,95,2,30,1,1,allow,0,0,Normal
56134,53,7161,53,167,86,81,2,30,1,1,allow,0,0,Normal
65038,53,49241,53,173,94,79,2,31,1,1,allow,0,0,Normal
50612,443,9041,443,6782,3367,3415,25,139,15,10,allow,1,0,Potential Threat
54534,443,41952,443,7153,2581,4572,28,74,15,13,allow,1,0,Potential Threat
50265,6881,13047,6881,491,150,341,2,1200,1,1,allow,1,0,Potential Threat
58113,3389,58113,3389,4245,2461,1784,18,33,9,9,allow,1,0,Potential Threat
50682,445,0,0,66,66,0,1,0,1,0,drop,0,1,Known Attack
54977,445,0,0,70,70,0,1,0,1,0,drop,0,1,Known Attack
56712,46824,0,0,62,62,0,1,0,1,0,deny,0,1,Known Attack
58638,5900,58638,5900,126,62,64,2,5,1,1,allow,1,0,Potential Threat
65031,53,49062,53,184,94,90,2,31,1,1,allow,0,0,Normal
56998,53,58740,53,177,94,83,2,29,1,1,allow,0,0,Normal
2705,37,0,0,60,60,0,1,0,1,0,deny,1,1,High Risk
53616,445,0,0,70,70,0,1,0,1,0,drop,0,1,Known Attack
55358,445,0,0,70,70,0,1,0,1,0,drop,0,1,Known Attack
54778,445,0,0,66,66,0,1,0,1,0,drop,0,1,Known Attack
27005,27014,39253,27014,882,126,756,2,30,1,1,allow,1,0,Potential Threat
55587,43890,0,0,66,66,0,1,0,1,0,deny,0,1,Known Attack
57908,445,0,0,66,66,0,1,0,1,0,drop,0,1,Known Attack
50270,443,3425,443,868,514,354,13,18,8,5,allow,1,0,Potential Threat
61675,443,61675,443,8512,2483,6029,21,18,12,9,allow,1,0,Potential Threat
55225,11392,0,0,66,66,0,1,0,1,0,deny,0,1,Known Attack
49842,443,3993,443,6212,1823,4389,16,75,9,7,allow,1,0,Potential Threat
50328,53,20316,53,783,96,687,2,30,1,1,allow,0,0,Normal
63287,44847,0,0,62,62,0,1,0,1,0,deny,1,1,High Risk
52061,80,7969,80,366,240,126,7,25,5,2,allow,0,0,Normal
22013,53,22013,53,198,90,108,2,30,1,1,allow,0,0,Normal
57143,53,50787,53,184,94,90,2,30,1,1,allow,0,0,Normal
64132,53,49481,53,179,94,85,2,29,1,1,allow,0,0,Normal
443,45788,0,0,199,199,0,1,0,1,0,deny,1,1,High Risk
5379,37965,0,0,66,66,0,1,0,1,0,deny,1,1,High Risk
60443,445,0,0,70,70,0,1,0,1,0,drop,0,1,Known Attack
55896,53,45886,53,184,94,90,2,31,1,1,allow,0,0,Normal
14914,443,14914,443,16960,1347,15613,28,17,10,18,allow,1,0,Potential Threat
55239,443,1727,443,9352,2524,6828,27,46,14,13,allow,1,0,Potential Threat
50584,6881,19659,6881,161,161,0,2,1200,2,0,allow,1,0,Potential Threat
53722,445,0,0,70,70,0,1,0,1,0,drop,0,1,Known Attack
51184,445,0,0,70,70,0,1,0,1,0,drop,0,1,Known Attack
46324,443,40837,443,24465,3945,20520,39,18,18,21,allow,1,0,Potential Threat
9414,443,33463,443,5689,501,5188,14,15,7,7,allow,1,0,Potential Threat
57770,445,0,0,70,70,0,1,0,1,0,drop,0,1,Known Attack
53816,445,0,0,66,66,0,1,0,1,0,drop,0,1,Known Attack
23276,443,23276,443,4668,1745,2923,21,76,12,9,allow,1,0,Potential Threat
57252,53,53666,53,183,94,89,2,30,1,1,allow,0,0,Normal
15986,8000,55850,8000,212,150,62,2,30,1,1,allow,1,0,Potential Threat
61669,445,0,0,70,70,0,1,0,1,0,drop,0,1,Known Attack
64841,53,21377,53,173,94,79,2,30,1,1,allow,0,0,Normal
57746,15000,19364,15000,130,70,60,2,6,1,1,allow,1,0,Potential Threat
3667,56205,0,0,146,146,0,1,0,1,0,deny,1,1,High Risk
61078,57470,0,0,62,62,0,1,0,1,0,deny,1,1,High Risk
26900,27017,2558,27017,422,164,258,6,30,3,3,allow,1,0,Potential Threat
17176,443,17176,443,6311,1229,5082,18,16,8,10,allow,1,0,Potential Threat
45898,443,17048,443,814431,31637,782794,913,315,346,567,allow,1,0,Potential Threat
65194,53,28428,53,196,94,102,2,29,1,1,allow,0,0,Normal
65155,53,8256,53,295,103,192,4,48,2,2,allow,0,0,Normal
49418,27015,63577,27015,71,71,0,1,30,1,0,allow,1,0,Potential Threat
51784,34568,52434,34568,66,66,0,1,5,1,0,allow,1,0,Potential Threat
49608,80,59432,80,145752,3240,142512,128,61,23,105,allow,1,0,Potential Threat
64511,445,0,0,70,70,0,1,0,1,0,drop,0,1,Known Attack
63714,445,0,0,70,70,0,1,0,1,0,drop,0,1,Known Attack
61589,445,0,0,66,66,0,1,0,1,0,drop,0,1,Known Attack
45373,443,33904,443,33357,26315,7042,65,273,38,27,allow,1,0,Potential Threat
53777,62955,35330,62955,70,70,0,2,7,2,0,allow,1,0,Potential Threat
63364,57470,0,0,66,66,0,1,0,1,0,deny,1,1,High Risk
10151,1042,12380,1042,490,149,341,2,1200,1,1,allow,1,0,Potential Threat
68,67,0,0,594,594,0,1,0,1,0,deny,1,1,High Risk
49334,53,34104,53,194,102,92,2,30,1,1,allow,0,0,Normal
55043,57470,0,0,78,78,0,1,0,1,0,deny,1,1,High Risk
0,0,0,0,480,244,236,4,0,2,2,allow,1,0,Potential Threat
52931,443,32527,443,23112,6278,16834,140,115,55,85,allow,1,0,Potential Threat
56183,53,29912,53,179,94,85,2,31,1,1,allow,0,0,Normal
54712,445,0,0,66,66,0,1,0,1,0,drop,0,1,Known Attack
30129,37965,0,0,72,72,0,1,0,1,0,deny,0,1,Known Attack
36430,443,7560,443,9423,2105,7318,31,26,16,15,allow,1,0,Potential Threat
51637,443,21678,443,3110,1049,2061,14,136,7,7,allow,1,0,Potential Threat
52007,445,0,0,66,66,0,1,0,1,0,drop,0,1,Known Attack
37887,22114,0,0,66,66,0,1,0,1,0,deny,0,1,Known Attack
13120,25174,0,0,62,62,0,1,0,1,0,deny,0,1,Known Attack
49324,443,52610,443,6147,943,5204,17,16,9,8,allow,1,0,Potential Threat
57689,445,0,0,70,70,0,1,0,1,0,drop,0,1,Known Attack
44774,22114,0,0,62,62,0,1,0,1,0,deny,0,1,Known Attack
55703,13836,63794,13836,70,70,0,1,5,1,0,allow,1,0,Potential Threat
56841,443,47510,443,156805,44621,112184,289,215,137,152,allow,1,0,Potential Threat
26900,27017,27524,27017,422,164,258,6,30,3,3,allow,1,0,Potential Threat
53486,445,0,0,70,70,0,1,0,1,0,drop,0,1,Known Attack
47910,7464,0,0,60,60,0,1,0,1,0,deny,0,1,Known Attack
57422,53,31757,53,821,102,719,2,30,1,1,allow,0,0,Normal
58633,445,0,0,70,70,0,1,0,1,0,drop,0,1,Known Attack
65141,445,0,0,70,70,0,1,0,1,0,drop,0,1,Known Attack
63779,26467,0,0,62,62,0,1,0,1,0,deny,0,1,Known Attack
55468,23,0,0,60,60,0,1,0,1,0,deny,0,1,Known Attack
58977,37965,0,0,66,66,0,1,0,1,0,deny,0,1,Known Attack
50893,443,25118,443,9452,1832,7620,20,130,10,10,allow,1,0,Potential Threat
42252,33303,0,0,60,60,0,1,0,1,0,deny,0,1,Known Attack
51522,443,43510,443,190,70,120,4,15,2,2,allow,0,0,Normal
43747,22114,0,0,66,66,0,1,0,1,0,deny,0,1,Known Attack
55392,445,0,0,70,70,0,1,0,1,0,drop,0,1,Known Attack
61273,443,61273,443,8480,2451,6029,21,17,12,9,allow,1,0,Potential Threat
45218,25174,0,0,146,146,0,1,0,1,0,deny,1,1,High Risk
49390,1433,0,0,60,60,0,1,0,1,0,deny,0,1,Known Attack
57373,445,0,0,70,70,0,1,0,1,0,drop,0,1,Known Attack
56660,53,3127,53,338,110,228,2,30,1,1,allow,0,0,Normal
62075,443,48853,443,9318,3002,6316,28,46,16,12,allow,1,0,Potential Threat
60815,443,60815,443,1320,685,635,14,181,7,7,allow,1,0,Potential Threat
37712,443,12957,443,7660,2239,5421,32,255,16,16,allow,1,0,Potential Threat
56006,53,47168,53,210,102,108,2,30,1,1,allow,0,0,Normal
64298,53,48284,53,311,118,193,2,30,1,1,allow,0,0,Normal
55112,53,21380,53,245,94,151,2,30,1,1,allow,0,0,Normal
443,20995,0,0,83,83,0,1,0,1,0,deny,1,1,High Risk
53947,867,53640,867,70,70,0,2,8,2,0,allow,0,0,Normal
55097,53,65390,53,170,87,83,2,31,1,1,allow,1,0,Potential Threat
54858,445,0,0,70,70,0,1,0,1,0,drop,0,1,Known Attack
53077,443,54152,443,6173,924,5249,18,177,10,8,allow,1,0,Potential Threat
50313,445,0,0,66,66,0,1,0,1,0,drop,0,1,Known Attack
5228,3434,0,0,1093,1093,0,1,0,1,0,deny,1,1,High Risk
48786,443,62894,443,7130,1890,5240,25,33,12,13,allow,1,0,Potential Threat
63710,445,0,0,70,70,0,1,0,1,0,drop,0,1,Known Attack
58372,445,0,0,66,66,0,1,0,1,0,drop,0,1,Known Attack
51414,22,0,0,60,60,0,1,0,1,0,deny,0,1,Known Attack
55233,445,0,0,70,70,0,1,0,1,0,drop,0,1,Known Attack
61800,445,0,0,66,66,0,1,0,1,0,drop,0,1,Known Attack
58327,445,0,0,66,66,0,1,0,1,0,drop,0,1,Known Attack
5223,59023,0,0,66,66,0,1,0,1,0,deny,1,1,High Risk
54684,37965,0,0,62,62,0,1,0,1,0,deny,0,1,Known Attack
49940,80,46739,80,1130,613,517,11,15,6,5,allow,0,0,Normal
56844,443,48471,443,10878,4815,6063,60,196,31,29,allow,1,0,Potential Threat
52164,443,52164,443,20480,2066,18414,37,17,19,18,allow,1,0,Potential Threat
8734,56205,0,0,66,66,0,1,0,1,0,deny,1,1,High Risk
64868,53,56069,53,216,102,114,2,30,1,1,allow,0,0,Normal
65512,44847,0,0,66,66,0,1,0,1,0,deny,1,1,High Risk
46859,15000,30674,15000,130,70,60,2,6,1,1,allow,1,0,Potential Threat
64611,53,9832,53,181,94,87,2,29,1,1,allow,0,0,Normal
63902,445,0,0,66,66,0,1,0,1,0,drop,0,1,Known Attack
60194,443,58489,443,8894,1633,7261,18,16,9,9,allow,1,0,Potential Threat
55069,53,50203,53,195,102,93,2,30,1,1,allow,0,0,Normal
55146,53,34694,53,181,94,87,2,30,1,1,allow,0,0,Normal
58120,25174,0,0,66,66,0,1,0,1,0,deny,0,1,Known Attack
52116,445,0,0,70,70,0,1,0,1,0,drop,0,1,Known Attack
65200,53,5141,53,214,110,104,2,30,1,1,allow,0,0,Normal
53696,50321,25044,50321,70,70,0,2,7,2,0,allow,1,0,Potential Threat
59459,37807,0,0,66,66,0,1,0,1,0,deny,0,1,Known Attack
63924,445,0,0,70,70,0,1,0,1,0,drop,0,1,Known Attack
56852,49677,39171,49677,130,70,60,2,5,1,1,allow,1,0,Potential Threat
65524,53,9019,53,386,122,264,4,52,2,2,allow,0,0,Normal
64194,445,0,0,70,70,0,1,0,1,0,drop,0,1,Known Attack
55145,443,65048,443,13231,6169,7062,38,120,19,19,allow,1,0,Potential Threat
49791,53,37520,53,412,90,322,4,34,2,2,allow,0,0,Normal
57987,445,0,0,66,66,0,1,0,1,0,drop,0,1,Known Attack
34772,15503,0,0,146,146,0,1,0,1,0,deny,1,1,High Risk
65295,53,41511,53,944,205,739,6,45,3,3,allow,1,0,Potential Threat
27005,27015,50781,27015,881,126,755,2,30,1,1,allow,1,0,Potential Threat
55707,53,54526,53,811,94,717,2,30,1,1,allow,0,0,Normal
22,44840,22,44840,1427,1170,257,8,15,4,4,allow,1,0,Potential Threat
65323,445,0,0,66,66,0,1,0,1,0,drop,0,1,Known Attack
30729,22114,0,0,66,66,0,1,0,1,0,deny,0,1,Known Attack
52233,80,14705,80,1674,708,966,18,392,6,12,allow,1,0,Potential Threat
23934,41615,0,0,145,145,0,1,0,1,0,deny,1,1,High Risk
52003,18150,63580,18150,70,70,0,1,5,1,0,allow,1,0,Potential Threat
13528,51221,0,0,62,62,0,1,0,1,0,deny,1,1,High Risk
52099,443,31661,443,39798,12257,27541,68,97,27,41,allow,1,0,Potential Threat
56803,53,52529,53,183,94,89,2,30,1,1,allow,0,0,Normal
11592,80,11592,80,6967,765,6202,15,16,7,8,allow,1,0,Potential Threat
0,0,0,0,156,156,0,2,0,2,0,deny,1,1,High Risk
53550,1,57289,1,70,70,0,1,5,1,0,allow,0,0,Normal
60443,50284,54263,50284,164,70,94,2,5,1,1,allow,1,0,Potential Threat
63804,445,0,0,66,66,0,1,0,1,0,drop,0,1,Known Attack
63509,445,0,0,70,70,0,1,0,1,0,drop,0,1,Known Attack
8282,40200,5762,40200,133,64,69,3,30,2,1,allow,1,0,Potential Threat
27005,27017,40278,27017,891,126,765,2,30,1,1,allow,1,0,Potential Threat
49418,27019,38743,27019,251,71,180,2,30,1,1,allow,1,0,Potential Threat
42289,443,63031,443,6827,1776,5051,26,121,13,13,allow,1,0,Potential Threat
55026,443,23738,443,11413,6823,4590,34,18,19,15,allow,1,0,Potential Threat
9552,57470,0,0,66,66,0,1,0,1,0,deny,1,1,High Risk
58318,15503,0,0,66,66,0,1,0,1,0,deny,0,1,Known Attack
38508,443,38508,443,279067,22871,256196,327,90,145,182,allow,1,0,Potential Threat
56386,53,3694,53,177,94,83,2,30,1,1,allow,0,0,Normal
50994,443,11381,443,6349,1072,5277,18,21,10,8,allow,1,0,Potential Threat
53154,44645,45393,44645,320,140,180,6,5,3,3,allow,1,0,Potential Threat
64673,53,43122,53,213,94,119,2,30,1,1,allow,0,0,Normal
6881,32056,50769,32056,509,150,359,2,1199,1,1,allow,1,0,Potential Threat
57513,443,18231,443,4346,1212,3134,13,120,6,7,allow,1,0,Potential Threat
56583,53,7154,53,177,94,83,2,30,1,1,allow,0,0,Normal
55869,53,64090,53,196,102,94,2,30,1,1,allow,1,0,Potential Threat
56772,53,27354,53,168,86,82,2,30,1,1,allow,0,0,Normal
56630,80,55230,80,234,234,0,4,12,4,0,allow,0,0,Normal
55779,445,0,0,70,70,0,1,0,1,0,drop,0,1,Known Attack
62747,445,0,0,66,66,0,1,0,1,0,drop,0,1,Known Attack
50241,53,51739,53,184,102,82,2,30,1,1,allow,0,0,Normal
6882,64147,0,0,146,146,0,1,0,1,0,deny,1,1,High Risk
55516,445,0,0,70,70,0,1,0,1,0,drop,0,1,Known Attack
55675,445,0,0,70,70,0,1,0,1,0,drop,0,1,Known Attack
54321,27015,42449,27015,924,924,0,3,29,3,0,allow,1,0,Potential Threat
55123,64097,0,0,66,66,0,1,0,1,0,deny,1,1,High Risk
34062,443,2265,443,3208,2015,1193,19,34,11,8,allow,1,0,Potential Threat
56370,445,0,0,70,70,0,1,0,1,0,drop,0,1,Known Attack
57416,53,8404,53,193,102,91,2,29,1,1,allow,0,0,Normal
49227,53,18246,53,179,94,85,2,31,1,1,allow,0,0,Normal
54320,27016,15570,27016,924,924,0,3,30,3,0,allow,1,0,Potential Threat
52019,445,0,0,70,70,0,1,0,1,0,drop,0,1,Known Attack
56941,53,4680,53,192,98,94,2,31,1,1,allow,0,0,Normal
45964,2225,0,0,60,60,0,1,0,1,0,deny,0,1,Known Attack
64243,53,24679,53,244,94,150,2,30,1,1,allow,0,0,Normal
49395,445,0,0,70,70,0,1,0,1,0,drop,0,1,Known Attack
60180,443,13880,443,3667,2243,1424,22,80,11,11,allow,1,0,Potential Threat
37640,443,4915,443,11442,3116,8326,32,46,19,13,allow,1,0,Potential Threat
57470,51413,17602,51413,330,330,0,6,1199,6,0,allow,1,0,Potential Threat
34922,443,21368,443,8093,2068,6025,23,360,11,12,allow,1,0,Potential Threat
57177,53,5547,53,174,89,85,2,31,1,1,allow,0,0,Normal
14059,21247,0,0,62,62,0,1,0,1,0,deny,0,1,Known Attack
58627,25174,0,0,62,62,0,1,0,1,0,deny,0,1,Known Attack
55237,53,6417,53,259,87,172,4,56,2,2,allow,0,0,Normal
56764,45797,41990,45797,164,70,94,2,5,1,1,allow,1,0,Potential Threat
61499,443,53254,443,15584,2626,12958,34,37,18,16,allow,1,0,Potential Threat
59987,445,0,0,70,70,0,1,0,1,0,drop,0,1,Known Attack
51995,50031,29706,50031,70,70,0,1,5,1,0,allow,1,0,Potential Threat
64473,53,45182,53,184,94,90,2,31,1,1,allow,0,0,Normal
63788,80,49704,80,314,192,122,6,15,4,2,allow,0,0,Normal
64495,53,28201,53,243,94,149,2,30,1,1,allow,0,0,Normal
56538,443,45521,443,7760,1599,6161,23,80,13,10,allow,1,0,Potential Threat
49931,53,22854,53,594,196,398,6,82,3,3,allow,0,0,Normal
64677,53,35002,53,190,97,93,2,31,1,1,allow,0,0,Normal
58638,5900,0,0,62,62,0,1,0,1,0,deny,0,1,Known Attack
55686,445,0,0,70,70,0,1,0,1,0,drop,0,1,Known Attack
55836,53,27528,53,181,94,87,2,30,1,1,allow,0,0,Normal
56952,53,7156,53,186,95,91,2,30,1,1,allow,0,0,Normal
32609,64097,0,0,66,66,0,1,0,1,0,deny,1,1,High Risk
56099,53,33681,53,701,88,613,2,30,1,1,allow,0,0,Normal
51634,80,59507,80,378,192,186,7,39,4,3,allow,0,0,Normal
60827,445,0,0,70,70,0,1,0,1,0,drop,0,1,Known Attack
0,0,0,0,320,320,0,5,0,5,0,allow,1,0,Potential Threat
64755,31573,0,0,66,66,0,1,0,1,0,deny,0,1,Known Attack
61973,445,0,0,70,70,0,1,0,1,0,drop,0,1,Known Attack
54016,42707,0,0,66,66,0,1,0,1,0,deny,0,1,Known Attack
47910,7454,0,0,60,60,0,1,0,1,0,deny,0,1,Known Attack
40737,443,35009,443,44004,3909,40095,80,135,38,42,allow,1,0,Potential Threat
49855,53,31460,53,170,87,83,2,30,1,1,allow,0,0,Normal
63642,445,0,0,66,66,0,1,0,1,0,drop,0,1,Known Attack
50377,445,0,0,70,70,0,1,0,1,0,drop,0,1,Known Attack
57087,445,0,0,70,70,0,1,0,1,0,drop,0,1,Known Attack
56756,13973,64423,13973,70,70,0,1,5,1,0,allow,1,0,Potential Threat
58638,5900,0,0,62,62,0,1,0,1,0,deny,0,1,Known Attack
61418,80,59402,80,31954,2972,28982,71,138,36,35,allow,1,0,Potential Threat
52237,443,52237,443,7718,2030,5688,23,20,11,12,allow,1,0,Potential Threat
49169,443,62824,443,11168,3827,7341,42,16,20,22,allow,1,0,Potential Threat
64573,53,39960,53,184,94,90,2,30,1,1,allow,0,0,Normal
26881,25174,0,0,62,62,0,1,0,1,0,deny,0,1,Known Attack
0,0,0,0,70,70,0,1,0,1,0,deny,1,1,High Risk
60423,445,0,0,70,70,0,1,0,1,0,drop,0,1,Known Attack
50031,44847,0,0,74,74,0,1,0,1,0,deny,0,1,Known Attack
56816,11392,0,0,62,62,0,1,0,1,0,deny,0,1,Known Attack
50005,53,15477,53,199,102,97,2,30,1,1,allow,0,0,Normal
53137,35111,32550,35111,70,70,0,1,5,1,0,allow,1,0,Potential Threat
49849,53,11014,53,196,102,94,2,30,1,1,allow,0,0,Normal
52988,445,0,0,66,66,0,1,0,1,0,drop,0,1,Known Attack
25434,53,25434,53,231,90,141,2,31,1,1,allow,0,0,Normal
51538,445,0,0,70,70,0,1,0,1,0,drop,0,1,Known Attack
45964,3111,0,0,60,60,0,1,0,1,0,deny,0,1,Known Attack
49898,53,31342,53,184,94,90,2,30,1,1,allow,0,0,Normal
56569,53,13010,53,183,94,89,2,30,1,1,allow,0,0,Normal
50367,53,22257,53,578,286,292,9,15,5,4,allow,0,0,Normal
56817,445,0,0,66,66,0,1,0,1,0,drop,0,1,Known Attack
54998,53,35657,53,174,89,85,2,31,1,1,allow,0,0,Normal
50127,64147,0,0,62,62,0,1,0,1,0,deny,1,1,High Risk
57272,445,0,0,66,66,0,1,0,1,0,drop,0,1,Known Attack
64752,445,0,0,70,70,0,1,0,1,0,drop,0,1,Known Attack
56967,443,1130,443,9222,3148,6074,26,91,14,12,allow,1,0,Potential Threat
56552,53,3851,53,195,102,93,2,31,1,1,allow,0,0,Normal
18642,42707,0,0,145,145,0,1,0,1,0,deny,1,1,High Risk
45343,443,52570,443,2312,1382,930,19,26,11,8,allow,1,0,Potential Threat
30188,23453,55935,23453,502,150,352,2,1200,1,1,allow,1,0,Potential Threat
49444,53,42796,53,401,88,313,4,38,2,2,allow,0,0,Normal
39839,22114,0,0,62,62,0,1,0,1,0,deny,0,1,Known Attack
57200,53,48391,53,711,87,624,2,30,1,1,allow,0,0,Normal
39065,443,4463,443,3589,1251,2338,15,20,9,6,allow,1,0,Potential Threat
50264,445,0,0,70,70,0,1,0,1,0,drop,0,1,Known Attack
37965,34591,32228,34591,820,152,668,4,1199,2,2,allow,1,0,Potential Threat
52471,22114,0,0,66,66,0,1,0,1,0,deny,0,1,Known Attack
7947,50584,0,0,62,62,0,1,0,1,0,deny,1,1,High Risk
55489,53,34902,53,748,106,642,2,31,1,1,allow,0,0,Normal
55339,53,49453,53,194,94,100,2,30,1,1,allow,0,0,Normal
63200,445,0,0,66,66,0,1,0,1,0,drop,0,1,Known Attack
42298,40014,14476,40014,148,86,62,2,31,1,1,allow,1,0,Potential Threat
48676,53398,0,0,60,60,0,1,0,1,0,deny,0,1,Known Attack
27081,10197,0,0,62,62,0,1,0,1,0,deny,0,1,Known Attack
37896,443,37896,443,4704,1797,2907,19,30,11,8,allow,1,0,Potential Threat
53786,53,10105,53,260,86,174,2,30,1,1,allow,0,0,Normal
29300,35440,0,0,62,62,0,1,0,1,0,deny,0,1,Known Attack
55543,53,20770,53,402,118,284,2,30,1,1,allow,0,0,Normal
50841,443,31504,443,10475,1518,8957,24,139,11,13,allow,1,0,Potential Threat
64551,2310,0,0,143,143,0,1,0,1,0,deny,0,1,Known Attack
49671,53,34167,53,242,110,132,2,30,1,1,allow,0,0,Normal
3717,25174,0,0,62,62,0,1,0,1,0,deny,1,1,High Risk
57204,443,62645,443,340,140,200,6,25,3,3,allow,1,0,Potential Threat
33705,443,51177,443,4610,918,3692,15,135,7,8,allow,1,0,Potential Threat
14059,21247,0,0,146,146,0,1,0,1,0,deny,1,1,High Risk
6881,30096,6963,30096,509,150,359,2,1199,1,1,allow,1,0,Potential Threat
49846,53,37794,53,763,101,662,2,31,1,1,allow,0,0,Normal
57293,445,0,0,70,70,0,1,0,1,0,drop,0,1,Known Attack
15333,60043,0,0,62,62,0,1,0,1,0,deny,1,1,High Risk
52749,443,45343,443,148418,107579,40839,315,6090,107,208,allow,1,0,Potential Threat
48320,80,28314,80,12110,3853,8257,35,1075,13,22,allow,1,0,Potential Threat
64709,53,47288,53,353,118,235,2,30,1,1,allow,0,0,Normal
55808,53,62686,53,174,89,85,2,30,1,1,allow,0,0,Normal
59680,445,0,0,70,70,0,1,0,1,0,drop,0,1,Known Attack
49851,443,11118,443,6058,1038,5020,20,71,11,9,allow,1,0,Potential Threat
49936,53,28353,53,211,102,109,2,31,1,1,allow,0,0,Normal
37426,443,35217,443,7477,3305,4172,21,400,12,9,allow,1,0,Potential Threat
59909,445,0,0,70,70,0,1,0,1,0,drop,0,1,Known Attack
61753,445,0,0,70,70,0,1,0,1,0,drop,0,1,Known Attack
60163,26467,0,0,66,66,0,1,0,1,0,deny,0,1,Known Attack
52326,445,0,0,66,66,0,1,0,1,0,drop,0,1,Known Attack
52224,37178,41727,37178,136,136,0,3,14,3,0,allow,1,0,Potential Threat
54314,53,25378,53,284,79,205,2,30,1,1,allow,0,0,Normal
62328,443,62328,443,1210,637,573,14,51,7,7,allow,1,0,Potential Threat
58638,5900,0,0,62,62,0,1,0,1,0,deny,0,1,Known Attack
63798,16357,18681,16357,66,66,0,2,8,2,0,allow,1,0,Potential Threat
63515,445,0,0,70,70,0,1,0,1,0,drop,0,1,Known Attack
65189,53,46273,53,328,93,235,4,29,2,2,allow,0,0,Normal
35338,443,9775,443,7504,2762,4742,35,61,17,18,allow,1,0,Potential Threat
64742,53,7062,53,338,110,228,2,30,1,1,allow,0,0,Normal
63617,445,0,0,70,70,0,1,0,1,0,drop,0,1,Known Attack
57390,445,0,0,70,70,0,1,0,1,0,drop,0,1,Known Attack
59884,443,44531,443,6622,2246,4376,21,46,12,9,allow,1,0,Potential Threat
24041,55783,0,0,62,62,0,1,0,1,0,deny,1,1,High Risk
56009,53,7541,53,172,88,84,2,31,1,1,allow,0,0,Normal
60823,25174,0,0,66,66,0,1,0,1,0,deny,0,1,Known Attack
64959,53,50159,53,173,94,79,2,30,1,1,allow,0,0,Normal
57371,53,5536,53,214,110,104,2,30,1,1,allow,0,0,Normal
37635,443,29591,443,4266,1768,2498,18,121,8,10,allow,1,0,Potential Threat
55310,53,30986,53,176,90,86,2,31,1,1,allow,0,0,Normal
50943,443,64250,443,29452,1988,27464,37,3619,10,27,allow,1,0,Potential Threat
47783,50432,0,0,62,62,0,1,0,1,0,deny,0,1,Known Attack
49781,443,43148,443,7877,1949,5928,24,126,12,12,allow,1,0,Potential Threat
64670,53,38301,53,186,95,91,2,31,1,1,allow,0,0,Normal
65020,53,24466,53,290,94,196,4,55,2,2,allow,0,0,Normal
2394,43890,0,0,62,62,0,1,0,1,0,deny,1,1,High Risk
49662,443,52708,443,4353,1145,3208,17,25,9,8,allow,1,0,Potential Threat
51006,445,0,0,66,66,0,1,0,1,0,drop,0,1,Known Attack
63532,445,0,0,70,70,0,1,0,1,0,drop,0,1,Known Attack
60683,5900,0,0,60,60,0,1,0,1,0,deny,0,1,Known Attack
47650,443,47650,443,4585,1678,2907,19,28,11,8,allow,1,0,Potential Threat
9227,443,31374,443,5146,960,4186,17,25,9,8,allow,1,0,Potential Threat
55516,5228,12835,5228,2769,1694,1075,20,3600,10,10,allow,1,0,Potential Threat
54446,443,54881,443,2782,1778,1004,20,33,10,10,allow,1,0,Potential Threat
56776,445,0,0,70,70,0,1,0,1,0,drop,0,1,Known Attack
54702,445,0,0,66,66,0,1,0,1,0,drop,0,1,Known Attack
34798,53,14935,53,199,94,105,2,30,1,1,allow,0,0,Normal
38769,443,3016,443,7352,3452,3900,18,15,10,8,allow,1,0,Potential Threat
54862,445,0,0,70,70,0,1,0,1,0,drop,0,1,Known Attack
53986,445,0,0,70,70,0,1,0,1,0,drop,0,1,Known Attack
55002,53,42728,53,196,102,94,2,31,1,1,allow,0,0,Normal
49901,53,49901,53,194,87,107,2,30,1,1,allow,0,0,Normal
8403,46824,0,0,62,62,0,1,0,1,0,deny,1,1,High Risk
62186,445,0,0,66,66,0,1,0,1,0,drop,0,1,Known Attack
59994,11446,0,0,66,66,0,1,0,1,0,deny,0,1,Known Attack
14199,443,14199,443,416,198,218,7,27,4,3,allow,1,0,Potential Threat
54472,80,34355,80,13695,1377,12318,26,255,14,12,allow,1,0,Potential Threat
63963,50584,0,0,66,66,0,1,0,1,0,deny,1,1,High Risk
49793,53,56349,53,271,102,169,2,30,1,1,allow,0,0,Normal
13285,29892,0,0,145,145,0,1,0,1,0,deny,1,1,High Risk
65040,53,64754,53,749,94,655,2,30,1,1,allow,1,0,Potential Threat
42089,53,62601,53,199,94,105,2,29,1,1,allow,1,0,Potential Threat
55883,53,20281,53,189,102,87,2,30,1,1,allow,0,0,Normal
56720,443,60130,443,4989,1014,3975,16,53,9,7,allow,1,0,Potential Threat
50584,53,19282,53,738,86,652,2,30,1,1,allow,0,0,Normal
52909,445,0,0,66,66,0,1,0,1,0,drop,0,1,Known Attack
64585,80,64585,80,405673,21057,384616,519,26,252,267,allow,1,0,Potential Threat
40511,80,1880,80,1680,950,730,12,15,6,6,allow,1,0,Potential Threat
55019,53,16040,53,299,110,189,4,32,2,2,allow,0,0,Normal
56568,53,49055,53,206,105,101,2,30,1,1,allow,0,0,Normal
53475,3389,0,0,66,66,0,1,0,1,0,deny,0,1,Known Attack
56621,443,45506,443,7981,1961,6020,20,15,11,9,allow,1,0,Potential Threat
52180,443,15332,443,11127,1324,9803,24,75,12,12,allow,1,0,Potential Threat
51363,445,0,0,70,70,0,1,0,1,0,drop,0,1,Known Attack
63843,53603,44636,53603,312,132,180,6,6,3,3,allow,1,0,Potential Threat
63906,36909,30978,36909,66,66,0,2,7,2,0,allow,1,0,Potential Threat
56765,53,28041,53,194,102,92,2,30,1,1,allow,0,0,Normal
58776,443,47713,443,3991,2587,1404,17,16,9,8,allow,1,0,Potential Threat
50675,445,0,0,66,66,0,1,0,1,0,drop,0,1,Known Attack
42969,8146,0,0,62,62,0,1,0,1,0,deny,0,1,Known Attack
64974,445,0,0,70,70,0,1,0,1,0,drop,0,1,Known Attack
63683,445,0,0,66,66,0,1,0,1,0,drop,0,1,Known Attack
55354,53,24160,53,168,94,74,2,30,1,1,allow,0,0,Normal
52078,15518,47758,15518,70,70,0,2,7,2,0,allow,1,0,Potential Threat
51560,46783,0,0,66,66,0,1,0,1,0,deny,0,1,Known Attack
43319,53,43319,53,237,91,146,2,32,1,1,allow,0,0,Normal
53470,53,29709,53,168,78,90,2,30,1,1,allow,0,0,Normal
49247,80,49247,80,378,180,198,7,53,4,3,allow,0,0,Normal
55957,53,35891,53,178,94,84,2,29,1,1,allow,0,0,Normal
64884,53,55819,53,195,102,93,2,31,1,1,allow,0,0,Normal
50255,53,26984,53,199,102,97,2,30,1,1,allow,0,0,Normal
61664,445,0,0,70,70,0,1,0,1,0,drop,0,1,Known Attack
58638,5900,0,0,62,62,0,1,0,1,0,deny,0,1,Known Attack
54835,443,32514,443,15578,7071,8507,69,140,33,36,allow,1,0,Potential Threat
26408,64147,0,0,66,66,0,1,0,1,0,deny,1,1,High Risk
45682,37965,0,0,62,62,0,1,0,1,0,deny,0,1,Known Attack
16387,8455,0,0,60,60,0,1,0,1,0,deny,0,1,Known Attack
65263,445,0,0,66,66,0,1,0,1,0,drop,0,1,Known Attack
58638,5900,0,0,62,62,0,1,0,1,0,deny,0,1,Known Attack
57401,53,56934,53,179,94,85,2,31,1,1,allow,0,0,Normal
56004,53,42302,53,172,88,84,2,30,1,1,allow,0,0,Normal
36933,23117,0,0,66,66,0,1,0,1,0,deny,0,1,Known Attack
46858,15000,17792,15000,130,70,60,2,5,1,1,allow,1,0,Potential Threat
56517,445,0,0,70,70,0,1,0,1,0,drop,0,1,Known Attack
61855,445,0,0,70,70,0,1,0,1,0,drop,0,1,Known Attack
49863,8100,2379,8100,78,78,0,1,4,1,0,allow,0,0,Normal
50723,445,0,0,66,66,0,1,0,1,0,drop,0,1,Known Attack
62639,445,0,0,70,70,0,1,0,1,0,drop,0,1,Known Attack
56922,29434,0,0,107,107,0,1,0,1,0,deny,0,1,Known Attack
40802,443,39888,443,3321,1297,2024,13,32,7,6,allow,1,0,Potential Threat
60720,23718,0,0,62,62,0,1,0,1,0,deny,0,1,Known Attack
53906,44512,0,0,62,62,0,1,0,1,0,deny,0,1,Known Attack
51699,37224,26533,37224,66,66,0,1,5,1,0,allow,1,0,Potential Threat
60751,20010,54269,20010,70,70,0,2,8,2,0,allow,1,0,Potential Threat
53886,445,0,0,70,70,0,1,0,1,0,drop,0,1,Known Attack
13684,25174,0,0,62,62,0,1,0,1,0,deny,0,1,Known Attack
443,35385,0,0,66,66,0,1,0,1,0,deny,1,1,High Risk
49113,50584,0,0,62,62,0,1,0,1,0,deny,0,1,Known Attack
49556,80,42311,80,7002,5717,1285,15,45,9,6,allow,1,0,Potential Threat
54002,445,0,0,70,70,0,1,0,1,0,drop,0,1,Known Attack
50596,53,57766,53,168,86,82,2,30,1,1,allow,0,0,Normal
65349,445,0,0,70,70,0,1,0,1,0,drop,0,1,Known Attack
53599,47783,42378,47783,618,432,186,9,17,6,3,allow,1,0,Potential Threat
43205,22,43205,22,6957,2330,4627,35,27,17,18,allow,1,0,Potential Threat
48817,49157,48817,49157,328,152,176,2,1200,1,1,allow,1,0,Potential Threat
25880,44847,0,0,146,146,0,1,0,1,0,deny,1,1,High Risk
56332,53,16709,53,209,110,99,2,30,1,1,allow,0,0,Normal
61575,445,0,0,66,66,0,1,0,1,0,drop,0,1,Known Attack
58302,443,37691,443,4611,3176,1435,26,30,15,11,allow,1,0,Potential Threat
58574,443,3429,443,3447,788,2659,13,135,6,7,allow,1,0,Potential Threat
49450,445,0,0,70,70,0,1,0,1,0,drop,0,1,Known Attack
56279,443,27594,443,15248,5524,9724,54,364,27,27,allow,1,0,Potential Threat
61222,445,0,0,70,70,0,1,0,1,0,drop,0,1,Known Attack
59991,445,0,0,66,66,0,1,0,1,0,drop,0,1,Known Attack
5611,25174,0,0,146,146,0,1,0,1,0,deny,1,1,High Risk
60637,445,0,0,70,70,0,1,0,1,0,drop,0,1,Known Attack
49269,53,5251,53,198,110,88,2,29,1,1,allow,0,0,Normal
54752,31573,0,0,66,66,0,1,0,1,0,deny,0,1,Known Attack
49776,53,15280,53,289,92,197,4,31,2,2,allow,0,0,Normal
49777,53,45833,53,166,86,80,2,31,1,1,allow,0,0,Normal
58638,5900,0,0,62,62,0,1,0,1,0,deny,0,1,Known Attack
52096,55854,2133,55854,70,70,0,2,7,2,0,allow,1,0,Potential Threat
64573,53,58393,53,558,104,454,4,49,2,2,allow,1,0,Potential Threat
55426,53,25381,53,177,94,83,2,30,1,1,allow,0,0,Normal
56819,37372,7815,37372,70,70,0,1,5,1,0,allow,1,0,Potential Threat
63702,445,0,0,66,66,0,1,0,1,0,drop,0,1,Known Attack
55624,53,2352,53,199,102,97,2,30,1,1,allow,0,0,Normal
21348,22,0,0,60,60,0,1,0,1,0,deny,0,1,Known Attack
61948,53,63047,53,205,86,119,2,30,1,1,allow,1,0,Potential Threat
39820,443,15397,443,2642442,95056,2547386,2730,3629,999,1731,allow,1,0,Potential Threat
53527,443,25088,443,127391,26326,101065,179,172,76,103,allow,1,0,Potential Threat
50760,445,0,0,70,70,0,1,0,1,0,drop,0,1,Known Attack
56905,53,61024,53,239,110,129,2,30,1,1,allow,0,0,Normal
58507,445,0,0,70,70,0,1,0,1,0,drop,0,1,Known Attack
27005,33038,17485,33038,892,126,766,2,30,1,1,allow,1,0,Potential Threat
53544,22051,5386,22051,70,70,0,1,5,1,0,allow,1,0,Potential Threat
33041,443,60563,443,12375,6777,5598,28,49,13,15,allow,1,0,Potential Threat
53682,20884,39828,20884,70,70,0,2,7,2,0,allow,1,0,Potential Threat
64041,53,58555,53,200,102,98,2,31,1,1,allow,0,0,Normal
50475,80,52145,80,2669,1434,1235,11,21,6,5,allow,1,0,Potential Threat
33012,50265,0,0,145,145,0,1,0,1,0,deny,1,1,High Risk
54280,3385,0,0,60,60,0,1,0,1,0,deny,0,1,Known Attack
56736,80,11534,80,194,128,66,4,25,3,1,allow,0,0,Normal
57591,53,13897,53,165,78,87,2,31,1,1,allow,0,0,Normal
50395,80,11837,80,487,180,307,6,26,4,2,allow,0,0,Normal
50506,445,0,0,70,70,0,1,0,1,0,drop,0,1,Known Attack
56187,445,0,0,70,70,0,1,0,1,0,drop,0,1,Known Attack
63875,43485,59709,43485,312,132,180,6,6,3,3,allow,1,0,Potential Threat
47105,64147,0,0,62,62,0,1,0,1,0,deny,1,1,High Risk
55937,53,36384,53,177,94,83,2,30,1,1,allow,0,0,Normal
58086,445,0,0,70,70,0,1,0,1,0,drop,0,1,Known Attack
56964,53,45347,53,267,87,180,4,54,2,2,allow,0,0,Normal
63888,6881,1639,6881,66,66,0,2,7,2,0,allow,1,0,Potential Threat
55654,445,0,0,70,70,0,1,0,1,0,drop,0,1,Known Attack
27005,27018,46285,27018,895,126,769,2,30,1,1,allow,1,0,Potential Threat
56971,53,24481,53,195,102,93,2,30,1,1,allow,0,0,Normal
52194,443,33437,443,9075,3727,5348,38,50,18,20,allow,1,0,Potential Threat
57893,80,44001,80,318,192,126,6,26,4,2,allow,0,0,Normal
49875,443,6451,443,31715,20427,11288,103,54,54,49,allow,1,0,Potential Threat
65356,53,60802,53,197,94,103,2,31,1,1,allow,0,0,Normal
56650,443,37147,443,8008,1988,6020,20,15,11,9,allow,1,0,Potential Threat
57363,445,0,0,70,70,0,1,0,1,0,drop,0,1,Known Attack
59584,36237,0,0,66,66,0,1,0,1,0,deny,0,1,Known Attack
14445,443,55284,443,2589,1443,1146,18,15,8,10,allow,1,0,Potential Threat
53257,37450,0,0,62,62,0,1,0,1,0,deny,0,1,Known Attack
35516,80,25484,80,841,715,126,5,15,3,2,allow,1,0,Potential Threat
50585,443,60446,443,1594,951,643,15,97,8,7,allow,1,0,Potential Threat
48087,16069,0,0,66,66,0,1,0,1,0,deny,0,1,Known Attack
63414,445,0,0,66,66,0,1,0,1,0,drop,0,1,Known Attack
58638,5900,0,0,62,62,0,1,0,1,0,deny,0,1,Known Attack
38567,80,39974,80,1571,877,694,11,181,6,5,allow,1,0,Potential Threat
61461,50584,0,0,62,62,0,1,0,1,0,deny,1,1,High Risk
50581,445,0,0,70,70,0,1,0,1,0,drop,0,1,Known Attack
54955,7302,0,0,62,62,0,1,0,1,0,deny,0,1,Known Attack
45775,443,19122,443,8706,1430,7276,23,316,9,14,allow,1,0,Potential Threat
44594,64147,0,0,66,66,0,1,0,1,0,deny,1,1,High Risk
3270,35440,0,0,66,66,0,1,0,1,0,deny,1,1,High Risk
56433,53,47561,53,210,110,100,2,30,1,1,allow,0,0,Normal
53120,25174,0,0,146,146,0,1,0,1,0,deny,1,1,High Risk
56481,53,28182,53,816,102,714,2,30,1,1,allow,0,0,Normal
65285,50584,0,0,66,66,0,1,0,1,0,deny,1,1,High Risk
49858,80,51229,80,1539,674,865,11,89,6,5,allow,0,0,Normal
54727,445,0,0,70,70,0,1,0,1,0,drop,0,1,Known Attack
56200,53,10019,53,211,110,101,2,30,1,1,allow,0,0,Normal
56357,53,62096,53,168,86,82,2,30,1,1,allow,0,0,Normal
57342,443,57537,443,10761,5724,5037,43,15,25,18,allow,1,0,Potential Threat
54464,56205,0,0,62,62,0,1,0,1,0,deny,0,1,Known Attack
65049,445,0,0,66,66,0,1,0,1,0,drop,0,1,Known Attack
46773,443,61841,443,10812,3429,7383,39,315,20,19,allow,1,0,Potential Threat
10427,32480,0,0,66,66,0,1,0,1,0,deny,1,1,High Risk
64430,445,0,0,70,70,0,1,0,1,0,drop,0,1,Known Attack
51625,445,0,0,66,66,0,1,0,1,0,drop,0,1,Known Attack
56712,53,4721,53,448,184,264,6,29,3,3,allow,0,0,Normal
57228,53,47428,53,199,102,97,2,30,1,1,allow,0,0,Normal
56339,445,0,0,70,70,0,1,0,1,0,drop,0,1,Known Attack
57558,443,4202,443,42986,7555,35431,69,125,29,40,allow,1,0,Potential Threat
55000,443,17337,443,134,60,74,3,10,2,1,allow,0,0,Normal
65451,53,6208,53,188,96,92,2,31,1,1,allow,0,0,Normal
56445,53,52720,53,198,101,97,2,30,1,1,allow,0,0,Normal
63059,443,42784,443,5772,3849,1923,27,270,14,13,allow,1,0,Potential Threat
53153,17639,25846,17639,698,320,378,10,18,6,4,allow,1,0,Potential Threat
52059,47363,55015,47363,70,70,0,1,5,1,0,allow,1,0,Potential Threat
57240,53,0,0,230,87,143,2,30,1,1,allow,0,0,Normal
13985,34159,0,0,62,62,0,1,0,1,0,deny,1,1,High Risk
64108,53,41542,53,296,126,170,2,30,1,1,allow,0,0,Normal
58176,5223,41893,5223,15152,5747,9405,46,56,20,26,allow,1,0,Potential Threat
58220,445,0,0,70,70,0,1,0,1,0,drop,0,1,Known Attack
54660,445,0,0,70,70,0,1,0,1,0,drop,0,1,Known Attack
49930,443,24713,443,16631,7072,9559,50,134,29,21,allow,1,0,Potential Threat
18415,37965,0,0,62,62,0,1,0,1,0,deny,1,1,High Risk
9512,443,14359,443,3614,434,3180,11,1,6,5,allow,1,0,Potential Threat
49333,25174,0,0,146,146,0,1,0,1,0,deny,1,1,High Risk
53606,445,0,0,66,66,0,1,0,1,0,drop,0,1,Known Attack
55410,53,27764,53,711,87,624,2,30,1,1,allow,0,0,Normal
65319,445,0,0,66,66,0,1,0,1,0,drop,0,1,Known Attack
49657,443,29231,443,9039,2175,6864,32,20,17,15,allow,1,0,Potential Threat
57080,445,0,0,70,70,0,1,0,1,0,drop,0,1,Known Attack
52112,22114,0,0,66,66,0,1,0,1,0,deny,0,1,Known Attack
56549,443,22340,443,13979,2593,11386,29,114,11,18,allow,1,0,Potential Threat
48219,55442,0,0,62,62,0,1,0,1,0,deny,0,1,Known Attack
62149,445,0,0,70,70,0,1,0,1,0,drop,0,1,Known Attack
54478,445,0,0,70,70,0,1,0,1,0,drop,0,1,Known Attack
64987,53,27930,53,198,102,96,2,29,1,1,allow,0,0,Normal
52130,1035,52488,1035,66,66,0,1,5,1,0,allow,0,0,Normal
63494,445,0,0,70,70,0,1,0,1,0,drop,0,1,Known Attack
55291,53,55867,53,243,94,149,2,31,1,1,allow,0,0,Normal
62645,445,0,0,70,70,0,1,0,1,0,drop,0,1,Known Attack
63037,445,0,0,70,70,0,1,0,1,0,drop,0,1,Known Attack
58961,445,0,0,70,70,0,1,0,1,0,drop,0,1,Known Attack
57220,445,0,0,70,70,0,1,0,1,0,drop,0,1,Known Attack
80,37649,0,0,60,60,0,1,0,1,0,deny,1,1,High Risk
55105,445,0,0,66,66,0,1,0,1,0,drop,0,1,Known Attack
59400,22114,0,0,66,66,0,1,0,1,0,deny,0,1,Known Attack
54633,445,0,0,66,66,0,1,0,1,0,drop,0,1,Known Attack
55169,53,40051,53,199,102,97,2,30,1,1,allow,0,0,Normal
30304,26467,0,0,62,62,0,1,0,1,0,deny,0,1,Known Attack
55041,53,58764,53,234,94,140,2,30,1,1,allow,0,0,Normal
43628,53,19035,53,168,78,90,2,29,1,1,allow,0,0,Normal
46278,443,29099,443,6685,4843,1842,29,17,18,11,allow,1,0,Potential Threat
56430,443,45343,443,10956,4863,6093,47,82,22,25,allow,1,0,Potential Threat
59957,443,65089,443,8677,2714,5963,21,114,13,8,allow,1,0,Potential Threat
25565,44521,0,0,60,60,0,1,0,1,0,deny,1,1,High Risk
48676,53395,0,0,60,60,0,1,0,1,0,deny,0,1,Known Attack
24260,50584,0,0,62,62,0,1,0,1,0,deny,1,1,High Risk
64219,51050,0,0,66,66,0,1,0,1,0,deny,1,1,High Risk
11030,17372,0,0,62,62,0,1,0,1,0,deny,0,1,Known Attack
50020,445,0,0,70,70,0,1,0,1,0,drop,0,1,Known Attack
61696,445,0,0,70,70,0,1,0,1,0,drop,0,1,Known Attack
58125,445,0,0,70,70,0,1,0,1,0,drop,0,1,Known Attack
52699,445,0,0,70,70,0,1,0,1,0,drop,0,1,Known Attack
55387,53,17527,53,761,100,661,2,31,1,1,allow,0,0,Normal
53261,443,44593,443,5025,973,4052,19,53,10,9,allow,1,0,Potential Threat
64066,23718,0,0,62,62,0,1,0,1,0,deny,0,1,Known Attack
51213,445,0,0,70,70,0,1,0,1,0,drop,0,1,Known Attack
49432,53,40864,53,338,118,220,2,29,1,1,allow,0,0,Normal
39824,51505,0,0,62,62,0,1,0,1,0,deny,0,1,Known Attack
56994,53,19050,53,177,94,83,2,30,1,1,allow,0,0,Normal
60147,25198,0,0,148,148,0,1,0,1,0,deny,1,1,High Risk
29159,39004,0,0,62,62,0,1,0,1,0,deny,1,1,High Risk
48020,7484,0,0,60,60,0,1,0,1,0,deny,0,1,Known Attack
56594,80,5980,80,234,234,0,4,11,4,0,allow,0,0,Normal
50004,445,0,0,70,70,0,1,0,1,0,drop,0,1,Known Attack
28999,37807,0,0,146,146,0,1,0,1,0,deny,1,1,High Risk
19099,56205,0,0,62,62,0,1,0,1,0,deny,1,1,High Risk
63742,445,0,0,70,70,0,1,0,1,0,drop,0,1,Known Attack
61948,445,0,0,66,66,0,1,0,1,0,drop,0,1,Known Attack
41861,5223,49797,5223,5169,1103,4066,26,214,10,16,allow,1,0,Potential Threat
56611,53,8939,53,91,91,0,1,30,1,0,allow,0,0,Normal
50006,80,59669,80,2087,1159,928,10,86,6,4,allow,1,0,Potential Threat
35176,80,37365,80,1987,1329,658,10,136,6,4,allow,1,0,Potential Threat
50574,443,63021,443,7352,1023,6329,19,16,11,8,allow,1,0,Potential Threat
63171,2323,0,0,60,60,0,1,0,1,0,deny,0,1,Known Attack
51526,4545,51526,4545,156,156,0,3,8,3,0,allow,1,0,Potential Threat
20409,23,0,0,60,60,0,1,0,1,0,deny,0,1,Known Attack
41166,443,62560,443,8933,1938,6995,21,16,12,9,allow,1,0,Potential Threat
64318,53,41262,53,499,183,316,6,57,3,3,allow,1,0,Potential Threat
63964,53,22176,53,323,85,238,4,34,2,2,allow,0,0,Normal
62812,445,0,0,66,66,0,1,0,1,0,drop,0,1,Known Attack
55584,53,28071,53,177,94,83,2,30,1,1,allow,0,0,Normal
40155,25174,0,0,66,66,0,1,0,1,0,deny,0,1,Known Attack
7619,50584,0,0,62,62,0,1,0,1,0,deny,1,1,High Risk
58638,5900,0,0,62,62,0,1,0,1,0,deny,0,1,Known Attack
50917,445,0,0,70,70,0,1,0,1,0,drop,0,1,Known Attack
58764,53,65299,53,268,94,174,2,30,1,1,allow,1,0,Potential Threat
65500,443,21161,443,91813,4379,87434,101,16,37,64,allow,1,0,Potential Threat
44886,23,0,0,60,60,0,1,0,1,0,deny,0,1,Known Attack
52116,80,18216,80,422,240,182,8,26,5,3,allow,0,0,Normal
56698,80,23963,80,176644,9435,167209,266,65,104,162,allow,1,0,Potential Threat
56702,443,53688,443,8058,2038,6020,20,15,11,9,allow,1,0,Potential Threat
3478,61463,0,0,179,179,0,1,0,1,0,deny,1,1,High Risk
57088,445,0,0,70,70,0,1,0,1,0,drop,0,1,Known Attack
34079,80,3796,80,5053,4178,875,17,15,9,8,allow,1,0,Potential Threat
49320,53,42245,53,331,90,241,4,38,2,2,allow,0,0,Normal
56345,443,39296,443,39990,1989,38001,50,147,17,33,allow,1,0,Potential Threat
6881,6881,0,0,62,62,0,1,0,1,0,deny,0,1,Known Attack
50222,445,0,0,70,70,0,1,0,1,0,drop,0,1,Known Attack
2238,22114,0,0,62,62,0,1,0,1,0,deny,1,1,High Risk
65291,53,61483,53,190,97,93,2,31,1,1,allow,1,0,Potential Threat
52925,64147,0,0,62,62,0,1,0,1,0,deny,1,1,High Risk
10552,25174,0,0,62,62,0,1,0,1,0,deny,0,1,Known Attack
56170,53,63567,53,198,102,96,2,30,1,1,allow,1,0,Potential Threat
50448,443,27905,443,10382,3262,7120,30,142,16,14,allow,1,0,Potential Threat
51744,1678,56992,1678,66,66,0,1,5,1,0,allow,1,0,Potential Threat
56640,445,0,0,70,70,0,1,0,1,0,drop,0,1,Known Attack
37649,443,13055,443,32391,21443,10948,69,47,41,28,allow,1,0,Potential Threat
54701,445,0,0,70,70,0,1,0,1,0,drop,0,1,Known Attack
64261,445,0,0,70,70,0,1,0,1,0,drop,0,1,Known Attack
62364,445,0,0,70,70,0,1,0,1,0,drop,0,1,Known Attack
51935,38639,36468,38639,70,70,0,1,5,1,0,allow,1,0,Potential Threat
43724,35440,0,0,62,62,0,1,0,1,0,deny,0,1,Known Attack
58638,5900,0,0,62,62,0,1,0,1,0,deny,0,1,Known Attack
55741,445,0,0,70,70,0,1,0,1,0,drop,0,1,Known Attack
49449,443,30580,443,1574,921,653,14,15,7,7,allow,1,0,Potential Threat
50575,53,5901,53,766,102,664,2,30,1,1,allow,0,0,Normal
63398,25174,0,0,66,66,0,1,0,1,0,deny,0,1,Known Attack
31627,64147,0,0,62,62,0,1,0,1,0,deny,1,1,High Risk
53118,443,63279,443,21933,11660,10273,206,188,114,92,allow,1,0,Potential Threat
55361,445,0,0,70,70,0,1,0,1,0,drop,0,1,Known Attack
50419,443,44835,443,4590,575,4015,14,28,6,8,allow,1,0,Potential Threat
64017,445,0,0,70,70,0,1,0,1,0,drop,0,1,Known Attack
65012,2767,0,0,66,66,0,1,0,1,0,deny,0,1,Known Attack
30729,22114,0,0,66,66,0,1,0,1,0,deny,0,1,Known Attack
49418,22114,0,0,62,62,0,1,0,1,0,deny,0,1,Known Attack
61568,53,62912,53,260,86,174,2,29,1,1,allow,1,0,Potential Threat
9212,51505,0,0,62,62,0,1,0,1,0,deny,1,1,High Risk
22683,39210,0,0,60,60,0,1,0,1,0,deny,1,1,High Risk
56151,445,0,0,70,70,0,1,0,1,0,drop,0,1,Known Attack
50617,80,45162,80,1658,1247,411,8,14,5,3,allow,0,0,Normal
58828,443,9559,443,5166,700,4466,16,15,7,9,allow,1,0,Potential Threat
51324,11392,0,0,66,66,0,1,0,1,0,deny,0,1,Known Attack
49601,80,15488,80,378,192,186,7,41,4,3,allow,0,0,Normal
44334,26467,0,0,62,62,0,1,0,1,0,deny,0,1,Known Attack
64051,53,51013,53,430,172,258,6,61,3,3,allow,1,0,Potential Threat
64342,445,0,0,70,70,0,1,0,1,0,drop,0,1,Known Attack
53437,443,53437,443,4198,2498,1700,25,102,12,13,allow,1,0,Potential Threat
49418,27015,56301,27015,258,71,187,2,30,1,1,allow,1,0,Potential Threat
63067,445,0,0,66,66,0,1,0,1,0,drop,0,1,Known Attack
57408,53,37720,53,195,102,93,2,30,1,1,allow,0,0,Normal
58818,443,11066,443,1413,876,537,12,25,6,6,allow,1,0,Potential Threat
57484,30317,0,0,62,62,0,1,0,1,0,deny,0,1,Known Attack
56837,53,27740,53,195,102,93,2,32,1,1,allow,0,0,Normal
53495,445,0,0,66,66,0,1,0,1,0,drop,0,1,Known Attack
51622,445,0,0,66,66,0,1,0,1,0,drop,0,1,Known Attack
56775,53,62594,53,200,94,106,2,29,1,1,allow,0,0,Normal
50680,443,36184,443,2993,866,2127,10,120,5,5,allow,1,0,Potential Threat
59570,443,54074,443,6713,3052,3661,49,5974,15,34,allow,1,0,Potential Threat
63941,53,9002,53,228,94,134,2,30,1,1,allow,0,0,Normal
10416,64147,0,0,62,62,0,1,0,1,0,deny,1,1,High Risk
49721,445,0,0,70,70,0,1,0,1,0,drop,0,1,Known Attack
50417,80,26233,80,1658,1247,411,8,15,5,3,allow,0,0,Normal
50745,80,27446,80,2977,680,2297,11,161,6,5,allow,1,0,Potential Threat
27005,30006,10243,30006,888,126,762,3,31,2,1,allow,1,0,Potential Threat
61184,445,0,0,70,70,0,1,0,1,0,drop,0,1,Known Attack
65269,445,0,0,70,70,0,1,0,1,0,drop,0,1,Known Attack
47643,80,39174,80,3524,2698,826,14,16,8,6,allow,1,0,Potential Threat
64571,443,18253,443,9155,2109,7046,27,31,15,12,allow,1,0,Potential Threat
51899,47537,54934,47537,70,70,0,2,8,2,0,allow,1,0,Potential Threat
45941,23386,0,0,60,60,0,1,0,1,0,deny,0,1,Known Attack
50541,80,22542,80,4296,3281,1015,12,33,7,5,allow,1,0,Potential Threat
65513,53,15039,53,195,102,93,2,31,1,1,allow,0,0,Normal
50149,80,2917,80,11574,901,10673,20,46,11,9,allow,1,0,Potential Threat
51088,443,60075,443,14025,7301,6724,38,171,22,16,allow,1,0,Potential Threat
43092,443,2375,443,7011,2541,4470,19,15,11,8,allow,1,0,Potential Threat
56586,53,54269,53,177,94,83,2,30,1,1,allow,0,0,Normal
63855,25174,0,0,146,146,0,1,0,1,0,deny,1,1,High Risk
57096,53,11827,53,198,102,96,2,30,1,1,allow,0,0,Normal
59787,445,0,0,66,66,0,1,0,1,0,drop,0,1,Known Attack
50356,445,0,0,66,66,0,1,0,1,0,drop,0,1,Known Attack
64321,445,0,0,70,70,0,1,0,1,0,drop,0,1,Known Attack
51790,46839,56676,46839,70,70,0,1,5,1,0,allow,1,0,Potential Threat
49163,445,0,0,70,70,0,1,0,1,0,drop,0,1,Known Attack
57228,53,5585,53,198,101,97,2,30,1,1,allow,0,0,Normal
27005,27016,31550,27016,884,126,758,2,30,1,1,allow,1,0,Potential Threat
53202,443,64942,443,3655,2344,1311,18,17,9,9,allow,1,0,Potential Threat
64287,53,8913,53,280,91,189,4,33,2,2,allow,0,0,Normal
47289,443,7853,443,16114,7882,8232,37,104,15,22,allow,1,0,Potential Threat
56756,53,46487,53,166,85,81,2,31,1,1,allow,0,0,Normal
58381,57470,0,0,66,66,0,1,0,1,0,deny,1,1,High Risk
58901,443,21819,443,5168,700,4468,16,15,7,9,allow,1,0,Potential Threat
63022,445,0,0,70,70,0,1,0,1,0,drop,0,1,Known Attack
39011,80,17481,80,1114,534,580,12,15,7,5,allow,1,0,Potential Threat
3478,61463,0,0,214,214,0,1,0,1,0,deny,1,1,High Risk
53162,443,22912,443,23929,10333,13596,51,43,25,26,allow,1,0,Potential Threat
63921,23758,6337,23758,312,132,180,6,7,3,3,allow,1,0,Potential Threat
64872,53,64528,53,166,86,80,2,31,1,1,allow,1,0,Potential Threat
55081,445,0,0,70,70,0,1,0,1,0,drop,0,1,Known Attack
26494,26467,0,0,62,62,0,1,0,1,0,deny,0,1,Known Attack
60210,445,0,0,70,70,0,1,0,1,0,drop,0,1,Known Attack
56672,53,24787,53,199,102,97,2,29,1,1,allow,0,0,Normal
54658,445,0,0,70,70,0,1,0,1,0,drop,0,1,Known Attack
58075,445,0,0,70,70,0,1,0,1,0,drop,0,1,Known Attack
60852,443,55582,443,7471,2914,4557,26,47,15,11,allow,1,0,Potential Threat
56045,53,39272,53,731,91,640,2,30,1,1,allow,0,0,Normal
49369,53,12483,53,168,86,82,2,31,1,1,allow,0,0,Normal
65112,445,0,0,70,70,0,1,0,1,0,drop,0,1,Known Attack
50021,53,13540,53,821,102,719,2,30,1,1,allow,0,0,Normal
7308,50584,0,0,66,66,0,1,0,1,0,deny,1,1,High Risk
60932,445,0,0,70,70,0,1,0,1,0,drop,0,1,Known Attack
59960,443,41281,443,1953,1223,730,16,16,9,7,allow,1,0,Potential Threat
52194,22674,46846,22674,70,70,0,2,8,2,0,allow,1,0,Potential Threat
44384,80,20153,80,51651,48866,2785,74,19,38,36,allow,1,0,Potential Threat
60099,445,0,0,70,70,0,1,0,1,0,drop,0,1,Known Attack
54781,445,0,0,66,66,0,1,0,1,0,drop,0,1,Known Attack
38323,443,27893,443,130,70,60,2,15,1,1,allow,0,0,Normal
56711,25174,0,0,62,62,0,1,0,1,0,deny,0,1,Known Attack
52220,445,0,0,70,70,0,1,0,1,0,drop,0,1,Known Attack
56403,53,56403,53,244,98,146,2,32,1,1,allow,0,0,Normal
55749,445,0,0,66,66,0,1,0,1,0,drop,0,1,Known Attack
49925,80,49556,80,1126,609,517,11,15,6,5,allow,0,0,Normal
44890,443,40961,443,2134,1397,737,18,1162,10,8,allow,1,0,Potential Threat
55386,37965,0,0,66,66,0,1,0,1,0,deny,0,1,Known Attack
27005,27016,57447,27016,885,126,759,2,30,1,1,allow,1,0,Potential Threat
54998,53,11974,53,179,94,85,2,30,1,1,allow,0,0,Normal
56724,53,16788,53,190,97,93,2,31,1,1,allow,0,0,Normal
49980,53,10608,53,503,103,400,4,47,2,2,allow,0,0,Normal
55508,53,1825,53,814,110,704,2,30,1,1,allow,0,0,Normal
53617,1056,21327,1056,320,140,180,6,6,3,3,allow,0,0,Normal
62766,443,26712,443,4911,3442,1469,29,322,16,13,allow,1,0,Potential Threat
54930,445,0,0,70,70,0,1,0,1,0,drop,0,1,Known Attack
62480,443,56428,443,1326,876,450,11,26,6,5,allow,1,0,Potential Threat
53540,34134,25153,34134,70,70,0,1,5,1,0,allow,1,0,Potential Threat
1100,27540,42086,27540,132,70,62,2,29,1,1,allow,1,0,Potential Threat
47732,80,47732,80,9621,1618,8003,19,20,10,9,allow,1,0,Potential Threat
49342,53,10156,53,443,182,261,6,30,3,3,allow,0,0,Normal
59493,44847,0,0,66,66,0,1,0,1,0,deny,0,1,Known Attack
58930,443,53896,443,70,70,0,1,5,1,0,allow,0,0,Normal
12232,41864,0,0,139,139,0,1,0,1,0,deny,1,1,High Risk
49539,53,64502,53,340,87,253,4,50,2,2,allow,1,0,Potential Threat
15333,60043,0,0,62,62,0,1,0,1,0,deny,1,1,High Risk
45550,80,42274,80,890,420,470,14,27,7,7,allow,0,0,Normal
57436,53,31842,53,182,93,89,2,30,1,1,allow,0,0,Normal
52410,8604,0,0,66,66,0,1,0,1,0,deny,0,1,Known Attack
0,0,0,0,60,60,0,1,0,1,0,deny,1,1,High Risk
61414,445,0,0,70,70,0,1,0,1,0,drop,0,1,Known Attack
48817,25636,48817,25636,481,150,331,2,1200,1,1,allow,1,0,Potential Threat
51880,8000,41455,8000,172,94,78,2,29,1,1,allow,1,0,Potential Threat
38606,53,21514,53,168,78,90,2,30,1,1,allow,0,0,Normal
64999,53,5804,53,178,94,84,2,29,1,1,allow,0,0,Normal
55293,445,0,0,70,70,0,1,0,1,0,drop,0,1,Known Attack
25108,53,24919,53,222,78,144,2,30,1,1,allow,0,0,Normal
49881,80,7229,80,1965,1450,515,7,87,5,2,allow,1,0,Potential Threat
65251,53,48559,53,198,101,97,2,30,1,1,allow,0,0,Normal
49359,53,28261,53,718,94,624,2,30,1,1,allow,0,0,Normal
62140,445,0,0,70,70,0,1,0,1,0,drop,0,1,Known Attack
55066,53,26532,53,815,95,720,2,31,1,1,allow,0,0,Normal
60498,55100,54000,55100,164,70,94,2,5,1,1,allow,1,0,Potential Threat
50660,443,1887,443,3845,1814,2031,19,38,11,8,allow,1,0,Potential Threat
49635,445,0,0,66,66,0,1,0,1,0,drop,0,1,Known Attack
50663,443,7277,443,7136,1421,5715,18,15,8,10,allow,1,0,Potential Threat
56428,30317,0,0,66,66,0,1,0,1,0,deny,0,1,Known Attack
65404,53,13922,53,256,94,162,2,30,1,1,allow,0,0,Normal
49418,27015,38933,27015,78,78,0,1,29,1,0,allow,1,0,Potential Threat
56958,53,40535,53,193,102,91,2,30,1,1,allow,0,0,Normal
19330,25174,0,0,62,62,0,1,0,1,0,deny,0,1,Known Attack
51869,443,60062,443,4435,1290,3145,17,31,9,8,allow,1,0,Potential Threat
52334,445,0,0,70,70,0,1,0,1,0,drop,0,1,Known Attack
49969,445,0,0,66,66,0,1,0,1,0,drop,0,1,Known Attack
42128,80,52556,80,1139,506,633,10,15,6,4,allow,1,0,Potential Threat
37616,443,22145,443,6506,1356,5150,24,16,14,10,allow,1,0,Potential Threat
42298,40020,48690,40020,148,86,62,2,30,1,1,allow,1,0,Potential Threat
64058,53,58322,53,280,110,170,2,30,1,1,allow,0,0,Normal
63813,53455,26592,53455,66,66,0,2,7,2,0,allow,1,0,Potential Threat
443,54507,0,0,82,82,0,1,0,1,0,deny,1,1,High Risk
55417,53,40418,53,179,94,85,2,30,1,1,allow,0,0,Normal
51425,37450,0,0,66,66,0,1,0,1,0,deny,0,1,Known Attack
50624,443,1028,443,12712,3662,9050,32,140,17,15,allow,1,0,Potential Threat
63040,53,20975,53,512,166,346,2,29,1,1,allow,0,0,Normal
64049,445,0,0,70,70,0,1,0,1,0,drop,0,1,Known Attack
2267,53,11454,53,204,118,86,2,31,1,1,allow,1,0,Potential Threat
49513,53,13327,53,200,102,98,2,31,1,1,allow,0,0,Normal
57339,443,64003,443,1778020,204978,1573042,2589,987,1006,1583,allow,1,0,Potential Threat
45144,25174,0,0,146,146,0,1,0,1,0,deny,1,1,High Risk
56427,53,42294,53,166,86,80,2,30,1,1,allow,0,0,Normal
53140,51221,0,0,74,74,0,1,0,1,0,deny,0,1,Known Attack
63046,445,0,0,70,70,0,1,0,1,0,drop,0,1,Known Attack
58659,53,58909,53,167,78,89,2,30,1,1,allow,0,0,Normal
57432,53,10564,53,193,102,91,2,31,1,1,allow,0,0,Normal
49234,53,56023,53,177,94,83,2,30,1,1,allow,0,0,Normal
55146,53,47251,53,181,94,87,2,30,1,1,allow,0,0,Normal
46673,80,11851,80,1151,711,440,10,15,5,5,allow,1,0,Potential Threat
41627,15000,9881,15000,130,70,60,2,5,1,1,allow,1,0,Potential Threat
50017,443,54344,443,51055,17321,33734,147,612,77,70,allow,1,0,Potential Threat
39839,22114,0,0,62,62,0,1,0,1,0,deny,0,1,Known Attack
50265,55243,25034,55243,481,150,331,2,1200,1,1,allow,1,0,Potential Threat
52322,443,52322,443,6926,828,6098,17,26,9,8,allow,1,0,Potential Threat
49909,445,0,0,66,66,0,1,0,1,0,drop,0,1,Known Attack
47700,51505,0,0,66,66,0,1,0,1,0,deny,0,1,Known Attack
63853,10659,14752,10659,66,66,0,2,8,2,0,allow,1,0,Potential Threat
56433,53,16233,53,204,104,100,2,30,1,1,allow,0,0,Normal
54836,443,5754,443,119863,100823,19040,322,229,183,139,allow,1,0,Potential Threat
443,46382,0,0,66,66,0,1,0,1,0,deny,1,1,High Risk
55711,26467,0,0,62,62,0,1,0,1,0,deny,0,1,Known Attack
64567,53,19362,53,199,102,97,2,30,1,1,allow,0,0,Normal
0,0,0,0,98,98,0,1,0,1,0,deny,1,1,High Risk
56648,53,44024,53,199,102,97,2,30,1,1,allow,0,0,Normal
59601,445,0,0,66,66,0,1,0,1,0,drop,0,1,Known Attack
40458,53,17783,53,168,78,90,2,31,1,1,allow,0,0,Normal
1660,8696,0,0,62,62,0,1,0,1,0,deny,1,1,High Risk
54999,443,63007,443,6430,1513,4917,26,40,14,12,allow,1,0,Potential Threat
1027,25174,0,0,62,62,0,1,0,1,0,deny,1,1,High Risk
56395,443,48597,443,77506,2940,74566,100,80,38,62,allow,1,0,Potential Threat
60466,445,0,0,66,66,0,1,0,1,0,drop,0,1,Known Attack
50561,80,19741,80,318,192,126,6,26,4,2,allow,0,0,Normal
52811,44847,0,0,66,66,0,1,0,1,0,deny,0,1,Known Attack
64256,445,0,0,70,70,0,1,0,1,0,drop,0,1,Known Attack
51798,80,50477,80,1825,824,1001,21,134,11,10,allow,1,0,Potential Threat
54957,80,50979,80,416,210,206,7,15,4,3,allow,0,0,Normal
20844,64147,0,0,66,66,0,1,0,1,0,deny,1,1,High Risk
55443,445,0,0,70,70,0,1,0,1,0,drop,0,1,Known Attack
56126,445,0,0,70,70,0,1,0,1,0,drop,0,1,Known Attack
56971,445,0,0,70,70,0,1,0,1,0,drop,0,1,Known Attack
57144,53,55905,53,178,94,84,2,30,1,1,allow,0,0,Normal
56006,445,0,0,70,70,0,1,0,1,0,drop,0,1,Known Attack
17735,53,27345,53,223,86,137,2,29,1,1,allow,0,0,Normal
37097,443,17597,443,1835,1190,645,17,26,10,7,allow,1,0,Potential Threat
16454,25174,0,0,66,66,0,1,0,1,0,deny,0,1,Known Attack
60853,445,0,0,66,66,0,1,0,1,0,drop,0,1,Known Attack
49752,53,61999,53,182,94,88,2,30,1,1,allow,0,0,Normal
35556,53,63282,53,168,78,90,2,30,1,1,allow,1,0,Potential Threat
27005,27020,51720,27020,1626,126,1500,4,30,2,2,allow,1,0,Potential Threat
59208,445,0,0,66,66,0,1,0,1,0,drop,0,1,Known Attack
62170,53,16163,53,234,94,140,2,29,1,1,allow,0,0,Normal
14394,443,16776,443,4649,2928,1721,40,415,21,19,allow,1,0,Potential Threat
49433,53,51324,53,278,94,184,2,30,1,1,allow,0,0,Normal
11295,40018,57800,40018,213,89,124,4,31,2,2,allow,1,0,Potential Threat
55084,445,0,0,70,70,0,1,0,1,0,drop,0,1,Known Attack
49905,53,25136,53,180,94,86,2,30,1,1,allow,0,0,Normal
58263,443,17697,443,12494,5331,7163,48,122,21,27,allow,1,0,Potential Threat
64617,53,10590,53,301,102,199,2,30,1,1,allow,0,0,Normal
49636,53,12225,53,180,94,86,2,30,1,1,allow,0,0,Normal
51260,80,52216,80,23175,13071,10104,134,1929,67,67,allow,1,0,Potential Threat
56936,80,5916,80,1490,886,604,10,75,6,4,allow,1,0,Potential Threat
53674,445,0,0,70,70,0,1,0,1,0,drop,0,1,Known Attack
52280,445,0,0,66,66,0,1,0,1,0,drop,0,1,Known Attack
65044,443,31714,443,4446,2496,1950,9,120,5,4,allow,1,0,Potential Threat
55100,53,26652,53,178,94,84,2,31,1,1,allow,0,0,Normal
59891,53,0,0,248,75,173,2,30,1,1,allow,0,0,Normal
65189,27015,44891,27015,255,78,177,2,30,1,1,allow,1,0,Potential Threat
1024,44847,0,0,146,146,0,1,0,1,0,deny,1,1,High Risk
50493,80,1565,80,318,192,126,6,25,4,2,allow,0,0,Normal
65254,445,0,0,70,70,0,1,0,1,0,drop,0,1,Known Attack
45941,23386,0,0,60,60,0,1,0,1,0,deny,0,1,Known Attack
56041,53,26244,53,179,94,85,2,30,1,1,allow,0,0,Normal
14844,37965,0,0,62,62,0,1,0,1,0,deny,1,1,High Risk
65531,53,44923,53,193,102,91,2,30,1,1,allow,0,0,Normal
57470,6881,57710,6881,453,251,202,4,1200,2,2,allow,1,0,Potential Threat
54772,445,0,0,70,70,0,1,0,1,0,drop,0,1,Known Attack
9605,57470,0,0,62,62,0,1,0,1,0,deny,1,1,High Risk
50347,445,0,0,66,66,0,1,0,1,0,drop,0,1,Known Attack
53887,445,0,0,70,70,0,1,0,1,0,drop,0,1,Known Attack
30274,23,0,0,60,60,0,1,0,1,0,deny,0,1,Known Attack
16403,16385,45121,16385,182,62,120,4,30,2,2,allow,1,0,Potential Threat
65460,445,0,0,70,70,0,1,0,1,0,drop,0,1,Known Attack
51846,41510,42814,41510,70,70,0,1,5,1,0,allow,1,0,Potential Threat
30960,45760,12069,45760,462,462,0,8,3632,8,0,allow,1,0,Potential Threat
46417,22114,0,0,146,146,0,1,0,1,0,deny,1,1,High Risk
58438,445,0,0,70,70,0,1,0,1,0,drop,0,1,Known Attack
55217,53,15991,53,744,89,655,2,31,1,1,allow,0,0,Normal
53392,445,0,0,70,70,0,1,0,1,0,drop,0,1,Known Attack
54976,2273,0,0,60,60,0,1,0,1,0,deny,0,1,Known Attack
58338,3353,0,0,60,60,0,1,0,1,0,deny,0,1,Known Attack
51165,445,0,0,70,70,0,1,0,1,0,drop,0,1,Known Attack
49519,53,62256,53,264,94,170,2,30,1,1,allow,0,0,Normal
64059,30188,0,0,62,62,0,1,0,1,0,deny,0,1,Known Attack
51944,445,0,0,70,70,0,1,0,1,0,drop,0,1,Known Attack
30948,50584,0,0,146,146,0,1,0,1,0,deny,1,1,High Risk
49172,53,13814,53,305,94,211,2,30,1,1,allow,0,0,Normal
56952,53,53652,53,487,136,351,4,46,2,2,allow,0,0,Normal
52387,445,0,0,70,70,0,1,0,1,0,drop,0,1,Known Attack
58638,5900,0,0,62,62,0,1,0,1,0,deny,0,1,Known Attack
58926,80,29286,80,1291,887,404,8,89,5,3,allow,1,0,Potential Threat
53894,2944,38557,2944,70,70,0,1,5,1,0,allow,0,0,Normal
55974,80,55609,80,613,539,74,7,15,6,1,allow,0,0,Normal
5588,5588,0,0,3354,1792,1562,46,193,23,23,allow,1,0,Potential Threat
27005,27018,58513,27018,888,126,762,2,30,1,1,allow,1,0,Potential Threat
27331,443,27331,443,1251,722,529,11,147,6,5,allow,1,0,Potential Threat
51632,445,0,0,70,70,0,1,0,1,0,drop,0,1,Known Attack
62329,53,9486,53,268,86,182,2,30,1,1,allow,0,0,Normal
55995,53,56863,53,182,94,88,2,30,1,1,allow,0,0,Normal
50861,443,62102,443,1501,590,911,12,26,6,6,allow,1,0,Potential Threat
62914,11392,0,0,62,62,0,1,0,1,0,deny,0,1,Known Attack
60722,445,0,0,66,66,0,1,0,1,0,drop,0,1,Known Attack
49661,445,0,0,70,70,0,1,0,1,0,drop,0,1,Known Attack
56176,53,13645,53,177,94,83,2,30,1,1,allow,0,0,Normal
52088,445,0,0,66,66,0,1,0,1,0,drop,0,1,Known Attack
55829,53,4732,53,208,106,102,2,31,1,1,allow,0,0,Normal
62691,445,0,0,70,70,0,1,0,1,0,drop,0,1,Known Attack
64204,53,35802,53,193,102,91,2,30,1,1,allow,0,0,Normal
53920,34914,18938,34914,1781,1103,678,15,17,9,6,allow,1,0,Potential Threat
55196,445,0,0,70,70,0,1,0,1,0,drop,0,1,Known Attack
57430,53,32678,53,200,102,98,2,30,1,1,allow,0,0,Normal
63823,51558,34606,51558,66,66,0,2,7,2,0,allow,1,0,Potential Threat
50917,80,57551,80,11626518,135099,11491419,9627,134,1907,7720,allow,1,0,Potential Threat
18657,53,18657,53,295,90,205,2,29,1,1,allow,0,0,Normal
56005,445,0,0,70,70,0,1,0,1,0,drop,0,1,Known Attack
64776,25174,0,0,66,66,0,1,0,1,0,deny,0,1,Known Attack
2890,53,28510,53,78,78,0,1,30,1,0,allow,1,0,Potential Threat
3504,23,0,0,60,60,0,1,0,1,0,deny,1,1,High Risk
1956,53,1956,53,240,98,142,2,30,1,1,allow,1,0,Potential Threat
25436,53,25436,53,220,90,130,2,30,1,1,allow,0,0,Normal
52869,445,0,0,70,70,0,1,0,1,0,drop,0,1,Known Attack
46531,123,21322,123,184,94,90,2,30,1,1,allow,0,0,Normal
65227,445,0,0,70,70,0,1,0,1,0,drop,0,1,Known Attack
35408,56205,0,0,66,66,0,1,0,1,0,deny,1,1,High Risk
55485,445,0,0,70,70,0,1,0,1,0,drop,0,1,Known Attack
30542,25174,0,0,62,62,0,1,0,1,0,deny,0,1,Known Attack
52430,445,0,0,70,70,0,1,0,1,0,drop,0,1,Known Attack
64467,80,64467,80,5570,699,4871,14,22,7,7,allow,1,0,Potential Threat
50894,445,0,0,70,70,0,1,0,1,0,drop,0,1,Known Attack
51982,56306,51670,56306,70,70,0,1,5,1,0,allow,1,0,Potential Threat
65422,53,8384,53,448,84,364,4,54,2,2,allow,1,0,Potential Threat
53831,54676,36346,54676,492,306,186,8,16,5,3,allow,1,0,Potential Threat
53762,9587,1266,9587,70,70,0,2,7,2,0,allow,1,0,Potential Threat
53540,34134,43313,34134,70,70,0,2,7,2,0,allow,1,0,Potential Threat
45941,23386,0,0,60,60,0,1,0,1,0,deny,0,1,Known Attack
49708,53,46475,53,193,102,91,2,30,1,1,allow,0,0,Normal
56578,53,41828,53,219,86,133,2,31,1,1,allow,0,0,Normal
48706,23393,0,0,60,60,0,1,0,1,0,deny,0,1,Known Attack
35666,443,50206,443,3389452,85022,3304430,3290,159,997,2293,allow,1,0,Potential Threat
50050,445,0,0,70,70,0,1,0,1,0,drop,0,1,Known Attack
50671,445,0,0,66,66,0,1,0,1,0,drop,0,1,Known Attack
51430,25174,0,0,146,146,0,1,0,1,0,deny,1,1,High Risk
59011,445,0,0,66,66,0,1,0,1,0,drop,0,1,Known Attack
49699,64147,0,0,66,66,0,1,0,1,0,deny,1,1,High Risk
50807,445,0,0,70,70,0,1,0,1,0,drop,0,1,Known Attack
56983,53,62235,53,221,94,127,2,29,1,1,allow,0,0,Normal
65331,53,50741,53,732,89,643,2,0,1,1,allow,1,0,Potential Threat
49863,8100,50615,8100,234,234,0,4,11,4,0,allow,1,0,Potential Threat
52951,80,38288,80,6266,4430,1836,22,358,13,9,allow,1,0,Potential Threat
58050,80,17128,80,318,192,126,6,20,4,2,allow,0,0,Normal
52740,445,0,0,70,70,0,1,0,1,0,drop,0,1,Known Attack
53510,445,0,0,70,70,0,1,0,1,0,drop,0,1,Known Attack
65049,443,55584,443,12674,1396,11278,12,139,2,10,allow,1,0,Potential Threat
50553,445,0,0,66,66,0,1,0,1,0,drop,0,1,Known Attack
3478,61463,0,0,1188,1188,0,1,0,1,0,deny,1,1,High Risk
56907,53,11065,53,193,102,91,2,31,1,1,allow,0,0,Normal
52027,445,0,0,66,66,0,1,0,1,0,drop,0,1,Known Attack
53532,53,52838,53,329,102,227,2,30,1,1,allow,0,0,Normal
57054,53,52774,53,241,94,147,2,29,1,1,allow,0,0,Normal
62638,445,0,0,70,70,0,1,0,1,0,drop,0,1,Known Attack
56916,445,0,0,66,66,0,1,0,1,0,drop,0,1,Known Attack
55312,53,10081,53,190,97,93,2,30,1,1,allow,0,0,Normal
38753,443,17390,443,29887852,586245,29301607,27419,299,7975,19444,allow,1,0,Potential Threat
56790,53,5516,53,747,92,655,2,31,1,1,allow,0,0,Normal
53161,30013,6313,30013,70,70,0,2,7,2,0,allow,1,0,Potential Threat
55072,53,58133,53,168,86,82,2,30,1,1,allow,0,0,Normal
49652,445,0,0,70,70,0,1,0,1,0,drop,0,1,Known Attack
49421,445,0,0,70,70,0,1,0,1,0,drop,0,1,Known Attack
56980,53,28670,53,267,87,180,4,38,2,2,allow,0,0,Normal
49915,35440,0,0,62,62,0,1,0,1,0,deny,0,1,Known Attack
51244,1,0,0,100,100,0,1,0,1,0,deny,0,1,Known Attack
63116,22114,0,0,146,146,0,1,0,1,0,deny,1,1,High Risk
26953,30317,0,0,62,62,0,1,0,1,0,deny,0,1,Known Attack
1912,48817,0,0,62,62,0,1,0,1,0,deny,1,1,High Risk
65026,53,30024,53,193,102,91,2,30,1,1,allow,0,0,Normal
60395,6890,18737,6890,70,70,0,1,5,1,0,allow,0,0,Normal
50089,445,0,0,70,70,0,1,0,1,0,drop,0,1,Known Attack
51961,80,32070,80,26804,11349,15455,45,26,25,20,allow,1,0,Potential Threat
57152,53,56256,53,720,94,626,2,30,1,1,allow,0,0,Normal
16382,17500,0,0,62,62,0,1,0,1,0,deny,0,1,Known Attack
56343,445,0,0,66,66,0,1,0,1,0,drop,0,1,Known Attack
52085,29894,54507,29894,136,136,0,3,14,3,0,allow,1,0,Potential Threat
80,37649,0,0,60,60,0,1,0,1,0,deny,1,1,High Risk
63882,445,0,0,70,70,0,1,0,1,0,drop,0,1,Known Attack
56986,53,20950,53,259,87,172,4,37,2,2,allow,0,0,Normal
63106,443,7897,443,8712,3748,4964,51,255,23,28,allow,1,0,Potential Threat
57492,443,47894,443,380975,82011,298964,804,171,343,461,allow,1,0,Potential Threat
64135,53,23762,53,196,102,94,2,30,1,1,allow,0,0,Normal
57236,53733,0,0,66,66,0,1,0,1,0,deny,0,1,Known Attack
49734,445,0,0,66,66,0,1,0,1,0,drop,0,1,Known Attack
56590,53,0,0,82,82,0,1,30,1,0,allow,0,0,Normal
59366,35440,0,0,66,66,0,1,0,1,0,deny,0,1,Known Attack
22904,56205,0,0,146,146,0,1,0,1,0,deny,1,1,High Risk
60895,443,6009,443,9387,2961,6426,38,18,23,15,allow,1,0,Potential Threat
54053,443,54053,443,1468,763,705,16,181,8,8,allow,1,0,Potential Threat
57256,445,0,0,70,70,0,1,0,1,0,drop,0,1,Known Attack
58420,445,0,0,66,66,0,1,0,1,0,drop,0,1,Known Attack
5826,26467,0,0,62,62,0,1,0,1,0,deny,1,1,High Risk
56813,37092,33767,37092,70,70,0,1,5,1,0,allow,1,0,Potential Threat
57434,50584,0,0,146,146,0,1,0,1,0,deny,1,1,High Risk
23589,53,23589,53,220,90,130,2,30,1,1,allow,0,0,Normal
15113,25174,0,0,146,146,0,1,0,1,0,deny,1,1,High Risk
8889,19777,0,0,60,60,0,1,0,1,0,deny,1,1,High Risk
50806,51505,0,0,66,66,0,1,0,1,0,deny,0,1,Known Attack
49471,80,33120,80,10175,1359,8816,18,78,7,11,allow,1,0,Potential Threat
5588,5588,0,0,3354,1792,1562,46,194,23,23,allow,1,0,Potential Threat
52076,80,2859,80,366,240,126,7,26,5,2,allow,0,0,Normal
56516,445,0,0,70,70,0,1,0,1,0,drop,0,1,Known Attack
49286,445,0,0,66,66,0,1,0,1,0,drop,0,1,Known Attack
56562,53,48636,53,182,93,89,2,31,1,1,allow,0,0,Normal
55534,53,10719,53,168,86,82,2,29,1,1,allow,0,0,Normal
64892,445,0,0,66,66,0,1,0,1,0,drop,0,1,Known Attack
61400,64147,0,0,66,66,0,1,0,1,0,deny,1,1,High Risk
62595,445,0,0,70,70,0,1,0,1,0,drop,0,1,Known Attack
49710,53,28433,53,480,93,387,4,50,2,2,allow,0,0,Normal
38053,50584,0,0,62,62,0,1,0,1,0,deny,0,1,Known Attack
51479,25174,0,0,66,66,0,1,0,1,0,deny,0,1,Known Attack
4296,53,43153,53,217,86,131,2,30,1,1,allow,1,0,Potential Threat
51274,24399,41980,24399,70,70,0,1,5,1,0,allow,1,0,Potential Threat
55190,443,14814,443,12801,4250,8551,40,118,21,19,allow,1,0,Potential Threat
50458,443,25872,443,523577,34256,489321,1025,208,473,552,allow,1,0,Potential Threat
30960,45739,64773,45739,330,330,0,6,3609,6,0,allow,1,0,Potential Threat
52186,57609,42161,57609,66,66,0,1,5,1,0,allow,1,0,Potential Threat
56492,443,36078,443,3715,1659,2056,35,188,18,17,allow,1,0,Potential Threat
55349,53,40115,53,701,88,613,2,31,1,1,allow,0,0,Normal
50581,53,15550,53,185,102,83,2,30,1,1,allow,0,0,Normal
57313,443,59852,443,134,60,74,3,5,2,1,allow,0,0,Normal
55966,53,61391,53,86,86,0,1,29,1,0,allow,0,0,Normal
53664,445,0,0,66,66,0,1,0,1,0,drop,0,1,Known Attack
49626,53,39799,53,969,86,883,2,30,1,1,allow,0,0,Normal
49487,53,6709,53,182,93,89,2,30,1,1,allow,0,0,Normal
62553,445,0,0,66,66,0,1,0,1,0,drop,0,1,Known Attack
45941,23388,0,0,60,60,0,1,0,1,0,deny,0,1,Known Attack
49763,443,64834,443,8439,1840,6599,21,127,11,10,allow,1,0,Potential Threat
50106,30317,0,0,66,66,0,1,0,1,0,deny,0,1,Known Attack
62088,56205,0,0,66,66,0,1,0,1,0,deny,1,1,High Risk
49180,80,59682,80,6158,654,5504,15,16,8,7,allow,1,0,Potential Threat
64934,53,64886,53,197,102,95,2,30,1,1,allow,1,0,Potential Threat
28875,51505,0,0,62,62,0,1,0,1,0,deny,1,1,High Risk
57470,20433,47061,20433,726,726,0,12,1200,12,0,allow,1,0,Potential Threat
54280,3396,0,0,60,60,0,1,0,1,0,deny,0,1,Known Attack
56098,55442,0,0,66,66,0,1,0,1,0,deny,0,1,Known Attack
62489,445,0,0,70,70,0,1,0,1,0,drop,0,1,Known Attack
56317,53,55686,53,182,93,89,2,31,1,1,allow,0,0,Normal
49443,80,19440,80,3642,1460,2182,23,143,12,11,allow,1,0,Potential Threat
34983,26543,0,0,145,145,0,1,0,1,0,deny,1,1,High Risk
32997,50584,0,0,62,62,0,1,0,1,0,deny,1,1,High Risk
49595,53,9542,53,180,94,86,2,30,1,1,allow,0,0,Normal
64406,50584,0,0,66,66,0,1,0,1,0,deny,1,1,High Risk
4773,53,4773,53,197,90,107,2,30,1,1,allow,1,0,Potential Threat
62392,15503,0,0,62,62,0,1,0,1,0,deny,0,1,Known Attack
54287,443,13671,443,122,62,60,2,15,1,1,allow,0,0,Normal
57000,80,51268,80,214,140,74,4,35,3,1,allow,0,0,Normal
50388,53,43330,53,94,94,0,1,29,1,0,allow,0,0,Normal
62705,443,33676,443,178,118,60,2,15,1,1,allow,0,0,Normal
61204,445,0,0,70,70,0,1,0,1,0,drop,0,1,Known Attack
52197,445,0,0,66,66,0,1,0,1,0,drop,0,1,Known Attack
62322,80,60035,80,384,384,0,7,34,7,0,allow,1,0,Potential Threat
64404,53,48455,53,224,94,130,2,30,1,1,allow,0,0,Normal
60620,80,60620,80,1916,1467,449,10,19,6,4,allow,1,0,Potential Threat
5223,16383,0,0,66,66,0,1,0,1,0,deny,1,1,High Risk
17750,51965,19962,51965,150,150,0,1,1200,1,0,allow,1,0,Potential Threat
53677,10657,55902,10657,70,70,0,1,4,1,0,allow,1,0,Potential Threat
57128,53,45410,53,755,93,662,2,31,1,1,allow,0,0,Normal
60307,445,0,0,66,66,0,1,0,1,0,drop,0,1,Known Attack
49327,443,21395,443,116686,4968,111718,116,53,31,85,allow,1,0,Potential Threat
49235,53,43539,53,164,78,86,2,29,1,1,allow,0,0,Normal
64670,53,60367,53,193,102,91,2,30,1,1,allow,0,0,Normal
49277,80,55324,80,254,128,126,5,16,3,2,allow,0,0,Normal
38320,51505,0,0,66,66,0,1,0,1,0,deny,0,1,Known Attack
57470,31114,57905,31114,528,528,0,9,1199,9,0,allow,1,0,Potential Threat
36125,443,36185,443,6620,1197,5423,22,129,12,10,allow,1,0,Potential Threat
58420,443,23233,443,17161,1619,15542,18,149,4,14,allow,1,0,Potential Threat
46719,443,39379,443,7261,3272,3989,22,45,13,9,allow,1,0,Potential Threat
63136,25174,0,0,62,62,0,1,0,1,0,deny,0,1,Known Attack
56557,53,41528,53,214,110,104,2,30,1,1,allow,0,0,Normal
59601,445,0,0,70,70,0,1,0,1,0,drop,0,1,Known Attack
33804,443,22331,443,5815,1128,4687,19,0,9,10,allow,1,0,Potential Threat
54573,80,38100,80,2091,823,1268,12,45,7,5,allow,0,0,Normal
56107,53,24230,53,194,102,92,2,30,1,1,allow,0,0,Normal
63974,53,33864,53,618,111,507,4,30,2,2,allow,0,0,Normal
50584,53,43253,53,174,89,85,2,31,1,1,allow,0,0,Normal
64900,53,45787,53,197,102,95,2,30,1,1,allow,0,0,Normal
49507,443,13013,443,4151,1015,3136,16,27,8,8,allow,1,0,Potential Threat
64021,53,7172,53,402,97,305,4,31,2,2,allow,0,0,Normal
57367,53,52070,53,177,94,83,2,30,1,1,allow,0,0,Normal
58825,443,1318,443,6357,4318,2039,22,16,11,11,allow,1,0,Potential Threat
42128,54532,0,0,60,60,0,1,0,1,0,deny,1,1,High Risk
51111,80,36793,80,1614,1300,314,10,15,5,5,allow,0,0,Normal
45993,443,45993,443,1494,898,596,12,142,6,6,allow,1,0,Potential Threat
47814,51505,0,0,62,62,0,1,0,1,0,deny,0,1,Known Attack
58792,443,15545,443,9278,6126,3152,27,16,15,12,allow,1,0,Potential Threat
15503,8624,29745,8624,491,150,341,2,1200,1,1,allow,1,0,Potential Threat
65071,53,11229,53,93,93,0,2,60,2,0,allow,0,0,Normal
50266,443,54511,443,21634,11226,10408,54,402,35,19,allow,1,0,Potential Threat
58638,5900,0,0,62,62,0,1,0,1,0,deny,0,1,Known Attack
49416,443,60402,443,625995,31468,594527,722,199,256,466,allow,1,0,Potential Threat
50569,443,18328,443,5941,1856,4085,22,81,13,9,allow,1,0,Potential Threat
50314,80,10727,80,1030,310,720,11,56,6,5,allow,0,0,Normal
64525,53,61457,53,199,102,97,2,30,1,1,allow,1,0,Potential Threat
47276,443,9154,443,9503,5267,4236,56,218,31,25,allow,1,0,Potential Threat
56905,80,13949,80,78,78,0,2,8,2,0,allow,0,0,Normal
49999,53,62191,53,316,91,225,4,46,2,2,allow,1,0,Potential Threat
49449,53,12310,53,216,110,106,2,30,1,1,allow,0,0,Normal
58859,445,0,0,70,70,0,1,0,1,0,drop,0,1,Known Attack
58638,5900,0,0,62,62,0,1,0,1,0,deny,0,1,Known Attack
61288,23,0,0,60,60,0,1,0,1,0,deny,0,1,Known Attack
55875,445,0,0,70,70,0,1,0,1,0,drop,0,1,Known Attack
40220,443,35161,443,5448,989,4459,22,84,10,12,allow,1,0,Potential Threat
65123,53,3182,53,193,102,91,2,29,1,1,allow,0,0,Normal
56077,80,49245,80,2481,529,1952,11,75,6,5,allow,0,0,Normal
50486,443,7512,443,1043,556,487,10,16,6,4,allow,1,0,Potential Threat
14092,80,14092,80,3182,2082,1100,18,86,10,8,allow,1,0,Potential Threat
49481,80,30554,80,11436,5021,6415,38,126,20,18,allow,1,0,Potential Threat
46715,443,4396,443,2945,779,2166,10,121,5,5,allow,1,0,Potential Threat
0,0,0,0,244,244,0,2,0,2,0,allow,1,0,Potential Threat
56581,445,0,0,66,66,0,1,0,1,0,drop,0,1,Known Attack
55835,53,25257,53,180,94,86,2,30,1,1,allow,0,0,Normal
56480,80,24972,80,289731,8487,281244,294,136,104,190,allow,1,0,Potential Threat
56583,53,58946,53,177,94,83,2,31,1,1,allow,0,0,Normal
38386,80,38386,80,6261,833,5428,15,20,8,7,allow,1,0,Potential Threat
57644,445,0,0,70,70,0,1,0,1,0,drop,0,1,Known Attack
50930,445,0,0,66,66,0,1,0,1,0,drop,0,1,Known Attack
63955,53,0,0,219,81,138,2,30,1,1,allow,0,0,Normal
52001,80,13411,80,546,300,246,10,25,6,4,allow,0,0,Normal
50265,31101,44674,31101,150,150,0,1,1200,1,0,allow,1,0,Potential Threat
64417,53,47310,53,369,94,275,4,49,2,2,allow,0,0,Normal
57074,53,64644,53,195,102,93,2,30,1,1,allow,1,0,Potential Threat
65124,53,4615,53,353,118,235,2,30,1,1,allow,0,0,Normal
64490,53,23595,53,280,118,162,2,30,1,1,allow,0,0,Normal
48388,44847,0,0,62,62,0,1,0,1,0,deny,0,1,Known Attack
50868,80,40174,80,12388,742,11646,18,130,7,11,allow,1,0,Potential Threat
58533,443,53373,443,17356,5096,12260,46,26,24,22,allow,1,0,Potential Threat
58038,51505,0,0,146,146,0,1,0,1,0,deny,1,1,High Risk
53799,443,27170,443,499,425,74,4,0,3,1,allow,0,0,Normal
5751,64147,0,0,66,66,0,1,0,1,0,deny,1,1,High Risk
50466,445,0,0,66,66,0,1,0,1,0,drop,0,1,Known Attack
64664,53,45386,53,250,86,164,4,33,2,2,allow,0,0,Normal
64055,45105,31145,45105,70,70,0,1,4,1,0,allow,1,0,Potential Threat
7275,13487,0,0,66,66,0,1,91,1,0,allow,1,0,Potential Threat
55467,53,15072,53,186,95,91,2,30,1,1,allow,0,0,Normal
54539,443,15655,443,4552,2230,2322,14,134,7,7,allow,1,0,Potential Threat
48640,47993,0,0,145,145,0,1,0,1,0,deny,1,1,High Risk
63917,57826,39527,57826,70,70,0,1,5,1,0,allow,1,0,Potential Threat
56192,53,12282,53,282,87,195,4,45,2,2,allow,0,0,Normal
56355,53,13355,53,184,94,90,2,30,1,1,allow,0,0,Normal
56759,53,4446,53,177,94,83,2,30,1,1,allow,0,0,Normal
65117,53,17216,53,198,102,96,2,30,1,1,allow,0,0,Normal
52357,445,0,0,70,70,0,1,0,1,0,drop,0,1,Known Attack
61008,5555,0,0,60,60,0,1,0,1,0,deny,0,1,Known Attack
54355,443,13555,443,15334,4707,10627,28,24,14,14,allow,1,0,Potential Threat
64835,53,41380,53,179,94,85,2,30,1,1,allow,0,0,Normal
53171,443,32050,443,11080,4277,6803,23,42,10,13,allow,1,0,Potential Threat
56700,80,19955,80,51889,4253,47636,68,64,31,37,allow,1,0,Potential Threat
9137,80,35596,80,908,842,66,7,18,6,1,allow,1,0,Potential Threat
64222,445,0,0,70,70,0,1,0,1,0,drop,0,1,Known Attack
56927,53,35589,53,183,94,89,2,30,1,1,allow,0,0,Normal
59543,445,0,0,70,70,0,1,0,1,0,drop,0,1,Known Attack
65289,53,7871,53,179,94,85,2,31,1,1,allow,0,0,Normal
56738,53,36120,53,264,87,177,4,37,2,2,allow,0,0,Normal
59833,53,25424,53,195,94,101,2,30,1,1,allow,0,0,Normal
56707,443,22633,443,8005,1985,6020,20,15,11,9,allow,1,0,Potential Threat
443,45788,0,0,332,332,0,1,0,1,0,deny,1,1,High Risk
64549,53,44048,53,273,86,187,2,30,1,1,allow,0,0,Normal
58326,80,34084,80,804,449,355,9,256,5,4,allow,1,0,Potential Threat
56280,53,50135,53,1335,87,1248,4,59,2,2,allow,0,0,Normal
60783,445,0,0,70,70,0,1,0,1,0,drop,0,1,Known Attack
49308,53,30302,53,195,102,93,2,31,1,1,allow,0,0,Normal
49128,443,6577,443,3062,1747,1315,17,16,9,8,allow,1,0,Potential Threat
64677,445,0,0,66,66,0,1,0,1,0,drop,0,1,Known Attack
65104,53,20417,53,198,94,104,2,30,1,1,allow,0,0,Normal
62824,37807,0,0,66,66,0,1,0,1,0,deny,0,1,Known Attack
63718,445,0,0,70,70,0,1,0,1,0,drop,0,1,Known Attack
53028,443,47549,443,12081,2070,10011,33,620,12,21,allow,1,0,Potential Threat
58643,445,0,0,70,70,0,1,0,1,0,drop,0,1,Known Attack
11458,2767,0,0,66,66,0,1,0,1,0,deny,0,1,Known Attack
51324,445,0,0,70,70,0,1,0,1,0,drop,0,1,Known Attack
58676,445,0,0,66,66,0,1,0,1,0,drop,0,1,Known Attack
55038,445,0,0,70,70,0,1,0,1,0,drop,0,1,Known Attack
55546,445,0,0,66,66,0,1,0,1,0,drop,0,1,Known Attack
48826,25174,0,0,66,66,0,1,0,1,0,deny,0,1,Known Attack
55647,53,8145,53,168,86,82,2,30,1,1,allow,0,0,Normal
55004,53,63304,53,270,102,168,2,30,1,1,allow,1,0,Potential Threat
65248,53,43627,53,212,110,102,2,29,1,1,allow,0,0,Normal
61338,445,0,0,70,70,0,1,0,1,0,drop,0,1,Known Attack
55244,445,0,0,70,70,0,1,0,1,0,drop,0,1,Known Attack
55580,53,4575,53,195,102,93,2,31,1,1,allow,0,0,Normal
34741,53,34741,53,414,268,146,3,33,2,1,allow,0,0,Normal
54446,445,0,0,70,70,0,1,0,1,0,drop,0,1,Known Attack
52308,53,36287,53,70,70,0,1,29,1,0,allow,0,0,Normal
50651,445,0,0,70,70,0,1,0,1,0,drop,0,1,Known Attack
27005,27015,8730,27015,913,126,787,2,30,1,1,allow,1,0,Potential Threat
57470,19853,37734,19853,132,132,0,3,1200,3,0,allow,1,0,Potential Threat
44207,44847,0,0,66,66,0,1,0,1,0,deny,0,1,Known Attack
59773,445,0,0,66,66,0,1,0,1,0,drop,0,1,Known Attack
45941,23388,0,0,60,60,0,1,0,1,0,deny,0,1,Known Attack
57287,443,20277,443,8960,2778,6182,31,20,16,15,allow,1,0,Potential Threat
56281,53,4042,53,177,94,83,2,30,1,1,allow,0,0,Normal
56627,443,41594,443,4499,947,3552,14,25,8,6,allow,1,0,Potential Threat
54020,443,45905,443,17529,8138,9391,39,31,17,22,allow,1,0,Potential Threat
54980,53,25043,53,763,101,662,2,30,1,1,allow,0,0,Normal
37998,26467,0,0,66,66,0,1,0,1,0,deny,0,1,Known Attack
9341,443,61165,443,3835,501,3334,14,15,7,7,allow,1,0,Potential Threat
54062,31573,0,0,66,66,0,1,0,1,0,deny,0,1,Known Attack
53789,47191,44143,47191,70,70,0,2,8,2,0,allow,1,0,Potential Threat
51777,445,0,0,70,70,0,1,0,1,0,drop,0,1,Known Attack
64516,443,9177,443,2649258,1156086,1493172,7283,5215,3384,3899,allow,1,0,Potential Threat
53776,37650,38223,37650,70,70,0,1,4,1,0,allow,1,0,Potential Threat
56824,443,13725,443,18356,13354,5002,47,34,29,18,allow,1,0,Potential Threat
10052,443,12703,443,1832,1113,719,18,110,10,8,allow,1,0,Potential Threat
54294,445,0,0,66,66,0,1,0,1,0,drop,0,1,Known Attack
2705,37,0,0,60,60,0,1,0,1,0,deny,1,1,High Risk
2717,31573,0,0,66,66,0,1,0,1,0,deny,1,1,High Risk
50717,445,0,0,66,66,0,1,0,1,0,drop,0,1,Known Attack
44889,23,0,0,60,60,0,1,0,1,0,deny,0,1,Known Attack
9321,443,54415,443,3345,432,2913,11,15,6,5,allow,1,0,Potential Threat
51759,445,0,0,70,70,0,1,0,1,0,drop,0,1,Known Attack
44883,53,44883,53,216,90,126,2,29,1,1,allow,0,0,Normal
14103,35440,0,0,62,62,0,1,0,1,0,deny,1,1,High Risk
53520,37553,29607,37553,70,70,0,1,4,1,0,allow,1,0,Potential Threat
60927,443,47688,443,3642,606,3036,13,119,6,7,allow,1,0,Potential Threat
49479,443,58848,443,4591,2492,2099,20,113,11,9,allow,1,0,Potential Threat
49432,80,52783,80,2231,899,1332,15,92,8,7,allow,1,0,Potential Threat
56334,53,34646,53,177,94,83,2,30,1,1,allow,0,0,Normal
63729,80,63729,80,7324,1017,6307,16,20,8,8,allow,1,0,Potential Threat
55620,20795,41932,20795,70,70,0,1,5,1,0,allow,1,0,Potential Threat
26900,27017,30872,27017,422,164,258,6,29,3,3,allow,1,0,Potential Threat
5222,1504,0,0,66,66,0,1,0,1,0,deny,0,1,Known Attack
58638,5900,0,0,62,62,0,1,0,1,0,deny,0,1,Known Attack
52324,443,60831,443,295493,16052,279441,394,68,186,208,allow,1,0,Potential Threat
20608,28189,0,0,60,60,0,1,0,1,0,deny,0,1,Known Attack
50196,53,48778,53,756,95,661,2,31,1,1,allow,0,0,Normal
9532,56205,0,0,146,146,0,1,0,1,0,deny,1,1,High Risk
60744,40010,53059,40010,316,136,180,6,5,3,3,allow,1,0,Potential Threat
53835,62413,0,0,62,62,0,1,0,1,0,deny,1,1,High Risk
50130,53,57806,53,174,89,85,2,30,1,1,allow,0,0,Normal
52346,445,0,0,66,66,0,1,0,1,0,drop,0,1,Known Attack
59864,443,10819,443,6066,833,5233,19,26,10,9,allow,1,0,Potential Threat
64160,445,0,0,70,70,0,1,0,1,0,drop,0,1,Known Attack
63300,445,0,0,70,70,0,1,0,1,0,drop,0,1,Known Attack
58424,445,0,0,66,66,0,1,0,1,0,drop,0,1,Known Attack
55340,445,0,0,70,70,0,1,0,1,0,drop,0,1,Known Attack
49730,53,58094,53,767,102,665,2,30,1,1,allow,0,0,Normal
52953,445,0,0,70,70,0,1,0,1,0,drop,0,1,Known Attack
49529,443,17894,443,9047,1436,7611,22,27,10,12,allow,1,0,Potential Threat
56786,443,47874,443,36203,1763,34440,46,119,17,29,allow,1,0,Potential Threat
62912,53,42026,53,214,76,138,2,30,1,1,allow,0,0,Normal
60004,445,0,0,70,70,0,1,0,1,0,drop,0,1,Known Attack
55581,53,6182,53,166,85,81,2,30,1,1,allow,0,0,Normal
45783,22114,0,0,62,62,0,1,0,1,0,deny,0,1,Known Attack
49540,50584,0,0,66,66,0,1,0,1,0,deny,0,1,Known Attack
49732,80,36115,80,5236,1070,4166,13,145,6,7,allow,1,0,Potential Threat
56688,53,20462,53,196,102,94,2,30,1,1,allow,0,0,Normal
55417,53,34497,53,198,102,96,2,33,1,1,allow,0,0,Normal
53172,56013,23634,56013,70,70,0,1,5,1,0,allow,1,0,Potential Threat
40657,443,5933,443,9869,2395,7474,36,129,20,16,allow,1,0,Potential Threat
55087,53,44618,53,344,110,234,2,30,1,1,allow,0,0,Normal
49240,445,0,0,70,70,0,1,0,1,0,drop,0,1,Known Attack
49340,53,43709,53,94,94,0,1,30,1,0,allow,0,0,Normal
52218,80,52218,80,1921,1472,449,10,20,6,4,allow,1,0,Potential Threat
51271,37965,0,0,66,66,0,1,0,1,0,deny,0,1,Known Attack
65515,53,22832,53,338,107,231,4,39,2,2,allow,0,0,Normal
56928,53,33620,53,172,88,84,2,30,1,1,allow,0,0,Normal
37075,80,59950,80,1597,783,814,10,15,5,5,allow,1,0,Potential Threat
64052,445,0,0,70,70,0,1,0,1,0,drop,0,1,Known Attack
55831,53,4843,53,183,94,89,2,30,1,1,allow,0,0,Normal
9104,26296,0,0,157,157,0,1,0,1,0,deny,1,1,High Risk
59343,53,0,0,178,72,106,2,29,1,1,allow,0,0,Normal
65221,53,38871,53,258,102,156,2,29,1,1,allow,0,0,Normal
53576,23505,46519,23505,70,70,0,1,5,1,0,allow,1,0,Potential Threat
51934,443,39970,443,9735,2891,6844,36,82,17,19,allow,1,0,Potential Threat
52459,33890,0,0,60,60,0,1,0,1,0,deny,0,1,Known Attack
3976,25174,0,0,62,62,0,1,0,1,0,deny,1,1,High Risk
50722,80,43079,80,7550,5292,2258,13,29,7,6,allow,1,0,Potential Threat
65249,25864,0,0,72,72,0,1,0,1,0,deny,0,1,Known Attack
63334,37807,0,0,66,66,0,1,0,1,0,deny,0,1,Known Attack
64999,53,11642,53,757,98,659,2,31,1,1,allow,0,0,Normal
56760,53,34251,53,216,102,114,2,30,1,1,allow,0,0,Normal
49951,80,47463,80,38898,1623,37275,49,15,21,28,allow,1,0,Potential Threat
55088,53,21749,53,177,94,83,2,30,1,1,allow,0,0,Normal
49505,443,22158,443,3182,1568,1614,8,120,4,4,allow,1,0,Potential Threat
52275,445,0,0,70,70,0,1,0,1,0,drop,0,1,Known Attack
49782,445,0,0,70,70,0,1,0,1,0,drop,0,1,Known Attack
53027,443,45299,443,26309,3035,23274,69,92,27,42,allow,1,0,Potential Threat
54464,445,0,0,66,66,0,1,0,1,0,drop,0,1,Known Attack
50280,57470,0,0,78,78,0,1,0,1,0,deny,1,1,High Risk
57802,443,19538,443,37181,32491,4690,93,81,54,39,allow,1,0,Potential Threat
65241,53,34581,53,198,102,96,2,30,1,1,allow,0,0,Normal
50502,445,0,0,66,66,0,1,0,1,0,drop,0,1,Known Attack
64109,53,30318,53,225,102,123,2,30,1,1,allow,0,0,Normal
0,0,0,0,124,64,60,2,0,1,1,allow,1,0,Potential Threat
64063,37832,22712,37832,70,70,0,1,4,1,0,allow,1,0,Potential Threat
53816,445,0,0,70,70,0,1,0,1,0,drop,0,1,Known Attack
55000,53,31472,53,193,102,91,2,29,1,1,allow,0,0,Normal
60413,43555,1703,43555,70,70,0,1,5,1,0,allow,1,0,Potential Threat
18592,44612,0,0,62,62,0,1,0,1,0,deny,1,1,High Risk
55601,53,28384,53,177,94,83,2,30,1,1,allow,0,0,Normal
58943,443,29236,443,6611,4273,2338,22,17,11,11,allow,1,0,Potential Threat
61315,48817,0,0,62,62,0,1,0,1,0,deny,1,1,High Risk
58145,1433,58145,1433,60,60,0,2,5,2,0,allow,1,0,Potential Threat
51164,445,0,0,66,66,0,1,0,1,0,drop,0,1,Known Attack
63047,445,0,0,70,70,0,1,0,1,0,drop,0,1,Known Attack
56955,53,57810,53,182,93,89,2,31,1,1,allow,0,0,Normal
58638,5900,0,0,62,62,0,1,0,1,0,deny,0,1,Known Attack
51411,443,6428,443,5550,1177,4373,24,80,13,11,allow,1,0,Potential Threat
41486,1433,0,0,60,60,0,1,0,1,0,deny,0,1,Known Attack
59668,50584,0,0,66,66,0,1,0,1,0,deny,0,1,Known Attack
55261,53,40486,53,716,95,621,2,31,1,1,allow,0,0,Normal
50483,80,35746,80,374,192,182,7,25,4,3,allow,0,0,Normal
53754,443,24588,443,499,425,74,4,0,3,1,allow,0,0,Normal
64093,64828,28561,64828,66,66,0,2,7,2,0,allow,1,0,Potential Threat
64710,53,1727,53,195,102,93,2,29,1,1,allow,0,0,Normal
45908,33330,0,0,60,60,0,1,0,1,0,deny,0,1,Known Attack
443,22323,0,0,83,83,0,1,0,1,0,deny,1,1,High Risk
58870,443,34912,443,21207,14062,7145,50,19,28,22,allow,1,0,Potential Threat
49508,53,61449,53,370,102,268,2,30,1,1,allow,0,0,Normal
60686,445,0,0,70,70,0,1,0,1,0,drop,0,1,Known Attack
49676,53,26255,53,216,110,106,2,30,1,1,allow,0,0,Normal
55867,53,4524,53,184,94,90,2,31,1,1,allow,0,0,Normal
26424,27189,0,0,66,66,0,1,0,1,0,deny,0,1,Known Attack
36103,443,46915,443,130,70,60,2,15,1,1,allow,0,0,Normal
52270,443,52270,443,1615,941,674,15,20,7,8,allow,1,0,Potential Threat
51738,445,0,0,70,70,0,1,0,1,0,drop,0,1,Known Attack
64727,25174,0,0,66,66,0,1,0,1,0,deny,0,1,Known Attack
53556,1024,53867,1024,70,70,0,2,8,2,0,allow,0,0,Normal
56276,443,43498,443,71414,17145,54269,194,292,91,103,allow,1,0,Potential Threat
56327,44512,0,0,66,66,0,1,0,1,0,deny,0,1,Known Attack
63975,445,0,0,70,70,0,1,0,1,0,drop,0,1,Known Attack
30188,15370,58525,15370,10190,4774,5416,64,1490,32,32,allow,1,0,Potential Threat
40294,28680,0,0,145,145,0,1,0,1,0,deny,1,1,High Risk
50432,5222,28391,5222,28281,9813,18468,196,608,100,96,allow,1,0,Potential Threat
64997,51221,0,0,66,66,0,1,0,1,0,deny,1,1,High Risk
2078,7000,2078,7000,3006,1615,1391,15,15,8,7,allow,1,0,Potential Threat
54988,445,0,0,66,66,0,1,0,1,0,drop,0,1,Known Attack
57929,445,0,0,70,70,0,1,0,1,0,drop,0,1,Known Attack
63314,57470,0,0,66,66,0,1,0,1,0,deny,1,1,High Risk
58638,5900,0,0,62,62,0,1,0,1,0,deny,0,1,Known Attack
60232,445,0,0,66,66,0,1,0,1,0,drop,0,1,Known Attack
49662,445,0,0,70,70,0,1,0,1,0,drop,0,1,Known Attack
52643,15941,0,0,66,66,0,1,0,1,0,deny,0,1,Known Attack
56553,53,14002,53,198,101,97,2,30,1,1,allow,0,0,Normal
64936,445,0,0,66,66,0,1,0,1,0,drop,0,1,Known Attack
12348,50265,0,0,62,62,0,1,0,1,0,deny,1,1,High Risk
52006,49849,11177,49849,70,70,0,2,7,2,0,allow,1,0,Potential Threat
51622,445,0,0,70,70,0,1,0,1,0,drop,0,1,Known Attack
62947,53,18275,53,213,86,127,2,30,1,1,allow,0,0,Normal
55434,53,17321,53,1335,87,1248,4,38,2,2,allow,0,0,Normal
51519,443,51519,443,8680,2323,6357,31,173,13,18,allow,1,0,Potential Threat
27005,23333,15007,23333,890,126,764,2,30,1,1,allow,1,0,Potential Threat
65518,53,19504,53,701,88,613,2,30,1,1,allow,0,0,Normal
15503,7750,61935,7750,858,858,0,14,1200,14,0,allow,1,0,Potential Threat
50692,445,0,0,70,70,0,1,0,1,0,drop,0,1,Known Attack
54210,36237,0,0,62,62,0,1,0,1,0,deny,0,1,Known Attack
49372,53,57735,53,210,110,100,2,30,1,1,allow,0,0,Normal
55763,8060,49115,8060,70,70,0,2,7,2,0,allow,1,0,Potential Threat
50502,445,0,0,70,70,0,1,0,1,0,drop,0,1,Known Attack
26527,25174,0,0,66,66,0,1,0,1,0,deny,0,1,Known Attack
34731,22114,0,0,146,146,0,1,0,1,0,deny,1,1,High Risk
57169,53,49234,53,177,94,83,2,30,1,1,allow,0,0,Normal
21502,44847,0,0,66,66,0,1,0,1,0,deny,1,1,High Risk
56448,53,9031,53,200,102,98,2,30,1,1,allow,0,0,Normal
59880,443,7834,443,16776,7513,9263,42,47,24,18,allow,1,0,Potential Threat
55386,37965,0,0,66,66,0,1,0,1,0,deny,0,1,Known Attack
51268,445,0,0,70,70,0,1,0,1,0,drop,0,1,Known Attack
63869,34368,47992,34368,66,66,0,2,8,2,0,allow,1,0,Potential Threat
9195,80,8495,80,2819,541,2278,12,31,6,6,allow,1,0,Potential Threat
57729,19750,0,0,66,66,0,1,0,1,0,deny,0,1,Known Attack
64053,53,7121,53,186,95,91,2,31,1,1,allow,0,0,Normal
64004,48339,32132,48339,70,70,0,1,4,1,0,allow,1,0,Potential Threat
44847,51365,14892,51365,509,150,359,2,1200,1,1,allow,1,0,Potential Threat
50651,25174,0,0,146,146,0,1,0,1,0,deny,1,1,High Risk
49204,445,0,0,66,66,0,1,0,1,0,drop,0,1,Known Attack
57482,445,0,0,70,70,0,1,0,1,0,drop,0,1,Known Attack
58524,445,0,0,70,70,0,1,0,1,0,drop,0,1,Known Attack
54586,161,0,0,14172,5597,8575,50,31,25,25,allow,1,0,Potential Threat
56880,53,23570,53,202,103,99,2,31,1,1,allow,0,0,Normal
63939,3389,63939,3389,4134,2109,2025,18,17,9,9,allow,1,0,Potential Threat
54977,53,39208,53,275,93,182,4,31,2,2,allow,0,0,Normal
43146,80,15239,80,1102,545,557,10,16,6,4,allow,0,0,Normal
62838,44847,0,0,66,66,0,1,0,1,0,deny,0,1,Known Attack
49177,53,40047,53,184,94,90,2,31,1,1,allow,0,0,Normal
52858,443,52858,443,313243,267937,45306,456,5925,210,246,allow,1,0,Potential Threat
26531,25174,0,0,62,62,0,1,0,1,0,deny,0,1,Known Attack
64837,53,35241,53,195,102,93,2,31,1,1,allow,0,0,Normal
28194,32468,0,0,62,62,0,1,0,1,0,deny,0,1,Known Attack
51558,37965,0,0,72,72,0,1,0,1,0,deny,0,1,Known Attack
50137,445,0,0,70,70,0,1,0,1,0,drop,0,1,Known Attack
35735,80,48997,80,1155,781,374,10,15,6,4,allow,1,0,Potential Threat
65126,53,60546,53,718,94,624,2,30,1,1,allow,1,0,Potential Threat
63029,445,0,0,70,70,0,1,0,1,0,drop,0,1,Known Attack
57111,53,59340,53,199,94,105,2,30,1,1,allow,0,0,Normal
1666,53,1666,53,217,90,127,2,30,1,1,allow,1,0,Potential Threat
55003,53,31448,53,196,102,94,2,30,1,1,allow,0,0,Normal
56986,53,24262,53,170,87,83,2,30,1,1,allow,0,0,Normal
54956,53,35292,53,711,87,624,2,31,1,1,allow,0,0,Normal
55098,53,8835,53,176,90,86,2,30,1,1,allow,0,0,Normal
64449,30188,0,0,66,66,0,1,0,1,0,deny,0,1,Known Attack
45410,1,0,0,62,62,0,1,0,1,0,deny,0,1,Known Attack
7992,64147,0,0,62,62,0,1,0,1,0,deny,1,1,High Risk
50369,443,20659,443,8048,1189,6859,19,25,10,9,allow,1,0,Potential Threat
49915,53,47403,53,225,102,123,2,30,1,1,allow,0,0,Normal
50280,445,0,0,66,66,0,1,0,1,0,drop,0,1,Known Attack
49262,443,12479,443,4353,1227,3126,12,135,6,6,allow,1,0,Potential Threat
52021,32202,58767,32202,70,70,0,2,8,2,0,allow,1,0,Potential Threat
65050,445,0,0,66,66,0,1,0,1,0,drop,0,1,Known Attack
38117,443,59236,443,8598,3880,4718,23,200,13,10,allow,1,0,Potential Threat
58744,80,31824,80,4635,1572,3063,12,15,7,5,allow,0,0,Normal
64494,445,0,0,66,66,0,1,0,1,0,drop,0,1,Known Attack
60724,445,0,0,66,66,0,1,0,1,0,drop,0,1,Known Attack
56988,53,43201,53,216,110,106,2,30,1,1,allow,0,0,Normal
6037,43890,0,0,74,74,0,1,0,1,0,deny,1,1,High Risk
50552,443,41023,443,8311,3156,5155,29,17,16,13,allow,1,0,Potential Threat
56748,445,0,0,70,70,0,1,0,1,0,drop,0,1,Known Attack
53808,56215,4312,56215,70,70,0,1,4,1,0,allow,1,0,Potential Threat
3478,61463,0,0,1063,1063,0,1,0,1,0,deny,1,1,High Risk
51380,445,0,0,66,66,0,1,0,1,0,drop,0,1,Known Attack
50769,445,0,0,70,70,0,1,0,1,0,drop,0,1,Known Attack
55927,445,0,0,70,70,0,1,0,1,0,drop,0,1,Known Attack
63927,50265,0,0,62,62,0,1,0,1,0,deny,1,1,High Risk
56771,53,26360,53,193,102,91,2,31,1,1,allow,0,0,Normal
48478,49903,0,0,62,62,0,1,0,1,0,deny,0,1,Known Attack
55726,32463,19971,32463,70,70,0,1,5,1,0,allow,1,0,Potential Threat
45624,443,55280,443,6697,1606,5091,23,17,13,10,allow,1,0,Potential Threat
53538,33791,33383,33791,618,432,186,9,17,6,3,allow,1,0,Potential Threat
60022,443,9132,443,6906,1458,5448,24,16,14,10,allow,1,0,Potential Threat
40845,64147,0,0,62,62,0,1,0,1,0,deny,1,1,High Risk
26501,80,26501,80,93644,8868,84776,131,31,64,67,allow,1,0,Potential Threat
59759,53,58276,53,211,78,133,2,30,1,1,allow,0,0,Normal
55560,53,36102,53,166,86,80,2,30,1,1,allow,0,0,Normal
61800,445,0,0,70,70,0,1,0,1,0,drop,0,1,Known Attack
60479,25174,0,0,66,66,0,1,0,1,0,deny,0,1,Known Attack
58781,443,55654,443,6133,1655,4478,12,120,5,7,allow,1,0,Potential Threat
65075,53,3072,53,278,100,178,4,31,2,2,allow,1,0,Potential Threat
25756,22114,0,0,146,146,0,1,0,1,0,deny,1,1,High Risk
60145,445,0,0,70,70,0,1,0,1,0,drop,0,1,Known Attack
58117,445,0,0,70,70,0,1,0,1,0,drop,0,1,Known Attack
62640,443,62640,443,27723,5572,22151,59,47,31,28,allow,1,0,Potential Threat
50045,53,44466,53,168,86,82,2,31,1,1,allow,0,0,Normal
50109,53,52643,53,198,110,88,2,31,1,1,allow,0,0,Normal
49651,445,0,0,70,70,0,1,0,1,0,drop,0,1,Known Attack
60452,443,43264,443,5807,2168,3639,17,135,8,9,allow,1,0,Potential Threat
58813,445,0,0,70,70,0,1,0,1,0,drop,0,1,Known Attack
38852,37965,0,0,62,62,0,1,0,1,0,deny,0,1,Known Attack
19594,23117,0,0,66,66,0,1,0,1,0,deny,0,1,Known Attack
56643,445,0,0,66,66,0,1,0,1,0,drop,0,1,Known Attack
64274,445,0,0,70,70,0,1,0,1,0,drop,0,1,Known Attack
49779,445,0,0,70,70,0,1,0,1,0,drop,0,1,Known Attack
65436,53,49533,53,286,90,196,4,55,2,2,allow,0,0,Normal
54527,443,27649,443,13132,7107,6025,45,174,23,22,allow,1,0,Potential Threat
33571,443,51011,443,4281,1160,3121,12,122,6,6,allow,1,0,Potential Threat
56962,80,49373,80,8730,5681,3049,21,31,12,9,allow,1,0,Potential Threat
56791,445,0,0,70,70,0,1,0,1,0,drop,0,1,Known Attack
50351,80,28696,80,1083,653,430,8,15,5,3,allow,0,0,Normal
51009,445,0,0,70,70,0,1,0,1,0,drop,0,1,Known Attack
443,20995,0,0,83,83,0,1,0,1,0,deny,1,1,High Risk
54737,50584,0,0,66,66,0,1,0,1,0,deny,0,1,Known Attack
60880,443,53335,443,12278,1931,10347,32,56,18,14,allow,1,0,Potential Threat
59363,443,28293,443,15860,1930,13930,37,195,14,23,allow,1,0,Potential Threat
56327,53,30596,53,199,102,97,2,30,1,1,allow,0,0,Normal
62292,445,0,0,70,70,0,1,0,1,0,drop,0,1,Known Attack
52191,445,0,0,70,70,0,1,0,1,0,drop,0,1,Known Attack
50584,18047,33742,18047,851,369,482,5,1200,3,2,allow,1,0,Potential Threat
49418,27018,42742,27018,274,78,196,2,31,1,1,allow,1,0,Potential Threat
40165,443,53877,443,232,172,60,3,5,2,1,allow,0,0,Normal
42936,53,47625,53,199,94,105,2,30,1,1,allow,0,0,Normal
18085,26467,0,0,66,66,0,1,0,1,0,deny,0,1,Known Attack
58638,5900,0,0,62,62,0,1,0,1,0,deny,0,1,Known Attack
46949,53,11241,53,168,78,90,2,29,1,1,allow,0,0,Normal
56767,443,38617,443,7941,1952,5989,20,15,11,9,allow,1,0,Potential Threat
49686,445,0,0,70,70,0,1,0,1,0,drop,0,1,Known Attack
65315,53,23256,53,178,94,84,2,30,1,1,allow,0,0,Normal
59900,443,59900,443,5980,1122,4858,18,58,9,9,allow,1,0,Potential Threat
50520,80,14281,80,1615,793,822,13,91,7,6,allow,0,0,Normal
58754,53,0,0,627,80,547,2,30,1,1,allow,0,0,Normal
50265,58840,23141,58840,132,132,0,3,1200,3,0,allow,1,0,Potential Threat
3440,7000,3440,7000,3127,676,2451,15,19,7,8,allow,1,0,Potential Threat
64772,64147,0,0,66,66,0,1,0,1,0,deny,1,1,High Risk
63562,445,0,0,70,70,0,1,0,1,0,drop,0,1,Known Attack
80,34539,80,34539,1468,1468,0,1,5,1,0,allow,1,0,Potential Threat
57121,445,0,0,70,70,0,1,0,1,0,drop,0,1,Known Attack
58794,5222,61380,5222,47445,16812,30633,144,870,65,79,allow,1,0,Potential Threat
65530,53,49295,53,381,88,293,4,31,2,2,allow,0,0,Normal
64074,53,30034,53,209,110,99,2,29,1,1,allow,0,0,Normal
55354,53,62421,53,214,110,104,2,30,1,1,allow,0,0,Normal
47971,443,21107,443,9021,1511,7510,21,121,11,10,allow,1,0,Potential Threat
37990,49152,47344,49152,156,156,0,3,7,3,0,allow,1,0,Potential Threat
58866,53,56575,53,355,118,237,2,29,1,1,allow,0,0,Normal
48706,23393,0,0,60,60,0,1,0,1,0,deny,0,1,Known Attack
27992,443,34351,443,7775,3104,4671,18,76,10,8,allow,1,0,Potential Threat
56160,53,10248,53,94,94,0,1,30,1,0,allow,0,0,Normal
53630,445,0,0,70,70,0,1,0,1,0,drop,0,1,Known Attack
42298,443,6175,443,70,70,0,1,30,1,0,allow,0,0,Normal
57905,80,48820,80,12974,3246,9728,29,29,16,13,allow,1,0,Potential Threat
40819,30975,0,0,157,157,0,1,0,1,0,deny,1,1,High Risk
60344,445,0,0,70,70,0,1,0,1,0,drop,0,1,Known Attack
54936,80,14845,80,613,539,74,7,15,6,1,allow,0,0,Normal
53606,54476,23615,54476,320,140,180,6,6,3,3,allow,1,0,Potential Threat
52618,445,0,0,66,66,0,1,0,1,0,drop,0,1,Known Attack
65238,53,13271,53,86,86,0,1,30,1,0,allow,0,0,Normal
59959,80,18461,80,1052,612,440,10,16,5,5,allow,1,0,Potential Threat
64127,53,10956,53,471,182,289,6,57,3,3,allow,1,0,Potential Threat
64814,16386,26637,16386,432,192,240,8,30,4,4,allow,1,0,Potential Threat
60022,443,60022,443,18674,1910,16764,32,18,17,15,allow,1,0,Potential Threat
57167,53,41895,53,195,102,93,2,30,1,1,allow,0,0,Normal
50023,53,49657,53,166,86,80,2,29,1,1,allow,0,0,Normal
54655,445,0,0,70,70,0,1,0,1,0,drop,0,1,Known Attack
63685,445,0,0,70,70,0,1,0,1,0,drop,0,1,Known Attack
56673,53,13282,53,183,94,89,2,30,1,1,allow,0,0,Normal
59274,445,0,0,70,70,0,1,0,1,0,drop,0,1,Known Attack
49684,445,0,0,66,66,0,1,0,1,0,drop,0,1,Known Attack
53164,443,1379,443,7434,1695,5739,23,27,12,11,allow,1,0,Potential Threat
61471,445,0,0,70,70,0,1,0,1,0,drop,0,1,Known Attack
49308,22114,0,0,66,66,0,1,0,1,0,deny,0,1,Known Attack
64290,53,4027,53,302,98,204,4,47,2,2,allow,1,0,Potential Threat
49418,27015,22382,27015,243,78,165,2,31,1,1,allow,1,0,Potential Threat
56941,53,32595,53,212,102,110,2,30,1,1,allow,0,0,Normal
46619,123,26763,123,184,94,90,2,30,1,1,allow,0,0,Normal
33453,64147,0,0,62,62,0,1,0,1,0,deny,1,1,High Risk
11228,25174,0,0,66,66,0,1,0,1,0,deny,0,1,Known Attack
56418,53,6346,53,183,94,89,2,29,1,1,allow,0,0,Normal
49814,445,0,0,70,70,0,1,0,1,0,drop,0,1,Known Attack
25583,2323,0,0,60,60,0,1,0,1,0,deny,0,1,Known Attack
58883,443,6061,443,5476,3102,2374,42,132,23,19,allow,1,0,Potential Threat
64950,53,8334,53,186,95,91,2,31,1,1,allow,0,0,Normal
59761,53,13611,53,569,164,405,2,31,1,1,allow,0,0,Normal
49631,53,64330,53,198,102,96,2,33,1,1,allow,1,0,Potential Threat
60461,443,30128,443,18515,2899,15616,32,148,15,17,allow,1,0,Potential Threat
60384,64170,40565,64170,504,318,186,8,16,5,3,allow,1,0,Potential Threat
56041,53,56903,53,179,94,85,2,30,1,1,allow,0,0,Normal
50286,443,30253,443,10203,2365,7838,40,86,22,18,allow,1,0,Potential Threat
41672,53,20887,53,240,76,164,2,30,1,1,allow,0,0,Normal
49256,445,0,0,66,66,0,1,0,1,0,drop,0,1,Known Attack
62430,445,0,0,70,70,0,1,0,1,0,drop,0,1,Known Attack
45363,443,50809,443,2396,1144,1252,14,982,7,7,allow,1,0,Potential Threat
35449,443,35449,443,157435,9243,148192,220,97,101,119,allow,1,0,Potential Threat
443,45788,0,0,332,332,0,1,0,1,0,deny,1,1,High Risk
56494,15503,0,0,146,146,0,1,0,1,0,deny,0,1,Known Attack
52121,58933,11142,58933,66,66,0,1,5,1,0,allow,1,0,Potential Threat
49856,80,12008,80,13992,1645,12347,23,89,10,13,allow,1,0,Potential Threat
56166,53,54206,53,193,102,91,2,29,1,1,allow,0,0,Normal
50487,445,0,0,70,70,0,1,0,1,0,drop,0,1,Known Attack
49418,27015,50232,27015,286,78,208,2,31,1,1,allow,1,0,Potential Threat
38085,443,21750,443,234,234,0,4,12,4,0,allow,0,0,Normal
55540,443,32830,443,10458,5272,5186,24,76,13,11,allow,1,0,Potential Threat
61686,80,38395,80,4004,1513,2491,20,47,10,10,allow,1,0,Potential Threat
9522,51505,0,0,66,66,0,1,0,1,0,deny,1,1,High Risk
27005,27022,10825,27022,890,126,764,2,31,1,1,allow,1,0,Potential Threat
26192,23,0,0,60,60,0,1,0,1,0,deny,0,1,Known Attack
18246,64097,0,0,66,66,0,1,0,1,0,deny,1,1,High Risk
56945,53,27105,53,176,90,86,2,31,1,1,allow,0,0,Normal
23122,26296,0,0,159,159,0,1,0,1,0,deny,1,1,High Risk
55652,443,58286,443,6672,2258,4414,19,16,10,9,allow,1,0,Potential Threat
65184,53,54868,53,164,84,80,2,31,1,1,allow,0,0,Normal
27005,27015,56171,27015,858,126,732,2,31,1,1,allow,1,0,Potential Threat
23157,53,23157,53,228,90,138,2,30,1,1,allow,0,0,Normal
443,39711,0,0,74,74,0,1,0,1,0,deny,1,1,High Risk
11815,30188,0,0,146,146,0,1,0,1,0,deny,1,1,High Risk
6666,2222,6666,2222,130,66,64,2,5,1,1,allow,1,0,Potential Threat
56965,53,30276,53,182,93,89,2,31,1,1,allow,0,0,Normal
55757,53,56073,53,177,94,83,2,29,1,1,allow,0,0,Normal
62077,445,0,0,66,66,0,1,0,1,0,drop,0,1,Known Attack
58638,5900,0,0,62,62,0,1,0,1,0,deny,0,1,Known Attack
59274,443,55424,443,8640,2329,6311,19,76,10,9,allow,1,0,Potential Threat
49395,445,0,0,66,66,0,1,0,1,0,drop,0,1,Known Attack
43314,443,11137,443,27958,21973,5985,77,403,43,34,allow,1,0,Potential Threat
21133,17068,30422,17068,481,150,331,2,1199,1,1,allow,1,0,Potential Threat
61683,445,0,0,70,70,0,1,0,1,0,drop,0,1,Known Attack
57896,1,0,0,100,100,0,1,0,1,0,deny,0,1,Known Attack
64880,9694,0,0,66,66,0,1,0,1,0,deny,0,1,Known Attack
48706,23393,0,0,60,60,0,1,0,1,0,deny,0,1,Known Attack
50533,443,28213,443,3518,1654,1864,10,120,5,5,allow,1,0,Potential Threat
32846,80,52606,80,1644,1324,320,10,15,5,5,allow,1,0,Potential Threat
25463,53,62402,53,827,91,736,4,29,2,2,allow,1,0,Potential Threat
58841,443,21745,443,18238,3980,14258,61,152,27,34,allow,1,0,Potential Threat
51324,465,51324,465,320,128,192,6,5,3,3,allow,0,0,Normal
59724,445,0,0,70,70,0,1,0,1,0,drop,0,1,Known Attack
64741,53,21274,53,198,86,112,2,29,1,1,allow,0,0,Normal
58999,53,58999,53,825,99,726,2,30,1,1,allow,0,0,Normal
60869,48817,0,0,62,62,0,1,0,1,0,deny,1,1,High Risk
25360,51505,0,0,66,66,0,1,0,1,0,deny,1,1,High Risk
64507,445,0,0,66,66,0,1,0,1,0,drop,0,1,Known Attack
56894,53,54448,53,178,94,84,2,29,1,1,allow,0,0,Normal
57361,445,0,0,66,66,0,1,0,1,0,drop,0,1,Known Attack
58941,80,60543,80,1114,534,580,12,15,7,5,allow,1,0,Potential Threat
51837,37965,0,0,66,66,0,1,0,1,0,deny,0,1,Known Attack
1042,64147,0,0,145,145,0,1,0,1,0,deny,1,1,High Risk
56242,53,42071,53,711,87,624,2,30,1,1,allow,0,0,Normal
57676,64147,0,0,70,70,0,1,0,1,0,deny,1,1,High Risk
19204,57866,0,0,62,62,0,1,0,1,0,deny,1,1,High Risk
60322,443,12700,443,1743,1164,579,16,25,10,6,allow,1,0,Potential Threat
54605,445,0,0,66,66,0,1,0,1,0,drop,0,1,Known Attack
63713,445,0,0,66,66,0,1,0,1,0,drop,0,1,Known Attack
51952,50967,36786,50967,70,70,0,2,7,2,0,allow,1,0,Potential Threat
37121,21247,0,0,66,66,0,1,0,1,0,deny,0,1,Known Attack
56750,80,10595,80,194,128,66,4,25,3,1,allow,0,0,Normal
50295,445,0,0,66,66,0,1,0,1,0,drop,0,1,Known Attack
64090,53,12119,53,227,102,125,2,30,1,1,allow,0,0,Normal
58638,5900,0,0,62,62,0,1,0,1,0,deny,0,1,Known Attack
56982,80,33665,80,3817,829,2988,11,16,7,4,allow,0,0,Normal
56312,53,57178,53,214,102,112,2,29,1,1,allow,0,0,Normal
60416,55998,54141,55998,70,70,0,1,5,1,0,allow,1,0,Potential Threat
58582,50584,0,0,66,66,0,1,0,1,0,deny,0,1,Known Attack
52311,80,52311,80,450,246,204,8,29,5,3,allow,0,0,Normal
64684,53,15819,53,184,94,90,2,31,1,1,allow,0,0,Normal
49476,445,0,0,70,70,0,1,0,1,0,drop,0,1,Known Attack
52876,443,52876,443,5045,2187,2858,16,136,8,8,allow,1,0,Potential Threat
54991,53,13574,53,177,94,83,2,29,1,1,allow,0,0,Normal
59966,443,53241,443,7165,1312,5853,22,16,12,10,allow,1,0,Potential Threat
64391,53,9777,53,209,102,107,2,29,1,1,allow,0,0,Normal
50584,39812,60344,39812,161,161,0,1,1200,1,0,allow,1,0,Potential Threat
51441,443,56551,443,642,582,60,2,15,1,1,allow,0,0,Normal
28009,36237,0,0,62,62,0,1,0,1,0,deny,0,1,Known Attack
47595,33440,0,0,106,106,0,1,61,1,0,allow,1,0,Potential Threat
60278,80,27803,80,1422,734,688,7,99,4,3,allow,1,0,Potential Threat
50459,62413,0,0,66,66,0,1,0,1,0,deny,1,1,High Risk
59970,445,0,0,66,66,0,1,0,1,0,drop,0,1,Known Attack
56255,44847,0,0,62,62,0,1,0,1,0,deny,0,1,Known Attack
65368,445,0,0,70,70,0,1,0,1,0,drop,0,1,Known Attack
37555,16386,35583,16386,432,192,240,8,30,4,4,allow,1,0,Potential Threat
55629,36190,12886,36190,504,318,186,8,16,5,3,allow,1,0,Potential Threat
52459,5555,0,0,60,60,0,1,0,1,0,deny,0,1,Known Attack
61705,80,47319,80,134,60,74,3,11,2,1,allow,0,0,Normal
55445,53,54858,53,96,96,0,2,31,2,0,allow,0,0,Normal
56731,443,49373,443,7907,1918,5989,20,15,11,9,allow,1,0,Potential Threat
64439,445,0,0,70,70,0,1,0,1,0,drop,0,1,Known Attack
64742,53,25545,53,761,102,659,2,29,1,1,allow,0,0,Normal
53161,443,60488,443,9458,4646,4812,26,25,14,12,allow,1,0,Potential Threat
41779,443,29003,443,618072,8505,609567,523,87,90,433,allow,1,0,Potential Threat
56668,53,43075,53,199,102,97,2,30,1,1,allow,0,0,Normal
57543,445,0,0,70,70,0,1,0,1,0,drop,0,1,Known Attack
55337,53,11833,53,294,106,188,4,56,2,2,allow,0,0,Normal
56917,443,25330,443,14033,1591,12442,26,132,10,16,allow,1,0,Potential Threat
49696,53,9591,53,178,94,84,2,30,1,1,allow,0,0,Normal
1818,22114,0,0,146,146,0,1,0,1,0,deny,1,1,High Risk
1814,62413,0,0,66,66,0,1,0,1,0,deny,1,1,High Risk
57103,445,0,0,70,70,0,1,0,1,0,drop,0,1,Known Attack
50817,53,0,0,182,73,109,2,30,1,1,allow,0,0,Normal
64908,445,0,0,66,66,0,1,0,1,0,drop,0,1,Known Attack
50046,445,0,0,70,70,0,1,0,1,0,drop,0,1,Known Attack
52068,39864,30686,39864,70,70,0,1,5,1,0,allow,1,0,Potential Threat
49747,53,22028,53,278,94,184,2,30,1,1,allow,0,0,Normal
53817,445,0,0,70,70,0,1,0,1,0,drop,0,1,Known Attack
50026,53,4265,53,395,99,296,4,57,2,2,allow,0,0,Normal
50325,445,0,0,66,66,0,1,0,1,0,drop,0,1,Known Attack
65274,53,37017,53,295,101,194,4,31,2,2,allow,0,0,Normal
9095,22114,0,0,62,62,0,1,0,1,0,deny,0,1,Known Attack
56100,53,6720,53,216,110,106,2,30,1,1,allow,0,0,Normal
49905,443,56801,443,4712,908,3804,18,77,9,9,allow,1,0,Potential Threat
60565,443,42590,443,6483,3687,2796,18,135,9,9,allow,1,0,Potential Threat
49810,445,0,0,70,70,0,1,0,1,0,drop,0,1,Known Attack
49572,443,30462,443,7538,4953,2585,21,54,12,9,allow,1,0,Potential Threat
59475,53,33895,53,179,86,93,2,30,1,1,allow,0,0,Normal
60003,443,18889,443,32538,7037,25501,49,143,20,29,allow,1,0,Potential Threat
56676,37965,0,0,66,66,0,1,0,1,0,deny,0,1,Known Attack
62893,993,15179,993,8883,4621,4262,76,191,47,29,allow,1,0,Potential Threat
64202,53,3004,53,316,89,227,4,50,2,2,allow,1,0,Potential Threat
31660,35440,0,0,62,62,0,1,0,1,0,deny,0,1,Known Attack
64618,53,55916,53,198,102,96,2,31,1,1,allow,0,0,Normal
65179,53,9786,53,289,102,187,2,30,1,1,allow,0,0,Normal
56495,53,40690,53,199,102,97,2,30,1,1,allow,0,0,Normal
53746,53,62050,53,164,78,86,2,31,1,1,allow,0,0,Normal
51560,46783,0,0,62,62,0,1,0,1,0,deny,0,1,Known Attack
44421,443,9990,443,2548,1565,983,20,330,11,9,allow,1,0,Potential Threat
50584,56112,8598,56112,1377,300,1077,6,1200,3,3,allow,1,0,Potential Threat
56616,53,31793,53,183,94,89,2,30,1,1,allow,0,0,Normal
57131,35776,0,0,145,145,0,1,0,1,0,deny,1,1,High Risk
60954,445,0,0,66,66,0,1,0,1,0,drop,0,1,Known Attack
51937,38056,36648,38056,70,70,0,2,8,2,0,allow,1,0,Potential Threat
52978,445,0,0,70,70,0,1,0,1,0,drop,0,1,Known Attack
52183,443,6084,443,10107,1324,8783,22,75,12,10,allow,1,0,Potential Threat
49901,53,27916,53,349,108,241,4,35,2,2,allow,0,0,Normal
64788,43890,0,0,62,62,0,1,0,1,0,deny,1,1,High Risk
56846,443,26374,443,9370,3805,5565,43,181,21,22,allow,1,0,Potential Threat
50977,56205,0,0,66,66,0,1,0,1,0,deny,0,1,Known Attack
64347,53,32269,53,193,102,91,2,30,1,1,allow,0,0,Normal
37917,443,55165,443,6124,860,5264,18,361,9,9,allow,1,0,Potential Threat
52758,80,33293,80,1746,980,766,15,151,8,7,allow,1,0,Potential Threat
56357,445,0,0,70,70,0,1,0,1,0,drop,0,1,Known Attack
51506,445,0,0,70,70,0,1,0,1,0,drop,0,1,Known Attack
55732,53,40584,53,194,102,92,2,31,1,1,allow,0,0,Normal
51039,445,0,0,70,70,0,1,0,1,0,drop,0,1,Known Attack
59836,443,35828,443,1394,733,661,14,80,8,6,allow,1,0,Potential Threat
58477,443,37357,443,10026,5706,4320,20,120,10,10,allow,1,0,Potential Threat
50401,443,63156,443,256,136,120,5,9,3,2,allow,1,0,Potential Threat
3478,61463,0,0,893,893,0,1,0,1,0,deny,1,1,High Risk
51826,445,0,0,70,70,0,1,0,1,0,drop,0,1,Known Attack
2864,25174,0,0,66,66,0,1,0,1,0,deny,1,1,High Risk
54322,27015,10656,27015,924,924,0,3,30,3,0,allow,1,0,Potential Threat
56982,80,63526,80,214,140,74,4,35,3,1,allow,1,0,Potential Threat
49904,445,0,0,70,70,0,1,0,1,0,drop,0,1,Known Attack
52166,80,3955,80,2110,1066,1044,12,15,7,5,allow,1,0,Potential Threat
14777,25174,0,0,62,62,0,1,0,1,0,deny,0,1,Known Attack
63832,25174,0,0,66,66,0,1,0,1,0,deny,0,1,Known Attack
58053,445,0,0,66,66,0,1,0,1,0,drop,0,1,Known Attack
6881,50239,58874,50239,3514,1874,1640,15,1200,8,7,allow,1,0,Potential Threat
56053,445,0,0,70,70,0,1,0,1,0,drop,0,1,Known Attack
9106,53,9106,53,227,89,138,2,30,1,1,allow,1,0,Potential Threat
57761,445,0,0,70,70,0,1,0,1,0,drop,0,1,Known Attack
6889,40740,0,0,143,143,0,1,0,1,0,deny,1,1,High Risk
65291,53,57485,53,195,102,93,2,29,1,1,allow,0,0,Normal
60055,443,24328,443,2314,1232,1082,15,141,8,7,allow,1,0,Potential Threat
24037,443,24037,443,3611,2177,1434,24,17,13,11,allow,1,0,Potential Threat
28345,11392,0,0,62,62,0,1,0,1,0,deny,0,1,Known Attack
10467,25174,0,0,62,62,0,1,0,1,0,deny,0,1,Known Attack
19875,30170,0,0,145,145,0,1,0,1,0,deny,1,1,High Risk
49208,53,22620,53,578,286,292,9,15,5,4,allow,0,0,Normal
1972,57470,0,0,78,78,0,1,0,1,0,deny,1,1,High Risk
58007,62413,0,0,66,66,0,1,0,1,0,deny,1,1,High Risk
56650,443,36450,443,4628,1035,3593,19,25,11,8,allow,0,0,Normal
52002,34348,46608,34348,66,66,0,1,5,1,0,allow,1,0,Potential Threat
54307,445,0,0,70,70,0,1,0,1,0,drop,0,1,Known Attack
57298,8765,45553,8765,2466,1350,1116,37,569,19,18,allow,1,0,Potential Threat
11983,57470,0,0,62,62,0,1,0,1,0,deny,1,1,High Risk
53247,445,0,0,70,70,0,1,0,1,0,drop,0,1,Known Attack
58638,5900,0,0,62,62,0,1,0,1,0,deny,0,1,Known Attack
63960,53,41492,53,172,88,84,2,31,1,1,allow,0,0,Normal
56924,53,38205,53,177,94,83,2,31,1,1,allow,0,0,Normal
49901,53,35015,53,186,95,91,2,31,1,1,allow,0,0,Normal
50620,445,0,0,70,70,0,1,0,1,0,drop,0,1,Known Attack
49648,445,0,0,66,66,0,1,0,1,0,drop,0,1,Known Attack
49723,53,39151,53,427,90,337,4,41,2,2,allow,0,0,Normal
1176,64147,0,0,62,62,0,1,0,1,0,deny,1,1,High Risk
1972,57470,0,0,78,78,0,1,0,1,0,deny,1,1,High Risk
50840,443,34565,443,8057,1135,6922,19,139,9,10,allow,1,0,Potential Threat
56200,445,0,0,70,70,0,1,0,1,0,drop,0,1,Known Attack
53044,36237,0,0,62,62,0,1,0,1,0,deny,0,1,Known Attack
52472,443,52472,443,4400,1493,2907,19,31,11,8,allow,1,0,Potential Threat
64496,53,57419,53,196,94,102,2,30,1,1,allow,0,0,Normal
14255,2767,0,0,62,62,0,1,0,1,0,deny,0,1,Known Attack
10477,44847,0,0,66,66,0,1,0,1,0,deny,1,1,High Risk
49225,53,55909,53,295,101,194,4,49,2,2,allow,0,0,Normal
54796,443,9714,443,6668,1926,4742,20,15,11,9,allow,1,0,Potential Threat
52910,53,52910,53,414,268,146,3,32,2,1,allow,0,0,Normal
60444,445,0,0,70,70,0,1,0,1,0,drop,0,1,Known Attack
55937,445,0,0,66,66,0,1,0,1,0,drop,0,1,Known Attack
64049,445,0,0,70,70,0,1,0,1,0,drop,0,1,Known Attack
54189,22114,0,0,66,66,0,1,0,1,0,deny,0,1,Known Attack
56322,53,0,0,166,73,93,2,31,1,1,allow,0,0,Normal
53571,19636,50196,19636,70,70,0,2,7,2,0,allow,1,0,Potential Threat
56646,48817,0,0,62,62,0,1,0,1,0,deny,0,1,Known Attack
55534,53,27868,53,168,86,82,2,29,1,1,allow,0,0,Normal
52023,41791,57379,41791,70,70,0,1,5,1,0,allow,1,0,Potential Threat
53895,36849,47178,36849,70,70,0,1,4,1,0,allow,1,0,Potential Threat
57232,443,17235,443,51152,3321,47831,81,100,38,43,allow,1,0,Potential Threat
52086,80,55343,80,2703,632,2071,12,22,7,5,allow,1,0,Potential Threat
49886,443,23328,443,7488,1598,5890,25,50,13,12,allow,1,0,Potential Threat
50016,53,35137,53,275,94,181,2,29,1,1,allow,0,0,Normal
56069,445,0,0,66,66,0,1,0,1,0,drop,0,1,Known Attack
47513,23,0,0,60,60,0,1,0,1,0,deny,0,1,Known Attack
59832,445,0,0,70,70,0,1,0,1,0,drop,0,1,Known Attack
58447,445,0,0,70,70,0,1,0,1,0,drop,0,1,Known Attack
55849,53,49045,53,195,102,93,2,30,1,1,allow,0,0,Normal
51426,47563,0,0,100,100,0,1,0,1,0,deny,1,1,High Risk
49456,53,27659,53,360,110,250,2,29,1,1,allow,0,0,Normal
33359,443,23934,443,9818,2036,7782,28,31,12,16,allow,1,0,Potential Threat
60449,28260,44457,28260,70,70,0,2,8,2,0,allow,1,0,Potential Threat
41643,443,51338,443,16032,13508,2524,37,36,19,18,allow,1,0,Potential Threat
53785,53,12230,53,167,78,89,2,31,1,1,allow,0,0,Normal
38852,37965,0,0,62,62,0,1,0,1,0,deny,0,1,Known Attack
63924,26328,57332,26328,66,66,0,2,8,2,0,allow,1,0,Potential Threat
63305,62413,0,0,66,66,0,1,0,1,0,deny,1,1,High Risk
52148,443,33858,443,375357,11451,363906,356,61,100,256,allow,1,0,Potential Threat
58638,5900,0,0,62,62,0,1,0,1,0,deny,0,1,Known Attack
49650,53,24810,53,216,110,106,2,29,1,1,allow,0,0,Normal
50536,80,24703,80,24166,3105,21061,31,24,12,19,allow,1,0,Potential Threat
50535,445,0,0,70,70,0,1,0,1,0,drop,0,1,Known Attack
57254,443,6263,443,3948,1290,2658,13,120,6,7,allow,1,0,Potential Threat
63779,12226,30689,12226,70,70,0,1,4,1,0,allow,1,0,Potential Threat
31738,51505,0,0,62,62,0,1,0,1,0,deny,1,1,High Risk
57325,445,0,0,70,70,0,1,0,1,0,drop,0,1,Known Attack
63130,445,0,0,66,66,0,1,0,1,0,drop,0,1,Known Attack
56340,53,44693,53,198,102,96,2,30,1,1,allow,0,0,Normal
48844,443,50866,443,36383,29447,6936,103,163,51,52,allow,1,0,Potential Threat
64283,53,44589,53,193,102,91,2,29,1,1,allow,0,0,Normal
56739,80,48782,80,1462,703,759,8,16,5,3,allow,0,0,Normal
64685,53,52958,53,186,95,91,2,30,1,1,allow,0,0,Normal
49393,53,14583,53,183,86,97,2,30,1,1,allow,0,0,Normal
55893,45711,0,0,78,78,0,1,0,1,0,deny,0,1,Known Attack
64184,443,64184,443,4561,1654,2907,19,28,11,8,allow,1,0,Potential Threat
49907,53,22787,53,199,102,97,2,30,1,1,allow,0,0,Normal
64727,25174,0,0,66,66,0,1,0,1,0,deny,0,1,Known Attack
49247,53,6509,53,478,196,282,6,64,3,3,allow,0,0,Normal
58638,5900,0,0,62,62,0,1,0,1,0,deny,0,1,Known Attack
5588,5588,0,0,3562,1936,1626,48,194,24,24,allow,1,0,Potential Threat
51081,53,49643,53,168,78,90,2,30,1,1,allow,0,0,Normal
60537,80,60537,80,318,120,198,6,25,3,3,allow,0,0,Normal
5643,53,5643,53,237,91,146,2,33,1,1,allow,1,0,Potential Threat
60767,40010,24332,40010,316,136,180,6,6,3,3,allow,1,0,Potential Threat
26921,37965,0,0,62,62,0,1,0,1,0,deny,0,1,Known Attack
55836,445,0,0,70,70,0,1,0,1,0,drop,0,1,Known Attack
51449,443,58167,443,21779,7983,13796,44,97,25,19,allow,1,0,Potential Threat
53306,53,0,0,86,86,0,1,29,1,0,allow,0,0,Normal
57131,26296,0,0,145,145,0,1,0,1,0,deny,1,1,High Risk
61537,445,0,0,66,66,0,1,0,1,0,drop,0,1,Known Attack
40244,443,63008,443,21525,15159,6366,43,315,25,18,allow,1,0,Potential Threat
53714,6882,41499,6882,70,70,0,1,4,1,0,allow,1,0,Potential Threat
56112,80,39554,80,8113,1082,7031,19,16,10,9,allow,1,0,Potential Threat
64077,25174,0,0,62,62,0,1,0,1,0,deny,0,1,Known Attack
55165,53,15099,53,199,102,97,2,30,1,1,allow,0,0,Normal
49216,63752,46385,63752,70,70,0,2,8,2,0,allow,1,0,Potential Threat
27005,27015,42167,27015,869,126,743,2,30,1,1,allow,1,0,Potential Threat
50424,445,0,0,66,66,0,1,0,1,0,drop,0,1,Known Attack
63932,53,27137,53,179,94,85,2,30,1,1,allow,0,0,Normal
57073,53,4074,53,99,99,0,1,31,1,0,allow,0,0,Normal
53300,37807,0,0,66,66,0,1,0,1,0,deny,0,1,Known Attack
63569,445,0,0,70,70,0,1,0,1,0,drop,0,1,Known Attack
3478,61463,0,0,918,918,0,1,0,1,0,deny,1,1,High Risk
64869,445,0,0,70,70,0,1,0,1,0,drop,0,1,Known Attack
65171,53,52756,53,194,94,100,2,29,1,1,allow,0,0,Normal
52171,63033,49679,63033,70,70,0,2,8,2,0,allow,1,0,Potential Threat
64876,53,58020,53,737,94,643,2,30,1,1,allow,1,0,Potential Threat
30109,5223,0,0,148,148,0,1,0,1,0,deny,0,1,Known Attack
49907,443,10260,443,3787,2434,1353,29,72,16,13,allow,1,0,Potential Threat
56832,23900,53161,23900,130,70,60,2,5,1,1,allow,1,0,Potential Threat
40806,443,37490,443,3287,2049,1238,12,31,7,5,allow,1,0,Potential Threat
19367,35440,0,0,146,146,0,1,0,1,0,deny,1,1,High Risk
5617,64147,0,0,62,62,0,1,0,1,0,deny,1,1,High Risk
58920,80,59955,80,318,192,126,6,37,4,2,allow,0,0,Normal
58638,5900,0,0,62,62,0,1,0,1,0,deny,0,1,Known Attack
27005,30010,26771,30010,887,126,761,2,31,1,1,allow,1,0,Potential Threat
57331,53,50054,53,178,94,84,2,30,1,1,allow,0,0,Normal
63919,445,0,0,70,70,0,1,0,1,0,drop,0,1,Known Attack
51415,443,38416,443,9284,2172,7112,39,83,19,20,allow,1,0,Potential Threat
49737,443,48877,443,35419,29471,5948,42,31,27,15,allow,1,0,Potential Threat
50719,443,22608,443,17803069,497380,17305689,17583,219,5899,11684,allow,1,0,Potential Threat
55443,445,0,0,70,70,0,1,0,1,0,drop,0,1,Known Attack
49987,445,0,0,70,70,0,1,0,1,0,drop,0,1,Known Attack
63594,445,0,0,70,70,0,1,0,1,0,drop,0,1,Known Attack
65201,53,7188,53,216,110,106,2,30,1,1,allow,0,0,Normal
16814,53,16814,53,217,87,130,2,30,1,1,allow,0,0,Normal
60892,445,0,0,70,70,0,1,0,1,0,drop,0,1,Known Attack
36513,443,42006,443,4216,2615,1601,26,80,13,13,allow,1,0,Potential Threat
56724,53,15012,53,749,89,660,2,31,1,1,allow,0,0,Normal
57146,53,13566,53,199,102,97,2,29,1,1,allow,0,0,Normal
53252,445,0,0,70,70,0,1,0,1,0,drop,0,1,Known Attack
42640,11119,0,0,148,148,0,1,0,1,0,deny,0,1,Known Attack
3406,17372,0,0,66,66,0,1,0,1,0,deny,1,1,High Risk
65189,27015,61124,27015,250,78,172,2,30,1,1,allow,1,0,Potential Threat
57411,53,7355,53,196,102,94,2,30,1,1,allow,0,0,Normal
37965,39108,36972,39108,1056,1056,0,17,1550,17,0,allow,1,0,Potential Threat
64653,445,0,0,70,70,0,1,0,1,0,drop,0,1,Known Attack
38444,443,18273,443,3547,955,2592,13,120,6,7,allow,1,0,Potential Threat
64318,53,51027,53,183,94,89,2,30,1,1,allow,0,0,Normal
35722,123,29832,123,94,94,0,1,30,1,0,allow,0,0,Normal
9748,21247,0,0,66,66,0,1,0,1,0,deny,0,1,Known Attack
52733,443,22448,443,613606,29392,584214,757,42,337,420,allow,1,0,Potential Threat
53298,445,0,0,66,66,0,1,0,1,0,drop,0,1,Known Attack
24292,48817,0,0,148,148,0,1,0,1,0,deny,1,1,High Risk
6773,57470,0,0,62,62,0,1,0,1,0,deny,1,1,High Risk
54984,443,11572,443,68519,3801,64718,93,31,40,53,allow,1,0,Potential Threat
57769,445,0,0,66,66,0,1,0,1,0,drop,0,1,Known Attack
16403,16384,8455,16384,426,186,240,8,30,4,4,allow,1,0,Potential Threat
55836,53,6468,53,177,94,83,2,30,1,1,allow,0,0,Normal
7210,22114,0,0,66,66,0,1,0,1,0,deny,1,1,High Risk
16387,35583,0,0,60,60,0,1,0,1,0,deny,1,1,High Risk
53676,35974,0,0,60,60,0,1,0,1,0,deny,0,1,Known Attack
15503,63684,7728,63684,481,150,331,2,1200,1,1,allow,1,0,Potential Threat
46326,443,42575,443,430,152,278,7,32,3,4,allow,0,0,Normal
60006,80,32015,80,1836,816,1020,12,143,7,5,allow,1,0,Potential Threat
37977,443,37977,443,5763,2553,3210,24,80,14,10,allow,1,0,Potential Threat
55841,53,32658,53,265,86,179,4,58,2,2,allow,0,0,Normal
55647,53,47322,53,711,87,624,2,30,1,1,allow,0,0,Normal
64001,445,0,0,70,70,0,1,0,1,0,drop,0,1,Known Attack
49035,443,36911,443,4299,2327,1972,23,315,11,12,allow,1,0,Potential Threat
56961,80,26352,80,5885,3796,2089,16,30,10,6,allow,1,0,Potential Threat
64827,445,0,0,70,70,0,1,0,1,0,drop,0,1,Known Attack
57934,445,0,0,70,70,0,1,0,1,0,drop,0,1,Known Attack
51822,445,0,0,70,70,0,1,0,1,0,drop,0,1,Known Attack
53730,443,15340,443,499,425,74,4,0,3,1,allow,0,0,Normal
57334,53,10038,53,184,94,90,2,30,1,1,allow,0,0,Normal
57613,80,57613,80,349583,9149,340434,298,25,62,236,allow,1,0,Potential Threat
44274,53,0,0,82,82,0,1,31,1,0,allow,0,0,Normal
52376,443,24814,443,33906,25094,8812,63,447,36,27,allow,1,0,Potential Threat
57905,443,45669,443,1851,1152,699,18,169,10,8,allow,1,0,Potential Threat
80,9918,0,0,60,60,0,1,0,1,0,deny,1,1,High Risk
58143,57866,0,0,66,66,0,1,0,1,0,deny,1,1,High Risk
49233,443,34014,443,9622,3524,6098,59,916,29,30,allow,1,0,Potential Threat
0,0,0,0,156,156,0,2,0,2,0,deny,1,1,High Risk
61840,25174,0,0,66,66,0,1,0,1,0,deny,0,1,Known Attack
1882,43890,0,0,62,62,0,1,0,1,0,deny,1,1,High Risk
51834,30309,10825,30309,70,70,0,1,5,1,0,allow,1,0,Potential Threat
54396,445,0,0,66,66,0,1,0,1,0,drop,0,1,Known Attack
56180,53,56180,53,229,98,131,2,30,1,1,allow,0,0,Normal
56422,53,25062,53,195,102,93,2,31,1,1,allow,0,0,Normal
43578,15503,0,0,74,74,0,1,0,1,0,deny,0,1,Known Attack
55326,53,39375,53,177,94,83,2,29,1,1,allow,0,0,Normal
51046,25174,0,0,62,62,0,1,0,1,0,deny,0,1,Known Attack
58638,5900,58638,5900,156,62,94,2,10,1,1,allow,1,0,Potential Threat
54127,443,25652,443,148422,10568,137854,223,115,114,109,allow,1,0,Potential Threat
11541,40108,0,0,148,148,0,1,0,1,0,deny,1,1,High Risk
56460,22114,0,0,146,146,0,1,0,1,0,deny,1,1,High Risk
64331,53,12876,53,174,89,85,2,31,1,1,allow,0,0,Normal
33882,80,63489,80,1454,866,588,11,58,7,4,allow,1,0,Potential Threat
27005,33056,50628,33056,885,126,759,2,31,1,1,allow,1,0,Potential Threat
56783,21279,24337,21279,70,70,0,1,5,1,0,allow,1,0,Potential Threat
49305,53,59053,53,177,94,83,2,29,1,1,allow,0,0,Normal
41980,443,47669,443,11377,7703,3674,26,162,19,7,allow,1,0,Potential Threat
49806,53,63116,53,242,118,124,2,30,1,1,allow,1,0,Potential Threat
51718,55003,38571,55003,70,70,0,2,8,2,0,allow,1,0,Potential Threat
60414,80,46472,80,5124,3499,1625,14,121,8,6,allow,1,0,Potential Threat
58638,5900,0,0,62,62,0,1,0,1,0,deny,0,1,Known Attack
64472,445,0,0,66,66,0,1,0,1,0,drop,0,1,Known Attack
59938,445,0,0,70,70,0,1,0,1,0,drop,0,1,Known Attack
53718,1053,4101,1053,320,140,180,6,8,3,3,allow,0,0,Normal
65373,53,60314,53,194,99,95,2,31,1,1,allow,0,0,Normal
48676,53393,0,0,60,60,0,1,0,1,0,deny,0,1,Known Attack
34779,443,25876,443,34914,5279,29635,47,543,18,29,allow,1,0,Potential Threat
63058,443,54083,443,304,86,218,2,30,1,1,allow,0,0,Normal
59916,445,0,0,70,70,0,1,0,1,0,drop,0,1,Known Attack
55271,53,16538,53,268,102,166,2,30,1,1,allow,0,0,Normal
62424,37965,0,0,66,66,0,1,0,1,0,deny,0,1,Known Attack
55752,8060,41329,8060,70,70,0,1,4,1,0,allow,1,0,Potential Threat
46856,25174,0,0,62,62,0,1,0,1,0,deny,0,1,Known Attack
27448,22114,0,0,62,62,0,1,0,1,0,deny,0,1,Known Attack
45308,22114,0,0,146,146,0,1,0,1,0,deny,1,1,High Risk
58638,5900,0,0,62,62,0,1,0,1,0,deny,0,1,Known Attack
49734,53,21745,53,216,110,106,2,30,1,1,allow,0,0,Normal
58638,5900,0,0,62,62,0,1,0,1,0,deny,0,1,Known Attack
59261,80,59261,80,109128,4773,104355,197,15,68,129,allow,1,0,Potential Threat
59765,443,22401,443,571,166,405,2,30,1,1,allow,0,0,Normal
63803,41439,2152,41439,66,66,0,2,8,2,0,allow,1,0,Potential Threat
65012,32468,0,0,66,66,0,1,0,1,0,deny,0,1,Known Attack
56246,445,0,0,66,66,0,1,0,1,0,drop,0,1,Known Attack
53157,445,0,0,70,70,0,1,0,1,0,drop,0,1,Known Attack
55844,445,0,0,66,66,0,1,0,1,0,drop,0,1,Known Attack
1865,25174,0,0,62,62,0,1,0,1,0,deny,1,1,High Risk
64112,24707,56635,24707,66,66,0,2,8,2,0,allow,1,0,Potential Threat
64791,443,54264,443,8580,5765,2815,46,82,22,24,allow,1,0,Potential Threat
60731,445,0,0,66,66,0,1,0,1,0,drop,0,1,Known Attack
65524,445,0,0,66,66,0,1,0,1,0,drop,0,1,Known Attack
65192,445,0,0,66,66,0,1,0,1,0,drop,0,1,Known Attack
54648,443,56134,443,9215,3253,5962,51,22,25,26,allow,1,0,Potential Threat
51604,443,15214,443,2911,2062,849,14,134,8,6,allow,1,0,Potential Threat
60105,443,39991,443,4856,1587,3269,17,138,9,8,allow,1,0,Potential Threat
23632,64147,0,0,66,66,0,1,0,1,0,deny,1,1,High Risk
59377,53,59377,53,216,98,118,2,30,1,1,allow,0,0,Normal
56641,80,60111,80,234,234,0,4,12,4,0,allow,0,0,Normal
16319,44847,0,0,62,62,0,1,0,1,0,deny,1,1,High Risk
40072,80,29014,80,1298,370,928,12,15,6,6,allow,0,0,Normal
51655,445,0,0,66,66,0,1,0,1,0,drop,0,1,Known Attack
55659,37787,37419,37787,70,70,0,1,5,1,0,allow,1,0,Potential Threat
40302,443,5180,443,7586,3785,3801,20,30,11,9,allow,1,0,Potential Threat
64005,53,59576,53,402,125,277,4,37,2,2,allow,1,0,Potential Threat
55649,53,62328,53,216,110,106,2,30,1,1,allow,0,0,Normal
6015,23,0,0,60,60,0,1,0,1,0,deny,0,1,Known Attack
36258,23,0,0,60,60,0,1,0,1,0,deny,0,1,Known Attack
49486,53,9984,53,177,94,83,2,30,1,1,allow,0,0,Normal
65495,53,9784,53,202,103,99,2,31,1,1,allow,0,0,Normal
50714,443,52657,443,9477,1950,7527,31,181,14,17,allow,1,0,Potential Threat
64784,53,13638,53,226,102,124,2,30,1,1,allow,0,0,Normal
23758,44847,0,0,62,62,0,1,0,1,0,deny,1,1,High Risk
44915,443,17055,443,23886,6994,16892,26,129,12,14,allow,1,0,Potential Threat
55581,53,26872,53,167,86,81,2,30,1,1,allow,0,0,Normal
52896,80,13613,80,3020,1414,1606,30,118,16,14,allow,1,0,Potential Threat
34630,443,65434,443,12120,5747,6373,22,120,10,12,allow,1,0,Potential Threat
61205,445,0,0,66,66,0,1,0,1,0,drop,0,1,Known Attack
61719,445,0,0,66,66,0,1,0,1,0,drop,0,1,Known Attack
53910,1024,52372,1024,70,70,0,2,8,2,0,allow,0,0,Normal
53726,445,0,0,70,70,0,1,0,1,0,drop,0,1,Known Attack
59982,443,10585,443,3640,870,2770,13,120,6,7,allow,1,0,Potential Threat
57558,445,0,0,66,66,0,1,0,1,0,drop,0,1,Known Attack
25565,50263,0,0,60,60,0,1,0,1,0,deny,1,1,High Risk
53036,443,40328,443,249145,4184,244961,218,107,40,178,allow,1,0,Potential Threat
56672,53,51134,53,177,94,83,2,30,1,1,allow,0,0,Normal
55463,53,8245,53,193,102,91,2,30,1,1,allow,0,0,Normal
51698,63846,26436,63846,66,66,0,1,5,1,0,allow,1,0,Potential Threat
53284,443,5586,443,4579,2245,2334,12,122,6,6,allow,1,0,Potential Threat
45238,44847,0,0,66,66,0,1,0,1,0,deny,0,1,Known Attack
63440,445,0,0,66,66,0,1,0,1,0,drop,0,1,Known Attack
32914,80,9670,80,1542,831,711,7,15,5,2,allow,1,0,Potential Threat
64903,53,16364,53,210,110,100,2,30,1,1,allow,0,0,Normal
49158,443,4149,443,3655,1807,1848,17,15,9,8,allow,1,0,Potential Threat
56170,53,52947,53,198,102,96,2,31,1,1,allow,0,0,Normal
53718,443,33767,443,318,192,126,6,16,4,2,allow,0,0,Normal
33193,50584,0,0,62,62,0,1,0,1,0,deny,1,1,High Risk
49163,36069,48102,36069,5990,5698,292,17,51,14,3,allow,1,0,Potential Threat
59105,443,52375,443,8742,3785,4957,21,16,12,9,allow,1,0,Potential Threat
49767,53,43872,53,200,102,98,2,31,1,1,allow,0,0,Normal
64116,53,59887,53,177,94,83,2,31,1,1,allow,0,0,Normal
33215,37965,0,0,62,62,0,1,0,1,0,deny,0,1,Known Attack
51401,443,31981,443,6537,3702,2835,34,170,17,17,allow,1,0,Potential Threat
49525,443,29311,443,14786,2845,11941,32,121,17,15,allow,1,0,Potential Threat
61404,52700,0,0,72,72,0,1,0,1,0,deny,1,1,High Risk
64703,53,15968,53,314,92,222,4,31,2,2,allow,0,0,Normal
64969,53,18068,53,329,118,211,2,30,1,1,allow,0,0,Normal
64821,53,30415,53,775,102,673,2,30,1,1,allow,0,0,Normal
49293,80,54518,80,75982,15645,60337,88,158,31,57,allow,1,0,Potential Threat
49690,50265,0,0,66,66,0,1,0,1,0,deny,0,1,Known Attack
64837,53,39780,53,195,102,93,2,30,1,1,allow,0,0,Normal
58638,5900,0,0,62,62,0,1,0,1,0,deny,0,1,Known Attack
1873,37965,0,0,62,62,0,1,0,1,0,deny,1,1,High Risk
39609,53,46701,53,168,78,90,2,30,1,1,allow,0,0,Normal
56353,443,16805,443,3775,1791,1984,24,203,12,12,allow,1,0,Potential Threat
54971,443,20430,443,13124,8442,4682,40,43,24,16,allow,1,0,Potential Threat
443,18177,0,0,66,66,0,1,0,1,0,deny,1,1,High Risk
54739,445,0,0,70,70,0,1,0,1,0,drop,0,1,Known Attack
60792,53,38025,53,168,78,90,2,29,1,1,allow,0,0,Normal
51728,44847,0,0,66,66,0,1,0,1,0,deny,0,1,Known Attack
49519,443,49519,443,15064,2611,12453,43,76,23,20,allow,1,0,Potential Threat
54642,445,0,0,70,70,0,1,0,1,0,drop,0,1,Known Attack
64283,37965,0,0,74,74,0,1,0,1,0,deny,0,1,Known Attack
56941,443,11257,443,8304,2968,5336,24,362,13,11,allow,1,0,Potential Threat
52206,445,0,0,70,70,0,1,0,1,0,drop,0,1,Known Attack
47020,443,34656,443,3545,1817,1728,22,95,11,11,allow,1,0,Potential Threat
36873,80,37820,80,1115,534,581,12,16,7,5,allow,1,0,Potential Threat
2946,25174,0,0,62,62,0,1,0,1,0,deny,1,1,High Risk
57044,53,35705,53,197,102,95,2,30,1,1,allow,0,0,Normal
64384,445,0,0,70,70,0,1,0,1,0,drop,0,1,Known Attack
49367,51505,0,0,62,62,0,1,0,1,0,deny,0,1,Known Attack
55843,53,38678,53,177,94,83,2,30,1,1,allow,0,0,Normal
50081,57470,0,0,66,66,0,1,0,1,0,deny,0,1,Known Attack
58338,3369,0,0,60,60,0,1,0,1,0,deny,0,1,Known Attack
35353,443,50088,443,1864,250,1614,8,120,4,4,allow,1,0,Potential Threat
64938,53,18539,53,210,102,108,2,30,1,1,allow,0,0,Normal
55926,445,0,0,70,70,0,1,0,1,0,drop,0,1,Known Attack
64932,53,8604,53,230,102,128,2,30,1,1,allow,0,0,Normal
55317,443,24510,443,5692,1239,4453,23,16,13,10,allow,1,0,Potential Threat
57631,443,64255,443,154,94,60,2,5,1,1,allow,1,0,Potential Threat
53349,445,0,0,66,66,0,1,0,1,0,drop,0,1,Known Attack
53122,443,25117,443,23067,5901,17166,43,73,21,22,allow,1,0,Potential Threat
56671,443,59090,443,7940,1951,5989,20,16,11,9,allow,1,0,Potential Threat
27065,53,10980,53,822,466,356,3,30,2,1,allow,1,0,Potential Threat
51535,64147,0,0,62,62,0,1,0,1,0,deny,1,1,High Risk
49846,445,0,0,66,66,0,1,0,1,0,drop,0,1,Known Attack
49807,443,23954,443,2796,1730,1066,15,126,9,6,allow,1,0,Potential Threat
53515,39608,40902,39608,70,70,0,1,4,1,0,allow,1,0,Potential Threat
58638,5900,0,0,62,62,0,1,0,1,0,deny,0,1,Known Attack
21420,44847,0,0,66,66,0,1,0,1,0,deny,1,1,High Risk
57394,53,39709,53,193,102,91,2,31,1,1,allow,0,0,Normal
63923,59177,7249,59177,66,66,0,2,7,2,0,allow,1,0,Potential Threat
59871,445,0,0,66,66,0,1,0,1,0,drop,0,1,Known Attack
53888,39204,51033,39204,70,70,0,1,5,1,0,allow,1,0,Potential Threat
58638,5900,0,0,62,62,0,1,0,1,0,deny,0,1,Known Attack
50459,53,40007,53,811,94,717,2,30,1,1,allow,0,0,Normal
27005,27015,31472,27015,888,126,762,2,30,1,1,allow,1,0,Potential Threat
60171,445,0,0,70,70,0,1,0,1,0,drop,0,1,Known Attack
49698,443,62719,443,14762,1871,12891,30,34,16,14,allow,1,0,Potential Threat
55266,445,0,0,70,70,0,1,0,1,0,drop,0,1,Known Attack
60403,60092,47131,60092,70,70,0,2,8,2,0,allow,1,0,Potential Threat
61679,445,0,0,70,70,0,1,0,1,0,drop,0,1,Known Attack
38503,25,0,0,60,60,0,1,0,1,0,deny,0,1,Known Attack
53888,443,38577,443,499,425,74,4,0,3,1,allow,0,0,Normal
60627,51050,0,0,62,62,0,1,0,1,0,deny,1,1,High Risk
58638,5900,0,0,62,62,0,1,0,1,0,deny,0,1,Known Attack
51579,443,8189,443,1522,1210,312,9,28,4,5,allow,1,0,Potential Threat
64056,51266,62758,51266,66,66,0,2,8,2,0,allow,1,0,Potential Threat
50759,445,0,0,66,66,0,1,0,1,0,drop,0,1,Known Attack
64385,443,4632,443,3677,1168,2509,17,120,8,9,allow,1,0,Potential Threat
61600,56205,0,0,66,66,0,1,0,1,0,deny,1,1,High Risk
64396,53,1161,53,211,102,109,2,30,1,1,allow,0,0,Normal
56880,53,8683,53,209,110,99,2,31,1,1,allow,0,0,Normal
59060,443,38409,443,16775,1879,14896,36,16,17,19,allow,1,0,Potential Threat
51923,11542,51093,11542,70,70,0,1,5,1,0,allow,1,0,Potential Threat
18623,1,0,0,66,66,0,1,0,1,0,deny,0,1,Known Attack
50482,445,0,0,70,70,0,1,0,1,0,drop,0,1,Known Attack
51684,80,23150,80,1515,481,1034,11,15,6,5,allow,0,0,Normal
54973,445,0,0,66,66,0,1,0,1,0,drop,0,1,Known Attack
19473,51413,8434,51413,459,149,310,2,1200,1,1,allow,1,0,Potential Threat
51938,11218,41228,11218,70,70,0,1,5,1,0,allow,1,0,Potential Threat
62371,445,0,0,70,70,0,1,0,1,0,drop,0,1,Known Attack
51158,443,53566,443,3155111,84086,3071025,3163,75,1072,2091,allow,1,0,Potential Threat
57166,53,41004,53,170,87,83,2,30,1,1,allow,0,0,Normal
48544,44847,0,0,146,146,0,1,0,1,0,deny,1,1,High Risk
41474,443,57047,443,2767442,82304,2685138,2961,85,1088,1873,allow,1,0,Potential Threat
59227,11392,0,0,62,62,0,1,0,1,0,deny,0,1,Known Attack
5180,57866,0,0,66,66,0,1,0,1,0,deny,1,1,High Risk
54280,3398,0,0,60,60,0,1,0,1,0,deny,0,1,Known Attack
60709,53,36089,53,260,86,174,2,30,1,1,allow,0,0,Normal
49158,80,49158,80,10922,816,10106,19,18,8,11,allow,1,0,Potential Threat
58638,5900,58638,5900,126,62,64,2,5,1,1,allow,1,0,Potential Threat
27005,30000,59167,30000,913,126,787,2,30,1,1,allow,1,0,Potential Threat
57470,15870,28583,15870,149,149,0,2,1199,2,0,allow,1,0,Potential Threat
55461,443,39176,443,2341,540,1801,9,121,5,4,allow,1,0,Potential Threat
12136,53,12136,53,198,90,108,2,30,1,1,allow,0,0,Normal
50014,80,33183,80,810,670,140,6,34,4,2,allow,0,0,Normal
49804,443,24644,443,5938,1521,4417,20,125,10,10,allow,1,0,Potential Threat
38275,443,49031,443,448,78,370,6,25,1,5,allow,1,0,Potential Threat
34176,51505,0,0,62,62,0,1,0,1,0,deny,0,1,Known Attack
52086,445,0,0,66,66,0,1,0,1,0,drop,0,1,Known Attack
65026,53,32654,53,186,95,91,2,30,1,1,allow,0,0,Normal
56563,445,0,0,66,66,0,1,0,1,0,drop,0,1,Known Attack
37179,443,24898,443,7440,3165,4275,31,358,17,14,allow,1,0,Potential Threat
43093,53,41079,53,242,78,164,2,30,1,1,allow,0,0,Normal
65241,53,1849,53,198,102,96,2,30,1,1,allow,0,0,Normal
55425,37965,0,0,66,66,0,1,0,1,0,deny,0,1,Known Attack
54028,37965,0,0,66,66,0,1,0,1,0,deny,0,1,Known Attack
65155,53,21805,53,295,103,192,4,48,2,2,allow,0,0,Normal
55011,445,0,0,70,70,0,1,0,1,0,drop,0,1,Known Attack
0,0,0,0,98,98,0,1,0,1,0,deny,1,1,High Risk
0,0,0,0,2000,1020,980,20,0,10,10,allow,1,0,Potential Threat
51098,443,32791,443,7250,2813,4437,21,62,12,9,allow,1,0,Potential Threat
46056,80,34041,80,5066,4404,662,11,30,6,5,allow,1,0,Potential Threat
60243,445,0,0,70,70,0,1,0,1,0,drop,0,1,Known Attack
43552,443,10231,443,4680,2873,1807,26,53,15,11,allow,1,0,Potential Threat
49474,7000,49474,7000,2990,1599,1391,15,15,8,7,allow,1,0,Potential Threat
51917,26077,25405,26077,70,70,0,1,5,1,0,allow,1,0,Potential Threat
53773,445,0,0,66,66,0,1,0,1,0,drop,0,1,Known Attack
57290,53,48036,53,758,93,665,2,30,1,1,allow,0,0,Normal
64403,53,2532,53,199,102,97,2,31,1,1,allow,0,0,Normal
57312,53,15136,53,212,110,102,2,29,1,1,allow,0,0,Normal
55945,445,0,0,70,70,0,1,0,1,0,drop,0,1,Known Attack
63139,53,8265,53,78,78,0,2,31,2,0,allow,0,0,Normal
50609,2323,0,0,60,60,0,1,0,1,0,deny,0,1,Known Attack
61534,445,0,0,70,70,0,1,0,1,0,drop,0,1,Known Attack
49695,53,13184,53,772,103,669,2,31,1,1,allow,0,0,Normal
56289,53,51620,53,749,89,660,2,30,1,1,allow,0,0,Normal
35494,22114,0,0,62,62,0,1,0,1,0,deny,0,1,Known Attack
51065,445,0,0,66,66,0,1,0,1,0,drop,0,1,Known Attack
44277,443,64665,443,36026,28458,7568,70,407,30,40,allow,1,0,Potential Threat
58638,5900,58638,5900,130,66,64,2,4,1,1,allow,1,0,Potential Threat
55234,53,22160,53,177,94,83,2,30,1,1,allow,0,0,Normal
57172,53,34011,53,196,102,94,2,31,1,1,allow,0,0,Normal
33109,443,18483,443,6749,1593,5156,23,123,12,11,allow,1,0,Potential Threat
64771,445,0,0,70,70,0,1,0,1,0,drop,0,1,Known Attack
26053,33720,0,0,160,160,0,1,0,1,0,deny,1,1,High Risk
6666,2222,0,0,60,60,0,1,0,1,0,deny,0,1,Known Attack
65304,53,24960,53,195,102,93,2,31,1,1,allow,0,0,Normal
52071,57491,41650,57491,70,70,0,2,8,2,0,allow,1,0,Potential Threat
49785,53,38466,53,206,105,101,2,31,1,1,allow,0,0,Normal
50396,445,0,0,70,70,0,1,0,1,0,drop,0,1,Known Attack
54197,445,0,0,66,66,0,1,0,1,0,drop,0,1,Known Attack
1030,44847,0,0,146,146,0,1,0,1,0,deny,1,1,High Risk
49205,445,0,0,70,70,0,1,0,1,0,drop,0,1,Known Attack
57258,53,33746,53,215,102,113,2,30,1,1,allow,0,0,Normal
56006,53,57116,53,183,102,81,2,29,1,1,allow,0,0,Normal
57981,445,0,0,70,70,0,1,0,1,0,drop,0,1,Known Attack
43904,443,27046,443,7552,2611,4941,24,360,13,11,allow,1,0,Potential Threat
12458,161,0,0,85,85,0,1,0,1,0,deny,0,1,Known Attack
64732,53,44138,53,189,102,87,2,29,1,1,allow,0,0,Normal
62348,50584,0,0,66,66,0,1,0,1,0,deny,1,1,High Risk
54064,445,0,0,66,66,0,1,0,1,0,drop,0,1,Known Attack
18725,35440,0,0,62,62,0,1,0,1,0,deny,1,1,High Risk
47088,15000,21651,15000,138,78,60,2,6,1,1,allow,1,0,Potential Threat
63232,443,26677,443,4496,2346,2150,28,124,15,13,allow,1,0,Potential Threat
27005,27255,55228,27255,879,126,753,2,30,1,1,allow,1,0,Potential Threat
56623,443,54121,443,7982,1962,6020,20,15,11,9,allow,1,0,Potential Threat
64211,445,0,0,70,70,0,1,0,1,0,drop,0,1,Known Attack
38675,443,44099,443,90810,3417,87393,94,16,30,64,allow,1,0,Potential Threat
49926,53,10749,53,266,110,156,2,30,1,1,allow,0,0,Normal
58638,5900,0,0,62,62,0,1,0,1,0,deny,0,1,Known Attack
47424,25174,0,0,66,66,0,1,0,1,0,deny,0,1,Known Attack
52087,80,10358,80,2757,648,2109,12,23,7,5,allow,1,0,Potential Threat
58631,445,0,0,70,70,0,1,0,1,0,drop,0,1,Known Attack
59985,443,35984,443,55132,17147,37985,126,150,55,71,allow,1,0,Potential Threat
52939,443,34090,443,16053,6801,9252,51,115,26,25,allow,1,0,Potential Threat
49563,53,41117,53,200,102,98,2,29,1,1,allow,0,0,Normal
58338,3362,0,0,60,60,0,1,0,1,0,deny,0,1,Known Attack
39132,44847,0,0,66,66,0,1,0,1,0,deny,0,1,Known Attack
51723,10622,43836,10622,70,70,0,2,8,2,0,allow,1,0,Potential Threat
51895,17172,22553,17172,70,70,0,1,5,1,0,allow,1,0,Potential Threat
0,0,0,0,98,98,0,1,0,1,0,deny,1,1,High Risk
43129,15503,0,0,62,62,0,1,0,1,0,deny,0,1,Known Attack
51923,22114,0,0,146,146,0,1,0,1,0,deny,1,1,High Risk
27005,27019,52593,27019,1007,252,755,4,32,3,1,allow,1,0,Potential Threat
16905,57866,0,0,66,66,0,1,0,1,0,deny,1,1,High Risk
56925,53,48692,53,196,102,94,2,30,1,1,allow,0,0,Normal
53176,445,0,0,66,66,0,1,0,1,0,drop,0,1,Known Attack
60191,443,1843,443,7292,950,6342,19,125,9,10,allow,1,0,Potential Threat
9476,443,21369,443,3999,905,3094,15,26,8,7,allow,1,0,Potential Threat
49737,443,56529,443,5566,1444,4122,17,129,10,7,allow,1,0,Potential Threat
49418,27020,23482,27020,248,78,170,2,30,1,1,allow,1,0,Potential Threat
26053,33720,0,0,160,160,0,1,0,1,0,deny,1,1,High Risk
37522,22114,0,0,62,62,0,1,0,1,0,deny,0,1,Known Attack
49723,53,26637,53,209,110,99,2,30,1,1,allow,0,0,Normal
63124,445,0,0,70,70,0,1,0,1,0,drop,0,1,Known Attack
51291,25174,0,0,62,62,0,1,0,1,0,deny,0,1,Known Attack
56892,53,3600,53,198,101,97,2,31,1,1,allow,0,0,Normal
49227,2710,25043,2710,70,70,0,1,5,1,0,allow,0,0,Normal
58062,443,59135,443,2257,1225,1032,15,18,8,7,allow,1,0,Potential Threat
55981,445,0,0,70,70,0,1,0,1,0,drop,0,1,Known Attack
48125,7548,0,0,60,60,0,1,0,1,0,deny,0,1,Known Attack
50444,443,31610,443,47752,21819,25933,119,704,59,60,allow,1,0,Potential Threat
53254,443,6395,443,310549,9420,301129,339,65,122,217,allow,1,0,Potential Threat
56367,44847,0,0,62,62,0,1,0,1,0,deny,0,1,Known Attack
53304,80,56632,80,130,64,66,3,4,2,1,allow,0,0,Normal
14435,443,15912,443,2569,1470,1099,17,15,8,9,allow,1,0,Potential Threat
28012,443,23129,443,6388,1112,5276,18,75,9,9,allow,1,0,Potential Threat
58499,445,0,0,70,70,0,1,0,1,0,drop,0,1,Known Attack
42022,80,12678,80,31196,607,30589,29,500,5,24,allow,1,0,Potential Threat
26699,35253,0,0,62,62,0,1,0,1,0,deny,0,1,Known Attack
55898,445,0,0,66,66,0,1,0,1,0,drop,0,1,Known Attack
49543,53,52836,53,200,102,98,2,30,1,1,allow,0,0,Normal
55635,445,0,0,70,70,0,1,0,1,0,drop,0,1,Known Attack
64959,53,64959,53,398,255,143,3,33,2,1,allow,1,0,Potential Threat
52569,30188,0,0,66,66,0,1,0,1,0,deny,0,1,Known Attack
29744,53,29744,53,235,90,145,2,33,1,1,allow,0,0,Normal
6712,5632,0,0,60,60,0,1,0,1,0,deny,0,1,Known Attack
5841,22114,0,0,62,62,0,1,0,1,0,deny,1,1,High Risk
60371,443,40685,443,7202,2596,4606,24,83,12,12,allow,1,0,Potential Threat
62854,445,0,0,70,70,0,1,0,1,0,drop,0,1,Known Attack
56995,53,19045,53,196,94,102,2,30,1,1,allow,0,0,Normal
2081,7000,2081,7000,5914,4395,1519,19,15,10,9,allow,1,0,Potential Threat
64082,53,17005,53,356,97,259,4,58,2,2,allow,0,0,Normal
59417,443,49153,443,2898,1700,1198,16,15,8,8,allow,1,0,Potential Threat
60894,445,0,0,66,66,0,1,0,1,0,drop,0,1,Known Attack
41095,443,28178,443,108842,88940,19902,313,255,159,154,allow,1,0,Potential Threat
49890,443,37248,443,9545,2433,7112,24,142,10,14,allow,1,0,Potential Threat
34014,80,56105,80,1951,731,1220,11,150,6,5,allow,1,0,Potential Threat
57015,42707,0,0,62,62,0,1,0,1,0,deny,0,1,Known Attack
63849,445,0,0,70,70,0,1,0,1,0,drop,0,1,Known Attack
54142,7000,54142,7000,4067,1750,2317,16,16,9,7,allow,1,0,Potential Threat
58994,443,55812,443,3284,1878,1406,20,27,11,9,allow,1,0,Potential Threat
39192,80,42667,80,62592,60966,1626,63,16,47,16,allow,1,0,Potential Threat
58638,5900,0,0,62,62,0,1,0,1,0,deny,0,1,Known Attack
51414,443,43551,443,78740,40216,38524,126,42,66,60,allow,1,0,Potential Threat
33136,443,16239,443,6648,1556,5092,23,29,13,10,allow,1,0,Potential Threat
64487,53,6176,53,225,110,115,2,30,1,1,allow,0,0,Normal
55137,445,0,0,70,70,0,1,0,1,0,drop,0,1,Known Attack
64566,443,6952,443,8573,2039,6534,25,31,14,11,allow,1,0,Potential Threat
5588,5588,0,0,3354,1792,1562,46,194,23,23,allow,1,0,Potential Threat
64346,51505,0,0,66,66,0,1,0,1,0,deny,1,1,High Risk
27366,5222,55342,5222,3833,1007,2826,27,68,11,16,allow,1,0,Potential Threat
56721,443,14378,443,7889,1900,5989,20,15,11,9,allow,1,0,Potential Threat
58638,5900,0,0,62,62,0,1,0,1,0,deny,0,1,Known Attack
53660,443,43128,443,350,210,140,6,24,4,2,allow,0,0,Normal
64874,53,41940,53,324,94,230,2,30,1,1,allow,0,0,Normal
63970,53,19074,53,228,110,118,2,30,1,1,allow,0,0,Normal
53669,80,61903,80,1119,665,454,12,15,7,5,allow,1,0,Potential Threat
55943,53,5113,53,1415,94,1321,4,31,2,2,allow,0,0,Normal
56111,53,50559,53,168,94,74,2,30,1,1,allow,0,0,Normal
47595,33438,0,0,106,106,0,1,60,1,0,allow,1,0,Potential Threat
52434,53,49925,53,183,86,97,2,30,1,1,allow,0,0,Normal
36754,7,13340,7,138,78,60,2,5,1,1,allow,0,0,Normal
56022,53,29566,53,728,102,626,2,30,1,1,allow,0,0,Normal
64191,44847,0,0,66,66,0,1,0,1,0,deny,1,1,High Risk
51450,80,49507,80,214,140,74,4,15,3,1,allow,0,0,Normal
49394,443,39992,443,6211,1869,4342,18,181,8,10,allow,1,0,Potential Threat
52919,445,0,0,66,66,0,1,0,1,0,drop,0,1,Known Attack
58851,445,0,0,70,70,0,1,0,1,0,drop,0,1,Known Attack
39921,80,15019,80,1151,711,440,10,15,5,5,allow,1,0,Potential Threat
60671,445,0,0,70,70,0,1,0,1,0,drop,0,1,Known Attack
38700,53,38476,53,164,78,86,2,30,1,1,allow,0,0,Normal
37570,443,53443,443,986,499,487,9,17,5,4,allow,1,0,Potential Threat
35556,443,19765,443,2988,1649,1339,17,255,9,8,allow,1,0,Potential Threat
57774,445,0,0,70,70,0,1,0,1,0,drop,0,1,Known Attack
61896,34021,0,0,66,66,0,1,91,1,0,allow,1,0,Potential Threat
58850,443,33361,443,9035,5883,3152,26,17,14,12,allow,1,0,Potential Threat
59544,445,0,0,70,70,0,1,0,1,0,drop,0,1,Known Attack
59422,51221,0,0,62,62,0,1,0,1,0,deny,0,1,Known Attack
53732,22704,63994,22704,70,70,0,2,8,2,0,allow,1,0,Potential Threat
64815,37965,0,0,62,62,0,1,0,1,0,deny,1,1,High Risk
59773,53,11146,53,218,78,140,2,31,1,1,allow,0,0,Normal
42389,42873,0,0,74,74,0,1,0,1,0,deny,0,1,Known Attack
22583,53,22583,53,213,82,131,2,30,1,1,allow,0,0,Normal
3377,50584,0,0,62,62,0,1,0,1,0,deny,1,1,High Risk
51855,23268,16577,23268,70,70,0,1,5,1,0,allow,1,0,Potential Threat
57860,443,46825,443,1786,172,1614,7,120,3,4,allow,1,0,Potential Threat
51798,443,51798,443,14904,6448,8456,33,30,18,15,allow,1,0,Potential Threat
56608,445,0,0,70,70,0,1,0,1,0,drop,0,1,Known Attack
2267,53,13385,53,204,118,86,2,31,1,1,allow,1,0,Potential Threat
55470,53,60625,53,310,94,216,2,30,1,1,allow,0,0,Normal
62627,7000,62627,7000,2990,1599,1391,15,15,8,7,allow,1,0,Potential Threat
50563,445,0,0,70,70,0,1,0,1,0,drop,0,1,Known Attack
62571,445,0,0,70,70,0,1,0,1,0,drop,0,1,Known Attack
65420,53,28650,53,166,86,80,2,31,1,1,allow,0,0,Normal
0,0,0,0,98,98,0,1,0,1,0,deny,1,1,High Risk
56601,53,16656,53,239,94,145,2,31,1,1,allow,0,0,Normal
6889,45129,0,0,159,159,0,1,0,1,0,deny,1,1,High Risk
49160,34068,0,0,146,146,0,1,0,1,0,deny,1,1,High Risk
58475,11392,0,0,66,66,0,1,0,1,0,deny,0,1,Known Attack
63554,445,0,0,70,70,0,1,0,1,0,drop,0,1,Known Attack
49602,53,44779,53,247,102,145,2,30,1,1,allow,0,0,Normal
56676,445,0,0,70,70,0,1,0,1,0,drop,0,1,Known Attack
55026,53,50435,53,177,94,83,2,30,1,1,allow,0,0,Normal
52455,443,34682,443,7356,1014,6342,20,75,10,10,allow,1,0,Potential Threat
38140,443,56534,443,11484,3842,7642,30,31,16,14,allow,1,0,Potential Threat
56601,445,0,0,70,70,0,1,0,1,0,drop,0,1,Known Attack
59534,53,0,0,216,72,144,2,30,1,1,allow,0,0,Normal
49250,53,39996,53,225,110,115,2,29,1,1,allow,0,0,Normal
56226,53,55576,53,512,187,325,6,58,3,3,allow,0,0,Normal
48668,7275,13487,7275,276,70,206,5,32,2,3,allow,1,0,Potential Threat
52540,443,62112,443,153,93,60,2,5,1,1,allow,1,0,Potential Threat
48783,53,0,0,86,86,0,1,30,1,0,allow,0,0,Normal
57995,80,53962,80,4065,2650,1415,25,75,13,12,allow,1,0,Potential Threat
57094,445,0,0,70,70,0,1,0,1,0,drop,0,1,Known Attack
62388,39004,0,0,62,62,0,1,0,1,0,deny,0,1,Known Attack
65075,53,31161,53,293,94,199,2,29,1,1,allow,0,0,Normal
50306,443,42473,443,2474,735,1739,11,120,6,5,allow,1,0,Potential Threat
53721,62413,0,0,62,62,0,1,0,1,0,deny,1,1,High Risk
51994,443,26093,443,330,190,140,6,15,4,2,allow,0,0,Normal
56285,53,7225,53,751,95,656,2,31,1,1,allow,0,0,Normal
49656,443,4978,443,182624,7130,175494,212,132,77,135,allow,1,0,Potential Threat
56962,53,9303,53,177,94,83,2,30,1,1,allow,0,0,Normal
45964,7776,0,0,60,60,0,1,0,1,0,deny,0,1,Known Attack
52223,11979,36766,11979,70,70,0,2,9,2,0,allow,1,0,Potential Threat
42237,36237,0,0,66,66,0,1,0,1,0,deny,0,1,Known Attack
52660,445,0,0,66,66,0,1,0,1,0,drop,0,1,Known Attack
60037,445,0,0,70,70,0,1,0,1,0,drop,0,1,Known Attack
56372,53,7936,53,172,94,78,2,30,1,1,allow,0,0,Normal
9098,443,52183,443,6177,969,5208,17,26,9,8,allow,1,0,Potential Threat
50025,53,41046,53,369,150,219,2,30,1,1,allow,0,0,Normal
61185,54532,0,0,62,62,0,1,0,1,0,deny,1,1,High Risk
57456,443,23040,443,1857,1218,639,18,119,11,7,allow,1,0,Potential Threat
49837,53,8590,53,176,90,86,2,30,1,1,allow,0,0,Normal
49229,53,18433,53,178,94,84,2,31,1,1,allow,0,0,Normal
44414,23718,0,0,66,66,0,1,0,1,0,deny,0,1,Known Attack
4760,44847,0,0,62,62,0,1,0,1,0,deny,1,1,High Risk
57470,29500,37295,29500,2772,2772,0,43,2311,43,0,allow,1,0,Potential Threat
52450,445,0,0,70,70,0,1,0,1,0,drop,0,1,Known Attack
11859,64147,0,0,62,62,0,1,0,1,0,deny,1,1,High Risk
51906,17491,64843,17491,70,70,0,2,8,2,0,allow,1,0,Potential Threat
52640,6881,33244,6881,719,413,306,10,14,5,5,allow,1,0,Potential Threat
57614,445,0,0,70,70,0,1,0,1,0,drop,0,1,Known Attack
56245,80,56245,80,101179,1296,99883,88,15,18,70,allow,1,0,Potential Threat
60247,445,0,0,70,70,0,1,0,1,0,drop,0,1,Known Attack
49980,445,0,0,70,70,0,1,0,1,0,drop,0,1,Known Attack
57156,445,0,0,66,66,0,1,0,1,0,drop,0,1,Known Attack
44558,443,44558,443,5480,2503,2977,20,15,11,9,allow,1,0,Potential Threat
64062,445,0,0,66,66,0,1,0,1,0,drop,0,1,Known Attack
53889,443,11378,443,499,425,74,4,0,3,1,allow,0,0,Normal
53200,443,25558,443,1462,965,497,13,18,7,6,allow,0,0,Normal
50002,53,23419,53,183,102,81,2,30,1,1,allow,0,0,Normal
61831,445,0,0,66,66,0,1,0,1,0,drop,0,1,Known Attack
30188,31063,61312,31063,502,150,352,2,1200,1,1,allow,1,0,Potential Threat
31991,23,0,0,60,60,0,1,0,1,0,deny,0,1,Known Attack
50986,443,50781,443,67798,17043,50755,202,146,110,92,allow,1,0,Potential Threat
56883,53,20999,53,184,94,90,2,30,1,1,allow,0,0,Normal
32787,80,54491,80,1412,848,564,14,316,8,6,allow,1,0,Potential Threat
55749,37965,0,0,66,66,0,1,0,1,0,deny,0,1,Known Attack
39094,443,50838,443,828718,43410,785308,1071,347,479,592,allow,1,0,Potential Threat
36770,56205,0,0,62,62,0,1,0,1,0,deny,1,1,High Risk
64805,53,57151,53,215,102,113,2,30,1,1,allow,0,0,Normal
55411,53,33954,53,183,94,89,2,30,1,1,allow,0,0,Normal
50037,53,12005,53,195,102,93,2,30,1,1,allow,0,0,Normal
57470,6881,64620,6881,577,251,326,4,1200,2,2,allow,1,0,Potential Threat
56922,53,56922,53,219,98,121,2,30,1,1,allow,0,0,Normal
36858,50265,0,0,146,146,0,1,0,1,0,deny,1,1,High Risk
51229,443,49748,443,8590,1038,7552,16,120,7,9,allow,1,0,Potential Threat
53171,445,0,0,70,70,0,1,0,1,0,drop,0,1,Known Attack
54989,443,3314,443,7745,2583,5162,27,100,15,12,allow,1,0,Potential Threat
50914,51505,0,0,66,66,0,1,0,1,0,deny,0,1,Known Attack
50041,443,6754,443,17237,1717,15520,36,152,16,20,allow,1,0,Potential Threat
58080,3389,58080,3389,3564,1850,1714,18,32,10,8,allow,1,0,Potential Threat
53897,443,53988,443,499,425,74,4,0,3,1,allow,0,0,Normal
43472,5228,13384,5228,2531,1416,1115,17,3600,8,9,allow,1,0,Potential Threat
58434,445,0,0,70,70,0,1,0,1,0,drop,0,1,Known Attack
64227,53,32450,53,245,94,151,2,30,1,1,allow,0,0,Normal
64050,53,59472,53,389,94,295,2,30,1,1,allow,0,0,Normal
49359,443,29384,443,6261,1362,4899,22,15,12,10,allow,1,0,Potential Threat
59398,445,0,0,66,66,0,1,0,1,0,drop,0,1,Known Attack
56703,80,22325,80,41915,4128,37787,59,64,29,30,allow,1,0,Potential Threat
64531,445,0,0,66,66,0,1,0,1,0,drop,0,1,Known Attack
61509,443,47638,443,1506,984,522,14,27,8,6,allow,1,0,Potential Threat
53822,18716,19485,18716,70,70,0,1,4,1,0,allow,1,0,Potential Threat
36812,53,60347,53,168,78,90,2,31,1,1,allow,1,0,Potential Threat
64603,53,49089,53,269,110,159,2,30,1,1,allow,0,0,Normal
58638,5900,58638,5900,126,62,64,2,5,1,1,allow,1,0,Potential Threat
51490,17500,0,0,100,100,0,1,0,1,0,deny,0,1,Known Attack
63041,53,42776,53,448,166,282,2,30,1,1,allow,0,0,Normal
59828,445,0,0,70,70,0,1,0,1,0,drop,0,1,Known Attack
39569,443,64666,443,125906,21096,104810,172,130,68,104,allow,1,0,Potential Threat
51461,445,0,0,70,70,0,1,0,1,0,drop,0,1,Known Attack
51709,40705,29645,40705,66,66,0,1,5,1,0,allow,1,0,Potential Threat
52181,443,64436,443,7855,815,7040,21,15,9,12,allow,1,0,Potential Threat
10004,40014,64871,40014,156,94,62,2,30,1,1,allow,1,0,Potential Threat
61721,443,43568,443,9676,2327,7349,25,16,15,10,allow,1,0,Potential Threat
20746,53,43830,53,191,86,105,2,30,1,1,allow,1,0,Potential Threat
54432,445,0,0,66,66,0,1,0,1,0,drop,0,1,Known Attack
51511,445,0,0,66,66,0,1,0,1,0,drop,0,1,Known Attack
37533,443,8271,443,5516,1774,3742,21,46,13,8,allow,1,0,Potential Threat
61270,445,0,0,70,70,0,1,0,1,0,drop,0,1,Known Attack
52936,5228,12223,5228,9201,2130,7071,41,5528,21,20,allow,1,0,Potential Threat
51102,443,49198,443,3402,1258,2144,13,135,6,7,allow,1,0,Potential Threat
10627,23117,0,0,66,66,0,1,0,1,0,deny,1,1,High Risk
6943,1,0,0,100,100,0,1,0,1,0,deny,0,1,Known Attack
59891,443,7306,443,1813,1004,809,16,28,8,8,allow,1,0,Potential Threat
26406,37965,0,0,66,66,0,1,0,1,0,deny,0,1,Known Attack
59201,51221,0,0,66,66,0,1,0,1,0,deny,0,1,Known Attack
54976,443,13251,443,8156,3281,4875,43,71,21,22,allow,1,0,Potential Threat
58775,443,62135,443,9017,5865,3152,26,16,14,12,allow,1,0,Potential Threat
53958,80,11138,80,130,70,60,2,15,1,1,allow,0,0,Normal
57406,445,0,0,70,70,0,1,0,1,0,drop,0,1,Known Attack
49426,57470,0,0,66,66,0,1,0,1,0,deny,0,1,Known Attack
53702,51413,14183,51413,70,70,0,2,7,2,0,allow,1,0,Potential Threat
53160,25174,0,0,146,146,0,1,0,1,0,deny,1,1,High Risk
39916,53,62317,53,168,78,90,2,30,1,1,allow,1,0,Potential Threat
58502,445,0,0,66,66,0,1,0,1,0,drop,0,1,Known Attack
49284,6881,63605,6881,411,225,186,6,16,3,3,allow,1,0,Potential Threat
47682,64147,0,0,66,66,0,1,0,1,0,deny,1,1,High Risk
56994,53,35888,53,177,94,83,2,30,1,1,allow,0,0,Normal
51857,40561,47310,40561,70,70,0,1,5,1,0,allow,1,0,Potential Threat
51837,37965,0,0,66,66,0,1,0,1,0,deny,0,1,Known Attack
53971,80,16324,80,662,448,214,10,15,7,3,allow,0,0,Normal
12821,37965,0,0,66,66,0,1,0,1,0,deny,1,1,High Risk
55740,8060,29494,8060,70,70,0,2,7,2,0,allow,1,0,Potential Threat
45013,50584,0,0,62,62,0,1,0,1,0,deny,0,1,Known Attack
55106,53,41822,53,177,94,83,2,30,1,1,allow,0,0,Normal
6890,34729,0,0,146,146,0,1,0,1,0,deny,1,1,High Risk
49764,53,54622,53,199,102,97,2,30,1,1,allow,0,0,Normal
53395,50321,40284,50321,7546,4168,3378,37,53,24,13,allow,1,0,Potential Threat
6881,49001,20436,49001,210,111,99,2,1201,1,1,allow,1,0,Potential Threat
56769,53,31740,53,183,94,89,2,30,1,1,allow,0,0,Normal
41296,80,53379,80,1056,682,374,10,15,6,4,allow,1,0,Potential Threat
56997,53,62280,53,86,86,0,1,30,1,0,allow,1,0,Potential Threat
63492,445,0,0,70,70,0,1,0,1,0,drop,0,1,Known Attack
65336,53,14965,53,732,89,643,2,31,1,1,allow,0,0,Normal
39548,8696,0,0,60,60,0,1,0,1,0,deny,0,1,Known Attack
54221,57470,0,0,66,66,0,1,0,1,0,deny,0,1,Known Attack
1024,44847,0,0,62,62,0,1,0,1,0,deny,1,1,High Risk
58570,445,0,0,70,70,0,1,0,1,0,drop,0,1,Known Attack
60113,443,5252,443,704,280,424,11,19,5,6,allow,1,0,Potential Threat
49359,80,26843,80,60,60,0,2,154,2,0,allow,0,0,Normal
51900,48817,0,0,146,146,0,1,0,1,0,deny,1,1,High Risk
56860,49991,37577,49991,70,70,0,2,8,2,0,allow,1,0,Potential Threat
52245,445,0,0,66,66,0,1,0,1,0,drop,0,1,Known Attack
49402,443,59952,443,7965,4044,3921,63,464,30,33,allow,1,0,Potential Threat
52247,443,52247,443,948720,23674,925046,988,26,349,639,allow,1,0,Potential Threat
50283,445,0,0,70,70,0,1,0,1,0,drop,0,1,Known Attack
56314,53,10977,53,183,94,89,2,30,1,1,allow,0,0,Normal
54699,53,18510,53,236,86,150,2,30,1,1,allow,0,0,Normal
52321,26467,0,0,62,62,0,1,0,1,0,deny,0,1,Known Attack
52267,443,8782,443,24712,9272,15440,65,136,34,31,allow,1,0,Potential Threat
56687,53,1087,53,225,110,115,2,30,1,1,allow,0,0,Normal
64803,53,39873,53,102,102,0,1,30,1,0,allow,0,0,Normal
57441,57470,0,0,66,66,0,1,0,1,0,deny,1,1,High Risk
14656,36237,0,0,66,66,0,1,0,1,0,deny,1,1,High Risk
60277,443,60277,443,7428,729,6699,19,80,7,12,allow,1,0,Potential Threat
58264,44847,0,0,66,66,0,1,0,1,0,deny,0,1,Known Attack
46072,443,46479,443,16656,3094,13562,29,271,14,15,allow,1,0,Potential Threat
5938,6987,0,0,60,60,0,1,90,1,0,allow,1,0,Potential Threat
49591,53,7578,53,168,86,82,2,32,1,1,allow,0,0,Normal
55089,53,6638,53,199,102,97,2,30,1,1,allow,0,0,Normal
54837,445,0,0,66,66,0,1,0,1,0,drop,0,1,Known Attack
50797,445,0,0,66,66,0,1,0,1,0,drop,0,1,Known Attack
51166,31573,0,0,66,66,0,1,0,1,0,deny,0,1,Known Attack
58638,5900,0,0,62,62,0,1,0,1,0,deny,0,1,Known Attack
20727,53,20727,53,217,82,135,2,32,1,1,allow,0,0,Normal
65476,443,36901,443,93073,4939,88134,111,16,45,66,allow,1,0,Potential Threat
34914,25604,0,0,145,145,0,1,0,1,0,deny,1,1,High Risk
55439,37965,0,0,66,66,0,1,0,1,0,deny,0,1,Known Attack
56872,445,0,0,70,70,0,1,0,1,0,drop,0,1,Known Attack
5588,5588,0,0,3354,1792,1562,46,192,23,23,allow,1,0,Potential Threat
55747,445,0,0,70,70,0,1,0,1,0,drop,0,1,Known Attack
49908,56205,0,0,62,62,0,1,0,1,0,deny,0,1,Known Attack
56094,445,0,0,66,66,0,1,0,1,0,drop,0,1,Known Attack
56742,443,19670,443,1327,918,409,10,34,6,4,allow,0,0,Normal
49567,5223,11151,5223,9705,5123,4582,29,74,15,14,allow,1,0,Potential Threat
58086,445,0,0,70,70,0,1,0,1,0,drop,0,1,Known Attack
55475,53,28600,53,757,102,655,2,29,1,1,allow,0,0,Normal
55958,53,14434,53,177,94,83,2,30,1,1,allow,0,0,Normal
11488,22114,0,0,66,66,0,1,0,1,0,deny,0,1,Known Attack
5729,22114,0,0,66,66,0,1,0,1,0,deny,1,1,High Risk
51546,445,0,0,70,70,0,1,0,1,0,deny,0,1,Known Attack
50143,35253,0,0,66,66,0,1,0,1,0,deny,0,1,Known Attack
50891,80,64394,80,136656,9764,126892,162,140,70,92,allow,1,0,Potential Threat
37568,443,2020,443,499,425,74,4,0,3,1,allow,1,0,Potential Threat
43326,443,43455,443,8065,2689,5376,27,315,14,13,allow,1,0,Potential Threat
32185,53,63584,53,86,86,0,1,30,1,0,allow,1,0,Potential Threat
51769,19165,28138,19165,70,70,0,2,8,2,0,allow,1,0,Potential Threat
1138,42873,0,0,62,62,0,1,0,1,0,deny,1,1,High Risk
37616,443,9088,443,702409,17257,685152,698,32,233,465,allow,1,0,Potential Threat
60192,35440,0,0,66,66,0,1,0,1,0,deny,0,1,Known Attack
50679,443,24042,443,14172,2714,11458,32,637,13,19,allow,1,0,Potential Threat
55857,53,40207,53,199,102,97,2,29,1,1,allow,0,0,Normal
64490,445,0,0,70,70,0,1,0,1,0,drop,0,1,Known Attack
50257,3389,50257,3389,3473,1518,1955,17,18,9,8,allow,1,0,Potential Threat
64484,53,32900,53,732,239,493,6,51,3,3,allow,1,0,Potential Threat
64438,53,4120,53,184,94,90,2,30,1,1,allow,0,0,Normal
55703,445,0,0,70,70,0,1,0,1,0,drop,0,1,Known Attack
11136,15503,0,0,62,62,0,1,0,1,0,deny,0,1,Known Attack
49207,443,63518,443,19566,12185,7381,89,176,42,47,allow,1,0,Potential Threat
53756,50584,0,0,66,66,0,1,0,1,0,deny,0,1,Known Attack
52727,445,0,0,66,66,0,1,0,1,0,drop,0,1,Known Attack
53795,443,29582,443,499,425,74,4,0,3,1,allow,0,0,Normal
50430,80,29932,80,318,192,126,6,26,4,2,allow,0,0,Normal
57131,31061,0,0,145,145,0,1,0,1,0,deny,1,1,High Risk
45900,443,8565,443,1277649,37293,1240356,1337,303,459,878,allow,1,0,Potential Threat
62613,445,0,0,66,66,0,1,0,1,0,drop,0,1,Known Attack
21133,18719,1173,18719,150,150,0,1,1200,1,0,allow,1,0,Potential Threat
55423,53,51640,53,177,94,83,2,30,1,1,allow,0,0,Normal
50795,445,0,0,66,66,0,1,0,1,0,drop,0,1,Known Attack
51413,10387,0,0,139,139,0,1,0,1,0,deny,0,1,Known Attack
16387,64075,0,0,60,60,0,1,0,1,0,deny,1,1,High Risk
59769,445,0,0,70,70,0,1,0,1,0,drop,0,1,Known Attack
49556,53,40428,53,300,100,200,4,44,2,2,allow,0,0,Normal
56872,21247,0,0,74,74,0,1,0,1,0,deny,0,1,Known Attack
64366,53,57312,53,234,94,140,2,30,1,1,allow,0,0,Normal
58840,443,27383,443,5108,700,4408,15,15,7,8,allow,1,0,Potential Threat
57176,53,43366,53,178,94,84,2,30,1,1,allow,0,0,Normal
52210,51505,0,0,62,62,0,1,0,1,0,deny,0,1,Known Attack
61706,64147,0,0,62,62,0,1,0,1,0,deny,1,1,High Risk
53346,445,0,0,70,70,0,1,0,1,0,drop,0,1,Known Attack
50353,80,65364,80,8007,830,7177,17,30,8,9,allow,1,0,Potential Threat
49767,53,2563,53,177,94,83,2,30,1,1,allow,0,0,Normal
65286,53,17051,53,756,94,662,2,30,1,1,allow,0,0,Normal
50999,443,48896,443,33716,17750,15966,134,329,72,62,allow,1,0,Potential Threat
64024,445,0,0,70,70,0,1,0,1,0,drop,0,1,Known Attack
58830,443,23946,443,5168,700,4468,16,15,7,9,allow,1,0,Potential Threat
60306,53,57588,53,168,78,90,2,29,1,1,allow,0,0,Normal
2267,53,57413,53,204,118,86,2,31,1,1,allow,1,0,Potential Threat
65028,53,37363,53,79,79,0,2,33,2,0,allow,0,0,Normal
58638,5900,0,0,62,62,0,1,0,1,0,deny,0,1,Known Attack
49730,53,34658,53,194,102,92,2,30,1,1,allow,0,0,Normal
44546,53,44546,53,204,92,112,2,30,1,1,allow,0,0,Normal
62034,53,62034,53,216,90,126,2,30,1,1,allow,1,0,Potential Threat
50419,26467,0,0,66,66,0,1,0,1,0,deny,0,1,Known Attack
56939,445,0,0,70,70,0,1,0,1,0,drop,0,1,Known Attack
65463,53,50986,53,177,94,83,2,30,1,1,allow,0,0,Normal
50970,445,0,0,70,70,0,1,0,1,0,drop,0,1,Known Attack
64316,53,5577,53,184,94,90,2,30,1,1,allow,0,0,Normal
57335,53,58927,53,177,94,83,2,30,1,1,allow,0,0,Normal
63998,21247,0,0,66,66,0,1,0,1,0,deny,0,1,Known Attack
45766,2323,0,0,60,60,0,1,0,1,0,deny,0,1,Known Attack
65386,53,49656,53,197,102,95,2,33,1,1,allow,0,0,Normal
52765,445,0,0,70,70,0,1,0,1,0,drop,0,1,Known Attack
64524,53,53824,53,235,102,133,2,30,1,1,allow,0,0,Normal
51879,38564,27585,38564,70,70,0,2,8,2,0,allow,1,0,Potential Threat
57432,443,39026,443,2714,336,2378,10,120,5,5,allow,1,0,Potential Threat
49264,445,0,0,66,66,0,1,0,1,0,drop,0,1,Known Attack
58881,445,0,0,70,70,0,1,0,1,0,drop,0,1,Known Attack
60814,443,39150,443,740,222,518,11,3631,4,7,allow,1,0,Potential Threat
64016,445,0,0,66,66,0,1,0,1,0,drop,0,1,Known Attack
58131,1,0,0,146,146,0,1,0,1,0,deny,0,1,Known Attack
1860,25174,0,0,66,66,0,1,0,1,0,deny,1,1,High Risk
42298,40039,27373,40039,148,86,62,2,30,1,1,allow,1,0,Potential Threat
25150,53,25150,53,217,87,130,2,30,1,1,allow,0,0,Normal
55458,445,0,0,70,70,0,1,0,1,0,drop,0,1,Known Attack
50777,445,0,0,70,70,0,1,0,1,0,drop,0,1,Known Attack
56214,53,47113,53,200,102,98,2,33,1,1,allow,0,0,Normal
56639,445,0,0,70,70,0,1,0,1,0,drop,0,1,Known Attack
32299,40019,6627,40019,261,175,86,2,31,1,1,allow,1,0,Potential Threat
1935,53,17873,53,260,86,174,2,30,1,1,allow,1,0,Potential Threat
53650,53,49968,53,199,94,105,2,29,1,1,allow,0,0,Normal
10833,23,0,0,60,60,0,1,0,1,0,deny,0,1,Known Attack
30114,65151,0,0,60,60,0,1,0,1,0,deny,1,1,High Risk
55759,445,0,0,66,66,0,1,0,1,0,drop,0,1,Known Attack
63759,64509,33605,64509,66,66,0,2,7,2,0,allow,1,0,Potential Threat
55967,445,0,0,70,70,0,1,0,1,0,drop,0,1,Known Attack
60415,53,0,0,82,82,0,1,30,1,0,allow,0,0,Normal
56169,53,27417,53,210,110,100,2,29,1,1,allow,0,0,Normal
49201,443,23062,443,13738,6378,7360,70,981,33,37,allow,1,0,Potential Threat
63389,445,0,0,70,70,0,1,0,1,0,drop,0,1,Known Attack
49803,80,1813,80,2553,1621,932,13,126,8,5,allow,1,0,Potential Threat
52173,80,40738,80,362,240,122,7,17,5,2,allow,0,0,Normal
49554,445,0,0,70,70,0,1,0,1,0,drop,0,1,Known Attack
65143,53,22648,53,822,102,720,2,29,1,1,allow,0,0,Normal
29291,48983,0,0,150,150,0,1,0,1,0,deny,1,1,High Risk
54289,445,0,0,70,70,0,1,0,1,0,drop,0,1,Known Attack
65132,445,0,0,70,70,0,1,0,1,0,drop,0,1,Known Attack
13223,1310,0,0,62,62,0,1,0,1,0,deny,0,1,Known Attack
49855,36180,0,0,62,62,0,1,0,1,0,deny,0,1,Known Attack
55722,53,19688,53,226,110,116,2,30,1,1,allow,0,0,Normal
60945,443,60187,443,1373,712,661,14,18,8,6,allow,1,0,Potential Threat
56303,53,63690,53,177,94,83,2,29,1,1,allow,1,0,Potential Threat
59813,53,1465,53,355,118,237,2,30,1,1,allow,0,0,Normal
1536,48817,0,0,62,62,0,1,0,1,0,deny,1,1,High Risk
57264,53,53973,53,197,102,95,2,30,1,1,allow,0,0,Normal
49183,445,0,0,66,66,0,1,0,1,0,drop,0,1,Known Attack
55385,443,7012,443,11771,2624,9147,50,20,25,25,allow,1,0,Potential Threat
54315,445,0,0,66,66,0,1,0,1,0,drop,0,1,Known Attack
4760,44847,0,0,62,62,0,1,0,1,0,deny,1,1,High Risk
56534,53,47047,53,177,94,83,2,29,1,1,allow,0,0,Normal
58699,445,0,0,70,70,0,1,0,1,0,drop,0,1,Known Attack
26900,27017,44727,27017,422,164,258,6,30,3,3,allow,1,0,Potential Threat
51972,80,28549,80,7001170,112187,6888983,6101,29,1546,4555,allow,1,0,Potential Threat
53812,443,40871,443,2966,801,2165,13,135,6,7,allow,1,0,Potential Threat
49450,53,29878,53,758,102,656,2,30,1,1,allow,0,0,Normal
49429,53,3365,53,199,102,97,2,29,1,1,allow,0,0,Normal
51841,445,0,0,70,70,0,1,0,1,0,drop,0,1,Known Attack
52451,56205,0,0,66,66,0,1,0,1,0,deny,0,1,Known Attack
54814,445,0,0,70,70,0,1,0,1,0,drop,0,1,Known Attack
61925,51505,0,0,62,62,0,1,0,1,0,deny,1,1,High Risk
58638,5900,0,0,62,62,0,1,0,1,0,deny,0,1,Known Attack
63561,445,0,0,70,70,0,1,0,1,0,drop,0,1,Known Attack
53812,45694,7999,45694,3156,1011,2145,16,16,8,8,allow,1,0,Potential Threat
15274,81,0,0,60,60,0,1,0,1,0,deny,0,1,Known Attack
64212,445,0,0,66,66,0,1,0,1,0,drop,0,1,Known Attack
59919,445,0,0,70,70,0,1,0,1,0,drop,0,1,Known Attack
40215,443,8042,443,6423,1543,4880,21,191,12,9,allow,1,0,Potential Threat
54992,53,12659,53,190,97,93,2,31,1,1,allow,0,0,Normal
54425,443,49600,443,1648,813,835,17,186,9,8,allow,1,0,Potential Threat
50398,445,0,0,66,66,0,1,0,1,0,drop,0,1,Known Attack
65257,445,0,0,70,70,0,1,0,1,0,drop,0,1,Known Attack
23763,23,0,0,60,60,0,1,0,1,0,deny,0,1,Known Attack
57033,445,0,0,66,66,0,1,0,1,0,drop,0,1,Known Attack
55002,80,41422,80,10872190,337459,10534731,12500,208,5532,6968,allow,1,0,Potential Threat
49414,53,44484,53,561,112,449,4,53,2,2,allow,0,0,Normal
36497,80,36497,80,7594,863,6731,18,21,8,10,allow,1,0,Potential Threat
59736,51505,0,0,62,62,0,1,0,1,0,deny,0,1,Known Attack
49926,53,49666,53,176,90,86,2,31,1,1,allow,0,0,Normal
57140,53,16030,53,170,87,83,2,30,1,1,allow,0,0,Normal
65072,80,65072,80,250600,11390,239210,268,23,98,170,allow,1,0,Potential Threat
34964,80,34964,80,2889,1482,1407,10,15,6,4,allow,1,0,Potential Threat
44849,46478,0,0,74,74,0,1,0,1,0,deny,0,1,Known Attack
38320,51505,0,0,66,66,0,1,0,1,0,deny,0,1,Known Attack
51667,25826,43364,25826,9372,9372,0,11,30,11,0,allow,1,0,Potential Threat
64102,445,0,0,70,70,0,1,0,1,0,drop,0,1,Known Attack
53746,445,0,0,70,70,0,1,0,1,0,drop,0,1,Known Attack
52361,23718,0,0,66,66,0,1,0,1,0,deny,0,1,Known Attack
61491,445,0,0,70,70,0,1,0,1,0,drop,0,1,Known Attack
50188,443,57063,443,6357,1079,5278,18,32,10,8,allow,1,0,Potential Threat
41004,5000,0,0,60,60,0,1,0,1,0,deny,0,1,Known Attack
65152,53,2972,53,763,102,661,2,30,1,1,allow,1,0,Potential Threat
54997,445,0,0,70,70,0,1,0,1,0,drop,0,1,Known Attack
41049,443,3441,443,197239,6098,191141,213,170,75,138,allow,1,0,Potential Threat
54435,443,54824,443,18802,3386,15416,54,293,28,26,allow,1,0,Potential Threat
49500,53,31434,53,248,118,130,2,29,1,1,allow,0,0,Normal
60728,445,0,0,70,70,0,1,0,1,0,drop,0,1,Known Attack
65376,445,0,0,66,66,0,1,0,1,0,drop,0,1,Known Attack
58701,445,0,0,66,66,0,1,0,1,0,drop,0,1,Known Attack
35461,44847,0,0,146,146,0,1,0,1,0,deny,1,1,High Risk
443,38956,0,0,82,82,0,1,0,1,0,deny,1,1,High Risk
55664,53,60480,53,177,94,83,2,29,1,1,allow,0,0,Normal
49690,50265,0,0,62,62,0,1,0,1,0,deny,0,1,Known Attack
55894,53,40691,53,216,102,114,2,30,1,1,allow,0,0,Normal
64568,443,63585,443,25404,2462,22942,47,32,25,22,allow,1,0,Potential Threat
45964,2225,0,0,60,60,0,1,0,1,0,deny,0,1,Known Attack
51833,445,0,0,66,66,0,1,0,1,0,drop,0,1,Known Attack
59112,443,3834,443,7174,1831,5343,31,110,17,14,allow,1,0,Potential Threat
65014,53,29342,53,193,102,91,2,30,1,1,allow,0,0,Normal
42298,40032,22903,40032,720,549,171,4,30,2,2,allow,1,0,Potential Threat
56615,80,9225,80,234,234,0,4,11,4,0,allow,0,0,Normal
57662,445,0,0,70,70,0,1,0,1,0,drop,0,1,Known Attack
60313,445,0,0,70,70,0,1,0,1,0,drop,0,1,Known Attack
60175,445,0,0,66,66,0,1,0,1,0,drop,0,1,Known Attack
55642,445,0,0,70,70,0,1,0,1,0,drop,0,1,Known Attack
47053,80,59078,80,1188,463,725,8,15,5,3,allow,1,0,Potential Threat
50803,445,0,0,66,66,0,1,0,1,0,drop,0,1,Known Attack
60469,445,0,0,70,70,0,1,0,1,0,drop,0,1,Known Attack
52340,445,0,0,66,66,0,1,0,1,0,drop,0,1,Known Attack
51676,443,25301,443,90135,76061,14074,251,247,132,119,allow,1,0,Potential Threat
48706,23393,0,0,60,60,0,1,0,1,0,deny,0,1,Known Attack
65196,53,4463,53,177,94,83,2,30,1,1,allow,0,0,Normal
32910,443,36297,443,2299332,50663,2248669,2117,141,553,1564,allow,1,0,Potential Threat
14697,8000,26641,8000,212,150,62,2,31,1,1,allow,1,0,Potential Threat
53123,443,38611,443,1630,1089,541,14,15,8,6,allow,0,0,Normal
51214,443,63195,443,7924,3247,4677,32,71,19,13,allow,1,0,Potential Threat
49205,53,3818,53,720,94,626,2,30,1,1,allow,0,0,Normal
48757,443,52585,443,6353,1075,5278,18,33,10,8,allow,1,0,Potential Threat
59569,445,0,0,70,70,0,1,0,1,0,drop,0,1,Known Attack
51789,443,60352,443,6218,4326,1892,31,124,17,14,allow,1,0,Potential Threat
51913,80,58997,80,366,240,126,7,29,5,2,allow,0,0,Normal
52649,445,0,0,66,66,0,1,0,1,0,drop,0,1,Known Attack
51574,443,25990,443,3021,960,2061,14,135,7,7,allow,1,0,Potential Threat
54982,53,55508,53,282,96,186,4,48,2,2,allow,0,0,Normal
57364,53,64164,53,177,94,83,2,30,1,1,allow,1,0,Potential Threat
28649,43890,0,0,66,66,0,1,0,1,0,deny,1,1,High Risk
27969,25174,0,0,62,62,0,1,0,1,0,deny,0,1,Known Attack
64493,53,11797,53,199,102,97,2,30,1,1,allow,0,0,Normal
64804,445,0,0,70,70,0,1,0,1,0,drop,0,1,Known Attack
58056,443,35080,443,10493,2658,7835,50,1469,26,24,allow,1,0,Potential Threat
49450,443,10791,443,5792,1511,4281,19,77,11,8,allow,1,0,Potential Threat
49226,53,53578,53,765,102,663,2,30,1,1,allow,0,0,Normal
443,14591,0,0,131,131,0,1,0,1,0,deny,1,1,High Risk
54014,5228,26717,5228,2493,1541,952,16,3601,8,8,allow,1,0,Potential Threat
53768,445,0,0,66,66,0,1,0,1,0,drop,0,1,Known Attack
60476,55100,33461,55100,70,70,0,1,5,1,0,allow,1,0,Potential Threat
65287,53,49493,53,180,94,86,2,30,1,1,allow,0,0,Normal
55891,443,55891,443,4581,1674,2907,19,30,11,8,allow,1,0,Potential Threat
65315,53,30606,53,216,110,106,2,30,1,1,allow,0,0,Normal
57003,443,38569,443,8592,3700,4892,39,108,21,18,allow,1,0,Potential Threat
24219,1900,0,0,60,60,0,1,0,1,0,deny,0,1,Known Attack
52303,445,0,0,66,66,0,1,0,1,0,drop,0,1,Known Attack
51827,445,0,0,66,66,0,1,0,1,0,drop,0,1,Known Attack
56612,53,25011,53,274,87,187,4,31,2,2,allow,0,0,Normal
56752,53,57000,53,182,93,89,2,30,1,1,allow,0,0,Normal
50497,445,0,0,70,70,0,1,0,1,0,drop,0,1,Known Attack
65495,11392,0,0,66,66,0,1,0,1,0,deny,0,1,Known Attack
41868,443,44888,443,6204,1328,4876,21,139,12,9,allow,1,0,Potential Threat
59915,42707,0,0,145,145,0,1,0,1,0,deny,1,1,High Risk
61918,445,0,0,66,66,0,1,0,1,0,drop,0,1,Known Attack
1446,35440,0,0,66,66,0,1,0,1,0,deny,1,1,High Risk
42185,443,3806,443,15233,9395,5838,33,338,16,17,allow,1,0,Potential Threat
2084,7000,2084,7000,3566,1999,1567,16,15,8,8,allow,1,0,Potential Threat
49304,445,0,0,70,70,0,1,0,1,0,drop,0,1,Known Attack
57236,443,10665,443,225524,59002,166522,402,78,192,210,allow,1,0,Potential Threat
47788,12250,0,0,146,146,0,1,0,1,0,deny,0,1,Known Attack
49472,53,37751,53,210,110,100,2,30,1,1,allow,0,0,Normal
58638,5900,0,0,62,62,0,1,0,1,0,deny,0,1,Known Attack
50869,80,23647,80,28291,3346,24945,46,144,25,21,allow,1,0,Potential Threat
53864,443,51683,443,232,172,60,3,5,2,1,allow,0,0,Normal
10063,443,38761,443,822903,35544,787359,1068,153,463,605,allow,1,0,Potential Threat
64159,445,0,0,70,70,0,1,0,1,0,drop,0,1,Known Attack
46525,53,46525,53,404,259,145,3,32,2,1,allow,0,0,Normal
54644,443,54644,443,103968,5475,98493,141,18,63,78,allow,1,0,Potential Threat
49349,80,16332,80,2391,532,1859,11,76,6,5,allow,1,0,Potential Threat
49888,53,1710,53,198,102,96,2,29,1,1,allow,0,0,Normal
60437,445,0,0,66,66,0,1,0,1,0,drop,0,1,Known Attack
55936,53,1988,53,177,94,83,2,29,1,1,allow,0,0,Normal
46573,50584,0,0,62,62,0,1,0,1,0,deny,0,1,Known Attack
63531,445,0,0,70,70,0,1,0,1,0,drop,0,1,Known Attack
37565,443,55641,443,4898,1119,3779,17,30,9,8,allow,1,0,Potential Threat
53508,445,0,0,70,70,0,1,0,1,0,drop,0,1,Known Attack
51221,41939,7547,41939,3917,1584,2333,50,3325,25,25,allow,1,0,Potential Threat
44075,80,12675,80,3560,1256,2304,22,86,10,12,allow,1,0,Potential Threat
52626,445,0,0,70,70,0,1,0,1,0,drop,0,1,Known Attack
61787,445,0,0,70,70,0,1,0,1,0,drop,0,1,Known Attack
55212,443,36417,443,10500,5056,5444,23,143,11,12,allow,1,0,Potential Threat
64693,53,28781,53,248,102,146,2,30,1,1,allow,0,0,Normal
8999,57099,0,0,146,146,0,1,0,1,0,deny,1,1,High Risk
27328,21247,0,0,66,66,0,1,0,1,0,deny,0,1,Known Attack
47910,7454,0,0,60,60,0,1,0,1,0,deny,0,1,Known Attack
60300,80,12014,80,1343,846,497,11,145,6,5,allow,1,0,Potential Threat
34162,443,17948,443,4897,850,4047,15,15,9,6,allow,1,0,Potential Threat
51984,80,5183,80,48285,2659,45626,65,15,32,33,allow,1,0,Potential Threat
53129,38413,48065,38413,70,70,0,2,8,2,0,allow,1,0,Potential Threat
46327,25903,25335,25903,332,192,140,6,25,4,2,allow,1,0,Potential Threat
57380,443,31912,443,5553,927,4626,16,15,10,6,allow,0,0,Normal
56470,53,41515,53,198,102,96,2,30,1,1,allow,0,0,Normal
51073,443,51073,443,1210,637,573,14,25,7,7,allow,1,0,Potential Threat
53792,443,8707,443,499,425,74,4,0,3,1,allow,0,0,Normal
48174,443,2102,443,3889,1992,1897,19,255,10,9,allow,1,0,Potential Threat
56940,80,20270,80,2925,1480,1445,11,30,7,4,allow,0,0,Normal
65159,53,58481,53,500,204,296,6,75,3,3,allow,1,0,Potential Threat
49258,80,49258,80,17197,1551,15646,29,27,13,16,allow,1,0,Potential Threat
56648,443,37098,443,1327,918,409,10,26,6,4,allow,0,0,Normal
52490,443,51639,443,23518,8884,14634,32,15,15,17,allow,1,0,Potential Threat
55658,45261,61900,45261,70,70,0,1,5,1,0,allow,1,0,Potential Threat
60520,53,60520,53,248,106,142,2,29,1,1,allow,0,0,Normal
50968,443,1299,443,10759,3158,7601,29,75,16,13,allow,1,0,Potential Threat
50105,445,0,0,70,70,0,1,0,1,0,drop,0,1,Known Attack
38484,48637,0,0,60,60,0,1,0,1,0,deny,0,1,Known Attack
51251,443,24124,443,7950,2502,5448,38,16,22,16,allow,1,0,Potential Threat
56928,53,51278,53,178,94,84,2,30,1,1,allow,0,0,Normal
56285,443,32543,443,185763,7360,178403,201,120,68,133,allow,1,0,Potential Threat
5938,22455,0,0,60,60,0,1,90,1,0,allow,1,0,Potential Threat
55614,53,42097,53,309,110,199,2,30,1,1,allow,0,0,Normal
54995,53,9641,53,199,102,97,2,30,1,1,allow,0,0,Normal
63383,53,63383,53,235,90,145,2,33,1,1,allow,1,0,Potential Threat
43863,80,21010,80,2025,805,1220,12,46,7,5,allow,0,0,Normal
50843,443,54645,443,6337,1378,4959,19,135,9,10,allow,1,0,Potential Threat
64144,445,0,0,70,70,0,1,0,1,0,drop,0,1,Known Attack
61163,443,25794,443,8637,5348,3289,37,738,15,22,allow,1,0,Potential Threat
57466,445,0,0,70,70,0,1,0,1,0,drop,0,1,Known Attack
50978,445,0,0,66,66,0,1,0,1,0,drop,0,1,Known Attack
65332,53,1654,53,226,86,140,2,29,1,1,allow,0,0,Normal
19229,53,19229,53,213,87,126,2,31,1,1,allow,0,0,Normal
33556,25174,0,0,146,146,0,1,0,1,0,deny,1,1,High Risk
32515,443,32515,443,34885,6636,28249,74,51,38,36,allow,1,0,Potential Threat
13947,37965,0,0,145,145,0,1,0,1,0,deny,1,1,High Risk
49418,27015,17910,27015,232,71,161,2,31,1,1,allow,1,0,Potential Threat
54538,443,10842,443,2936,1546,1390,17,70,10,7,allow,1,0,Potential Threat
80,7597,0,0,66,66,0,1,0,1,0,deny,1,1,High Risk
63518,445,0,0,70,70,0,1,0,1,0,drop,0,1,Known Attack
55013,443,19104,443,7531,1773,5758,30,32,17,13,allow,1,0,Potential Threat
65056,53,56800,53,270,94,176,2,30,1,1,allow,0,0,Normal
65153,53,29688,53,168,86,82,2,30,1,1,allow,0,0,Normal
59964,443,8853,443,166170,5611,160559,189,16,78,111,allow,1,0,Potential Threat
64565,53,49218,53,802,104,698,2,31,1,1,allow,0,0,Normal
62902,445,0,0,70,70,0,1,0,1,0,drop,0,1,Known Attack
54964,443,18537,443,24232,10141,14091,74,76,39,35,allow,1,0,Potential Threat
49710,443,63933,443,7691,1797,5894,22,137,12,10,allow,1,0,Potential Threat
49227,445,0,0,70,70,0,1,0,1,0,drop,0,1,Known Attack
49308,53,20210,53,190,97,93,2,30,1,1,allow,0,0,Normal
51192,15503,0,0,66,66,0,1,0,1,0,deny,0,1,Known Attack
55427,53,28517,53,772,103,669,2,30,1,1,allow,0,0,Normal
55820,445,0,0,66,66,0,1,0,1,0,drop,0,1,Known Attack
61468,445,0,0,66,66,0,1,0,1,0,drop,0,1,Known Attack
59986,445,0,0,66,66,0,1,0,1,0,drop,0,1,Known Attack
54997,26467,0,0,62,62,0,1,0,1,0,deny,0,1,Known Attack
38629,25174,0,0,66,66,0,1,0,1,0,deny,0,1,Known Attack
56458,53,47423,53,196,102,94,2,30,1,1,allow,0,0,Normal
51267,445,0,0,70,70,0,1,0,1,0,drop,0,1,Known Attack
50008,53,59037,53,359,95,264,4,46,2,2,allow,0,0,Normal
64095,443,63841,443,9895,2094,7801,52,262,23,29,allow,1,0,Potential Threat
61461,443,61461,443,19070,4830,14240,33,18,18,15,allow,1,0,Potential Threat
55831,53,65358,53,183,94,89,2,30,1,1,allow,1,0,Potential Threat
55367,53,11900,53,195,102,93,2,30,1,1,allow,0,0,Normal
49270,53,46560,53,322,110,212,4,30,2,2,allow,0,0,Normal
49502,44847,0,0,66,66,0,1,0,1,0,deny,0,1,Known Attack
52037,80,5136,80,366,240,126,7,25,5,2,allow,0,0,Normal
50307,53,50594,53,1370,89,1281,4,33,2,2,allow,0,0,Normal
55160,445,0,0,70,70,0,1,0,1,0,drop,0,1,Known Attack
3765,64147,0,0,66,66,0,1,0,1,0,deny,1,1,High Risk
16862,21247,0,0,62,62,0,1,0,1,0,deny,0,1,Known Attack
55479,53,40449,53,184,94,90,2,31,1,1,allow,0,0,Normal
63627,26296,0,0,159,159,0,1,0,1,0,deny,1,1,High Risk
61315,48817,0,0,62,62,0,1,0,1,0,deny,1,1,High Risk
59403,445,0,0,66,66,0,1,0,1,0,drop,0,1,Known Attack
49851,53,3240,53,166,86,80,2,30,1,1,allow,0,0,Normal
56819,443,59951,443,79878,10479,69399,138,120,68,70,allow,1,0,Potential Threat
63878,445,0,0,70,70,0,1,0,1,0,drop,0,1,Known Attack
51287,26467,0,0,66,66,0,1,0,1,0,deny,0,1,Known Attack
56293,53,53658,53,166,86,80,2,30,1,1,allow,0,0,Normal
33161,80,27979,80,604,530,74,7,15,6,1,allow,1,0,Potential Threat
51490,445,0,0,66,66,0,1,0,1,0,drop,0,1,Known Attack
61538,445,0,0,66,66,0,1,0,1,0,drop,0,1,Known Attack
56736,53,58809,53,283,94,189,4,41,2,2,allow,0,0,Normal
49661,53,62903,53,344,102,242,2,30,1,1,allow,1,0,Potential Threat
49747,443,22101,443,7087,1705,5382,19,128,10,9,allow,1,0,Potential Threat
65140,53,14372,53,199,102,97,2,30,1,1,allow,0,0,Normal
65102,53,16634,53,210,102,108,2,30,1,1,allow,0,0,Normal
42252,33303,0,0,60,60,0,1,0,1,0,deny,0,1,Known Attack
55536,445,0,0,70,70,0,1,0,1,0,drop,0,1,Known Attack
61995,445,0,0,70,70,0,1,0,1,0,drop,0,1,Known Attack
63944,30188,0,0,66,66,0,1,0,1,0,deny,0,1,Known Attack
55555,53,39560,53,188,96,92,2,31,1,1,allow,0,0,Normal
56835,35894,0,0,66,66,0,1,0,1,0,deny,0,1,Known Attack
55848,445,0,0,70,70,0,1,0,1,0,drop,0,1,Known Attack
50409,445,0,0,66,66,0,1,0,1,0,drop,0,1,Known Attack
65242,445,0,0,66,66,0,1,0,1,0,drop,0,1,Known Attack
18357,51180,0,0,62,62,0,1,0,1,0,deny,1,1,High Risk
55624,53,62232,53,244,94,150,2,29,1,1,allow,0,0,Normal
64095,53,40106,53,177,94,83,2,30,1,1,allow,0,0,Normal
58421,30188,0,0,66,66,0,1,0,1,0,deny,0,1,Known Attack
1658,443,1658,443,12030,1282,10748,23,17,9,14,allow,1,0,Potential Threat
58045,443,63795,443,3296,1329,1967,14,135,7,7,allow,1,0,Potential Threat
57933,445,0,0,66,66,0,1,0,1,0,drop,0,1,Known Attack
56781,17548,14113,17548,70,70,0,1,5,1,0,allow,1,0,Potential Threat
50820,80,16954,80,550,476,74,6,15,5,1,allow,0,0,Normal
37339,443,37972,443,130,70,60,3,5,2,1,allow,0,0,Normal
56647,443,45722,443,8059,2039,6020,20,15,11,9,allow,1,0,Potential Threat
22078,53,22078,53,229,98,131,2,30,1,1,allow,0,0,Normal
49789,445,0,0,70,70,0,1,0,1,0,drop,0,1,Known Attack
50939,443,29204,443,134,60,74,3,5,2,1,allow,0,0,Normal
12951,50584,0,0,66,66,0,1,0,1,0,deny,1,1,High Risk
64811,53,63660,53,446,93,353,4,55,2,2,allow,1,0,Potential Threat
53928,443,61918,443,499,425,74,4,0,3,1,allow,1,0,Potential Threat
62157,445,0,0,66,66,0,1,0,1,0,drop,0,1,Known Attack
65197,445,0,0,70,70,0,1,0,1,0,drop,0,1,Known Attack
56215,53,5017,53,216,110,106,2,30,1,1,allow,0,0,Normal
23844,26467,0,0,62,62,0,1,0,1,0,deny,0,1,Known Attack
65460,80,65460,80,48356,4069,44287,55,48,19,36,allow,1,0,Potential Threat
51605,443,55829,443,8095,3030,5065,27,95,14,13,allow,1,0,Potential Threat
53131,443,52675,443,33229,7810,25419,63,44,24,39,allow,1,0,Potential Threat
53615,867,16773,867,70,70,0,2,7,2,0,allow,0,0,Normal
54553,53,62342,53,202,202,0,3,46,3,0,allow,1,0,Potential Threat
49226,443,49226,443,118943,24432,94511,156,96,79,77,allow,1,0,Potential Threat
27005,27016,48371,27016,887,126,761,2,30,1,1,allow,1,0,Potential Threat
32768,22,0,0,60,60,0,1,0,1,0,deny,0,1,Known Attack
64567,53,64760,53,193,102,91,2,30,1,1,allow,1,0,Potential Threat
58638,5900,0,0,62,62,0,1,0,1,0,deny,0,1,Known Attack
52385,53,0,0,138,69,69,2,30,1,1,allow,0,0,Normal
60173,443,14780,443,7909,3501,4408,19,181,9,10,allow,1,0,Potential Threat
60021,445,0,0,70,70,0,1,0,1,0,drop,0,1,Known Attack
56600,445,0,0,66,66,0,1,0,1,0,drop,0,1,Known Attack
54013,445,0,0,66,66,0,1,0,1,0,drop,0,1,Known Attack
43225,443,17321,443,3831584,85342,3746242,3246,110,597,2649,allow,1,0,Potential Threat
49699,53,23875,53,202,103,99,2,31,1,1,allow,0,0,Normal
55875,53,42726,53,228,110,118,2,30,1,1,allow,0,0,Normal
34477,5900,34477,5900,60,60,0,1,5,1,0,allow,1,0,Potential Threat
51834,35440,0,0,66,66,0,1,0,1,0,deny,0,1,Known Attack
49440,445,0,0,66,66,0,1,0,1,0,drop,0,1,Known Attack
52981,445,0,0,66,66,0,1,0,1,0,drop,0,1,Known Attack
60501,40829,11084,40829,70,70,0,2,8,2,0,allow,1,0,Potential Threat
56061,445,0,0,66,66,0,1,0,1,0,drop,0,1,Known Attack
63079,443,63360,443,304,86,218,2,30,1,1,allow,1,0,Potential Threat
51826,58925,42484,58925,70,70,0,2,9,2,0,allow,1,0,Potential Threat
49291,53,21649,53,771,102,669,2,30,1,1,allow,0,0,Normal
41249,443,56931,443,2080,1126,954,17,150,10,7,allow,1,0,Potential Threat
48754,443,18594,443,6490,1145,5345,20,33,11,9,allow,1,0,Potential Threat
53987,16571,41017,16571,70,70,0,2,7,2,0,allow,1,0,Potential Threat
54683,445,0,0,70,70,0,1,0,1,0,drop,0,1,Known Attack
25600,23684,0,0,159,159,0,1,0,1,0,deny,1,1,High Risk
56214,53,47362,53,200,102,98,2,30,1,1,allow,0,0,Normal
52020,28704,61808,28704,70,70,0,1,5,1,0,allow,1,0,Potential Threat
19204,57866,0,0,66,66,0,1,0,1,0,deny,1,1,High Risk
53036,443,2888,443,3039,1089,1950,9,120,5,4,allow,1,0,Potential Threat
7749,36237,0,0,66,66,0,1,0,1,0,deny,1,1,High Risk
65127,53,38412,53,194,102,92,2,30,1,1,allow,0,0,Normal
52691,445,0,0,70,70,0,1,0,1,0,drop,0,1,Known Attack
56376,53,45759,53,196,100,96,2,30,1,1,allow,0,0,Normal
56596,53,10703,53,194,102,92,2,31,1,1,allow,0,0,Normal
56111,53,5335,53,179,94,85,2,30,1,1,allow,0,0,Normal
49654,445,0,0,70,70,0,1,0,1,0,drop,0,1,Known Attack
58638,5900,0,0,62,62,0,1,0,1,0,deny,0,1,Known Attack
56939,53,41325,53,216,110,106,2,31,1,1,allow,0,0,Normal
28825,23,0,0,60,60,0,1,0,1,0,deny,0,1,Known Attack
56260,53,19443,53,177,94,83,2,30,1,1,allow,0,0,Normal
52164,445,0,0,70,70,0,1,0,1,0,drop,0,1,Known Attack
48706,23393,0,0,60,60,0,1,0,1,0,deny,0,1,Known Attack
27005,27015,8670,27015,877,126,751,2,30,1,1,allow,1,0,Potential Threat
33822,57470,0,0,66,66,0,1,0,1,0,deny,1,1,High Risk
49771,53,28192,53,177,94,83,2,29,1,1,allow,0,0,Normal
2636,7302,0,0,66,66,0,1,0,1,0,deny,1,1,High Risk
52966,80,53251,80,2974,1352,1622,28,113,15,13,allow,1,0,Potential Threat
43916,21,0,0,60,60,0,1,0,1,0,deny,0,1,Known Attack
58969,445,0,0,70,70,0,1,0,1,0,drop,0,1,Known Attack
61384,445,0,0,70,70,0,1,0,1,0,drop,0,1,Known Attack
59005,443,56215,443,6306,1780,4526,28,33,14,14,allow,1,0,Potential Threat
57078,3389,57078,3389,3407,1518,1889,16,17,9,7,allow,1,0,Potential Threat
65218,53,49451,53,193,102,91,2,30,1,1,allow,0,0,Normal
57470,51413,18747,51413,604,275,329,4,1199,2,2,allow,1,0,Potential Threat
60564,445,0,0,66,66,0,1,0,1,0,drop,0,1,Known Attack
12285,61248,0,0,139,139,0,1,0,1,0,reset-both,1,1,High Risk
4257,35440,0,0,62,62,0,1,0,1,0,deny,1,1,High Risk
39118,443,29645,443,5229,2388,2841,23,367,12,11,allow,1,0,Potential Threat
49427,445,0,0,70,70,0,1,0,1,0,drop,0,1,Known Attack
58575,445,0,0,70,70,0,1,0,1,0,drop,0,1,Known Attack
50615,80,48256,80,190675,79205,111470,237,41,104,133,allow,1,0,Potential Threat
59944,445,0,0,66,66,0,1,0,1,0,drop,0,1,Known Attack
56624,53,20436,53,819,102,717,2,30,1,1,allow,0,0,Normal
61484,443,59400,443,9479,3507,5972,24,16,12,12,allow,1,0,Potential Threat
58424,52700,0,0,66,66,0,1,0,1,0,deny,0,1,Known Attack
993,4281,0,0,66,66,0,1,0,1,0,deny,1,1,High Risk
55076,53,43465,53,183,94,89,2,30,1,1,allow,0,0,Normal
49836,53,62893,53,168,78,90,2,30,1,1,allow,1,0,Potential Threat
37554,443,12881,443,13220,4632,8588,32,37,19,13,allow,1,0,Potential Threat
54827,445,0,0,70,70,0,1,0,1,0,drop,0,1,Known Attack
61766,44847,0,0,66,66,0,1,0,1,0,deny,0,1,Known Attack
54602,445,0,0,70,70,0,1,0,1,0,drop,0,1,Known Attack
60971,445,0,0,70,70,0,1,0,1,0,drop,0,1,Known Attack
58463,443,33811,443,19057,9308,9749,111,307,53,58,allow,1,0,Potential Threat
53064,445,0,0,66,66,0,1,0,1,0,drop,0,1,Known Attack
54817,445,0,0,66,66,0,1,0,1,0,drop,0,1,Known Attack
53226,80,34049,80,1054,602,452,10,20,5,5,allow,0,0,Normal
56307,53,64603,53,168,78,90,2,30,1,1,allow,1,0,Potential Threat
12531,22114,0,0,62,62,0,1,0,1,0,deny,0,1,Known Attack
49977,57470,0,0,62,62,0,1,0,1,0,deny,0,1,Known Attack
54526,44847,0,0,62,62,0,1,0,1,0,deny,0,1,Known Attack
64105,445,0,0,66,66,0,1,0,1,0,drop,0,1,Known Attack
51597,445,0,0,70,70,0,1,0,1,0,drop,0,1,Known Attack
62519,445,0,0,70,70,0,1,0,1,0,drop,0,1,Known Attack
64821,445,0,0,70,70,0,1,0,1,0,drop,0,1,Known Attack
58504,57470,0,0,62,62,0,1,0,1,0,deny,1,1,High Risk
57491,445,0,0,66,66,0,1,0,1,0,drop,0,1,Known Attack
10331,6881,0,0,146,146,0,1,0,1,0,deny,1,1,High Risk
36258,23,0,0,60,60,0,1,0,1,0,deny,0,1,Known Attack
34752,3389,34752,3389,3910,1805,2105,20,18,12,8,allow,1,0,Potential Threat
57732,445,0,0,70,70,0,1,0,1,0,drop,0,1,Known Attack
56681,53,26694,53,195,102,93,2,30,1,1,allow,0,0,Normal
59204,443,10417,443,9335,3052,6283,25,125,11,14,allow,1,0,Potential Threat
49324,53,24551,53,258,94,164,2,30,1,1,allow,0,0,Normal
50043,445,0,0,66,66,0,1,0,1,0,drop,0,1,Known Attack
50313,80,19871,80,3450,1386,2064,15,83,8,7,allow,1,0,Potential Threat
64401,53,5392,53,293,94,199,2,30,1,1,allow,0,0,Normal
40204,40031,12730,40031,245,182,63,2,30,1,1,allow,1,0,Potential Threat
50022,53,3051,53,179,94,85,2,30,1,1,allow,0,0,Normal
44847,6881,46281,6881,150,150,0,1,1200,1,0,allow,1,0,Potential Threat
49206,53,61280,53,174,89,85,2,31,1,1,allow,0,0,Normal
53822,25174,0,0,66,66,0,1,0,1,0,deny,0,1,Known Attack
58758,443,49380,443,4889,1079,3810,15,25,8,7,allow,1,0,Potential Threat
63725,80,55530,80,374,192,182,7,15,4,3,allow,1,0,Potential Threat
16370,56205,0,0,62,62,0,1,0,1,0,deny,1,1,High Risk
49746,53,23888,53,177,94,83,2,30,1,1,allow,0,0,Normal
63030,2222,0,0,66,66,0,1,0,1,0,deny,0,1,Known Attack
60263,445,0,0,70,70,0,1,0,1,0,drop,0,1,Known Attack
59271,445,0,0,70,70,0,1,0,1,0,drop,0,1,Known Attack
50116,22,50116,22,60,60,0,1,5,1,0,allow,0,0,Normal
64031,25933,32039,25933,436,254,182,7,14,4,3,allow,1,0,Potential Threat
45317,53,22055,53,86,86,0,1,30,1,0,allow,0,0,Normal
57149,53,45353,53,222,86,136,2,30,1,1,allow,0,0,Normal
57174,53,49148,53,210,94,116,2,30,1,1,allow,0,0,Normal
2440,37807,0,0,66,66,0,1,0,1,0,deny,1,1,High Risk
60165,80,45319,80,1982,692,1290,8,15,5,3,allow,1,0,Potential Threat
30598,46824,0,0,62,62,0,1,0,1,0,deny,0,1,Known Attack
49628,53,54412,53,168,86,82,2,30,1,1,allow,0,0,Normal
50490,80,51282,80,318,192,126,6,25,4,2,allow,0,0,Normal
49406,80,42946,80,2074,1309,765,10,124,6,4,allow,1,0,Potential Threat
1933,53,18812,53,210,78,132,2,29,1,1,allow,1,0,Potential Threat
47500,443,47942,443,7464,2375,5089,15,120,7,8,allow,1,0,Potential Threat
58007,62413,0,0,62,62,0,1,0,1,0,deny,1,1,High Risk
58273,53,40385,53,202,86,116,2,30,1,1,allow,0,0,Normal
57536,53,46039,53,199,94,105,2,30,1,1,allow,0,0,Normal
55697,445,0,0,70,70,0,1,0,1,0,drop,0,1,Known Attack
52247,49278,31090,49278,316,136,180,6,6,3,3,allow,1,0,Potential Threat
5774,37965,0,0,66,66,0,1,0,1,0,deny,1,1,High Risk
22346,51505,0,0,62,62,0,1,0,1,0,deny,1,1,High Risk
18091,32480,0,0,66,66,0,1,0,1,0,deny,1,1,High Risk
55128,445,0,0,70,70,0,1,0,1,0,drop,0,1,Known Attack
60786,51505,0,0,66,66,0,1,0,1,0,deny,0,1,Known Attack
18204,55160,0,0,146,146,0,1,0,1,0,deny,1,1,High Risk
49167,53,55211,53,258,94,164,2,30,1,1,allow,0,0,Normal
60982,445,0,0,66,66,0,1,0,1,0,drop,0,1,Known Attack
50169,25174,0,0,62,62,0,1,0,1,0,deny,0,1,Known Attack
41538,443,31150,443,8090,2462,5628,22,21,12,10,allow,1,0,Potential Threat
59328,80,59328,80,24437,12718,11719,41,15,16,25,allow,1,0,Potential Threat
50303,445,0,0,66,66,0,1,0,1,0,drop,0,1,Known Attack
5685,35440,0,0,66,66,0,1,0,1,0,deny,1,1,High Risk
51652,80,59640,80,454,262,192,8,37,5,3,allow,0,0,Normal
40202,5222,32011,5222,5958,2420,3538,40,25,20,20,allow,1,0,Potential Threat
51788,35787,52462,35787,70,70,0,2,8,2,0,allow,1,0,Potential Threat
50988,80,43692,80,5956,1595,4361,17,19,10,7,allow,1,0,Potential Threat
59423,445,0,0,70,70,0,1,0,1,0,drop,0,1,Known Attack
51946,443,39002,443,8670,1805,6865,28,26,15,13,allow,1,0,Potential Threat
52435,53,3973,53,216,78,138,2,29,1,1,allow,0,0,Normal
64982,53,7315,53,195,102,93,2,30,1,1,allow,0,0,Normal
50513,80,33823,80,318,192,126,6,25,4,2,allow,0,0,Normal
10060,443,49510,443,293424,16379,277045,410,93,193,217,allow,1,0,Potential Threat
51551,445,0,0,70,70,0,1,0,1,0,drop,0,1,Known Attack
55010,445,0,0,70,70,0,1,0,1,0,drop,0,1,Known Attack
61460,80,11498,80,1507,1184,323,11,79,7,4,allow,1,0,Potential Threat
53964,445,0,0,70,70,0,1,0,1,0,drop,0,1,Known Attack
50089,445,0,0,70,70,0,1,0,1,0,drop,0,1,Known Attack
56896,80,32594,80,2684,2550,134,7,16,5,2,allow,0,0,Normal
54540,443,17427,443,6680,3784,2896,18,135,9,9,allow,1,0,Potential Threat
53705,443,11151,443,499,425,74,4,0,3,1,allow,0,0,Normal
52838,37965,0,0,66,66,0,1,0,1,0,deny,0,1,Known Attack
52718,445,0,0,70,70,0,1,0,1,0,drop,0,1,Known Attack
51623,445,0,0,70,70,0,1,0,1,0,drop,0,1,Known Attack
37827,443,64403,443,424,210,214,7,131,4,3,allow,1,0,Potential Threat
993,11946,0,0,66,66,0,1,0,1,0,deny,1,1,High Risk
58900,37807,0,0,66,66,0,1,0,1,0,deny,0,1,Known Attack
55107,53,32486,53,193,102,91,2,30,1,1,allow,0,0,Normal
57470,29633,40389,29633,1660,677,983,20,1595,10,10,allow,1,0,Potential Threat
53452,443,10617,443,15368,8643,6725,36,49,19,17,allow,1,0,Potential Threat
53373,445,0,0,70,70,0,1,0,1,0,drop,0,1,Known Attack
33043,443,36029,443,1788,968,820,20,15,11,9,allow,1,0,Potential Threat
46556,443,5923,443,9316,1720,7596,25,16,13,12,allow,1,0,Potential Threat
33405,37965,0,0,62,62,0,1,0,1,0,deny,0,1,Known Attack
64257,53,61085,53,211,78,133,2,30,1,1,allow,0,0,Normal
49646,53,51164,53,353,118,235,2,30,1,1,allow,0,0,Normal
64322,53,46298,53,273,90,183,4,32,2,2,allow,0,0,Normal
61195,56205,0,0,66,66,0,1,0,1,0,deny,1,1,High Risk
26758,443,6342,443,20851,15854,4997,36,20,20,16,allow,1,0,Potential Threat
56567,53,47104,53,701,88,613,2,30,1,1,allow,0,0,Normal
56947,53,11234,53,239,102,137,2,30,1,1,allow,0,0,Normal
65218,53,51807,53,186,95,91,2,30,1,1,allow,0,0,Normal
50280,53,20623,53,916,86,830,2,31,1,1,allow,0,0,Normal
64605,53,20190,53,183,94,89,2,31,1,1,allow,0,0,Normal
63663,445,0,0,70,70,0,1,0,1,0,drop,0,1,Known Attack
49661,443,16392,443,9021,2548,6473,38,80,19,19,allow,1,0,Potential Threat
55199,53,62103,53,196,94,102,2,30,1,1,allow,0,0,Normal
57300,443,65390,443,8979,3093,5886,43,15,24,19,allow,1,0,Potential Threat
57282,53,4028,53,199,102,97,2,29,1,1,allow,0,0,Normal
58973,445,0,0,70,70,0,1,0,1,0,drop,0,1,Known Attack
57557,445,0,0,70,70,0,1,0,1,0,drop,0,1,Known Attack
65479,53,45836,53,728,102,626,2,29,1,1,allow,0,0,Normal
64735,445,0,0,70,70,0,1,0,1,0,drop,0,1,Known Attack
55000,53,36007,53,193,102,91,2,31,1,1,allow,0,0,Normal
57343,53,10133,53,214,86,128,2,29,1,1,allow,0,0,Normal
51464,443,62248,443,7269,1978,5291,28,39,14,14,allow,1,0,Potential Threat
52492,37965,0,0,66,66,0,1,0,1,0,deny,0,1,Known Attack
65133,53,55111,53,198,102,96,2,30,1,1,allow,0,0,Normal
62920,445,0,0,70,70,0,1,0,1,0,drop,0,1,Known Attack
49309,443,31644,443,4250,2969,1281,23,47,12,11,allow,1,0,Potential Threat
49343,53,21551,53,209,110,99,2,30,1,1,allow,0,0,Normal
60984,445,0,0,70,70,0,1,0,1,0,drop,0,1,Known Attack
56115,445,0,0,70,70,0,1,0,1,0,drop,0,1,Known Attack
38698,443,50432,443,90261,3545,86716,96,16,32,64,allow,1,0,Potential Threat
49257,53,6745,53,199,102,97,2,30,1,1,allow,0,0,Normal
50151,445,0,0,66,66,0,1,0,1,0,drop,0,1,Known Attack
63963,50584,0,0,66,66,0,1,0,1,0,deny,1,1,High Risk
65316,445,0,0,70,70,0,1,0,1,0,drop,0,1,Known Attack
56272,53,13597,53,193,102,91,2,31,1,1,allow,0,0,Normal
61319,445,0,0,66,66,0,1,0,1,0,drop,0,1,Known Attack
52459,5555,0,0,60,60,0,1,0,1,0,deny,0,1,Known Attack
27005,32056,3703,32056,886,126,760,2,30,1,1,allow,1,0,Potential Threat
56102,53,33083,53,199,94,105,2,30,1,1,allow,0,0,Normal
59486,80,62432,80,2633,1151,1482,10,32,6,4,allow,1,0,Potential Threat
62233,443,62233,443,41941,3388,38553,67,77,26,41,allow,1,0,Potential Threat
51539,443,19176,443,262,70,192,5,21,2,3,allow,0,0,Normal
49857,443,36785,443,4221,1038,3183,19,59,11,8,allow,1,0,Potential Threat
58638,5900,0,0,62,62,0,1,0,1,0,deny,0,1,Known Attack
49162,53,41472,53,183,94,89,2,30,1,1,allow,0,0,Normal
52252,46314,0,0,62,62,0,1,0,1,0,deny,0,1,Known Attack
59879,55783,0,0,62,62,0,1,0,1,0,deny,1,1,High Risk
49165,53,19244,53,379,94,285,2,30,1,1,allow,0,0,Normal
49609,53,22044,53,170,87,83,2,30,1,1,allow,0,0,Normal
63873,61002,7411,61002,5431,3164,2267,32,76,18,14,allow,1,0,Potential Threat
65093,445,0,0,66,66,0,1,0,1,0,drop,0,1,Known Attack
62692,443,51155,443,14518,2409,12109,23,135,10,13,allow,1,0,Potential Threat
49419,443,41592,443,318,192,126,6,15,4,2,allow,0,0,Normal
42238,25174,0,0,62,62,0,1,0,1,0,deny,0,1,Known Attack
8211,28793,0,0,66,66,0,1,0,1,0,deny,1,1,High Risk
49981,44847,0,0,62,62,0,1,0,1,0,deny,0,1,Known Attack
46592,53,27919,53,168,78,90,2,30,1,1,allow,0,0,Normal
55143,445,0,0,66,66,0,1,0,1,0,drop,0,1,Known Attack
49485,80,52074,80,1155,781,374,10,15,6,4,allow,1,0,Potential Threat
40671,443,5840,443,190,70,120,4,15,2,2,allow,0,0,Normal
50265,57121,42011,57121,132,132,0,3,1200,3,0,allow,1,0,Potential Threat
61444,445,0,0,70,70,0,1,0,1,0,drop,0,1,Known Attack
51506,443,52823,443,584947,21842,563105,678,36,286,392,allow,1,0,Potential Threat
51221,1338,12971,1338,132,132,0,3,1200,3,0,allow,1,0,Potential Threat
53976,52534,6002,52534,70,70,0,1,5,1,0,allow,1,0,Potential Threat
57470,46941,64707,46941,899,288,611,4,1199,2,2,allow,1,0,Potential Threat
19858,64147,0,0,62,62,0,1,0,1,0,deny,1,1,High Risk
49165,53,17672,53,212,102,110,2,29,1,1,allow,0,0,Normal
54443,445,0,0,70,70,0,1,0,1,0,drop,0,1,Known Attack
63173,36237,0,0,62,62,0,1,0,1,0,deny,0,1,Known Attack
61996,445,0,0,70,70,0,1,0,1,0,drop,0,1,Known Attack
50236,25174,0,0,66,66,0,1,0,1,0,deny,0,1,Known Attack
56928,53,57142,53,178,94,84,2,30,1,1,allow,0,0,Normal
2938,64147,0,0,62,62,0,1,0,1,0,deny,1,1,High Risk
58245,445,0,0,70,70,0,1,0,1,0,drop,0,1,Known Attack
53806,445,0,0,66,66,0,1,0,1,0,drop,0,1,Known Attack
59749,445,0,0,70,70,0,1,0,1,0,drop,0,1,Known Attack
49743,445,0,0,66,66,0,1,0,1,0,drop,0,1,Known Attack
54654,6881,17557,6881,470,348,122,6,26,4,2,allow,1,0,Potential Threat
40236,443,44776,443,4945,1401,3544,21,25,11,10,allow,1,0,Potential Threat
64879,53,23535,53,173,94,79,2,30,1,1,allow,0,0,Normal
51928,443,37238,443,18581,9681,8900,62,103,33,29,allow,1,0,Potential Threat
51217,443,21771,443,126,60,66,3,5,2,1,allow,0,0,Normal
55808,53,26919,53,179,94,85,2,30,1,1,allow,0,0,Normal
56579,53,34186,53,711,87,624,2,30,1,1,allow,0,0,Normal
55709,30217,48170,30217,70,70,0,1,5,1,0,allow,1,0,Potential Threat
57271,53,58158,53,288,94,194,2,30,1,1,allow,0,0,Normal
53772,443,49684,443,499,425,74,4,0,3,1,allow,0,0,Normal
58562,57587,0,0,66,66,0,1,0,1,0,deny,1,1,High Risk
56695,53,57441,53,776,102,674,2,30,1,1,allow,0,0,Normal
62465,445,0,0,70,70,0,1,0,1,0,drop,0,1,Known Attack
56206,445,0,0,70,70,0,1,0,1,0,drop,0,1,Known Attack
65289,53,55084,53,174,89,85,2,31,1,1,allow,0,0,Normal
20388,53,20388,53,217,90,127,2,30,1,1,allow,0,0,Normal
55797,53,36305,53,177,94,83,2,31,1,1,allow,0,0,Normal
50204,445,0,0,70,70,0,1,0,1,0,drop,0,1,Known Attack
59475,445,0,0,66,66,0,1,0,1,0,drop,0,1,Known Attack
47376,443,12829,443,2944,778,2166,10,120,5,5,allow,1,0,Potential Threat
56589,53,29325,53,198,101,97,2,31,1,1,allow,0,0,Normal
65178,53,0,0,190,85,105,2,30,1,1,allow,0,0,Normal
57365,53,10039,53,780,104,676,2,31,1,1,allow,0,0,Normal
62911,36237,0,0,66,66,0,1,0,1,0,deny,0,1,Known Attack
61495,37965,0,0,66,66,0,1,0,1,0,deny,0,1,Known Attack
55603,443,55603,443,4684,1777,2907,19,12,11,8,allow,1,0,Potential Threat
61033,445,0,0,70,70,0,1,0,1,0,drop,0,1,Known Attack
57631,443,50238,443,16277,3466,12811,46,1801,22,24,allow,1,0,Potential Threat
56252,445,0,0,66,66,0,1,0,1,0,drop,0,1,Known Attack
17640,55442,0,0,66,66,0,1,0,1,0,deny,1,1,High Risk
56944,35894,0,0,62,62,0,1,0,1,0,deny,0,1,Known Attack
54756,445,0,0,70,70,0,1,0,1,0,deny,0,1,Known Attack
58046,80,28676,80,2306,1112,1194,23,76,12,11,allow,1,0,Potential Threat
56742,445,0,0,70,70,0,1,0,1,0,drop,0,1,Known Attack
57295,443,4265,443,5614,733,4881,16,15,9,7,allow,1,0,Potential Threat
60764,445,0,0,66,66,0,1,0,1,0,drop,0,1,Known Attack
50919,445,0,0,66,66,0,1,0,1,0,drop,0,1,Known Attack
20168,81,0,0,60,60,0,1,0,1,0,deny,0,1,Known Attack
65348,53,57406,53,214,102,112,2,31,1,1,allow,0,0,Normal
2717,31573,0,0,62,62,0,1,0,1,0,deny,1,1,High Risk
23843,26467,0,0,62,62,0,1,0,1,0,deny,0,1,Known Attack
53641,16605,38186,16605,70,70,0,2,7,2,0,allow,1,0,Potential Threat
61833,443,61833,443,80743,4724,76019,101,89,37,64,allow,1,0,Potential Threat
65256,53,14067,53,213,102,111,2,30,1,1,allow,0,0,Normal
65462,53,20337,53,196,102,94,2,33,1,1,allow,0,0,Normal
5588,5588,0,0,3562,1936,1626,48,194,24,24,allow,1,0,Potential Threat
56955,53,20294,53,184,86,98,2,29,1,1,allow,0,0,Normal
52467,443,14984,443,5343,1102,4241,22,152,11,11,allow,1,0,Potential Threat
58638,5900,0,0,62,62,0,1,0,1,0,deny,0,1,Known Attack
51172,44847,0,0,66,66,0,1,0,1,0,deny,0,1,Known Attack
56747,53,24392,53,172,94,78,2,30,1,1,allow,0,0,Normal
59830,443,56581,443,82533,15815,66718,124,131,50,74,allow,1,0,Potential Threat
61078,123,41282,123,184,94,90,2,30,1,1,allow,0,0,Normal
50634,80,58631,80,25670,13514,12156,46,36,21,25,allow,1,0,Potential Threat
57890,443,58945,443,3588,1991,1597,27,176,14,13,allow,1,0,Potential Threat
60472,20273,1767,20273,70,70,0,2,8,2,0,allow,1,0,Potential Threat
49605,53,30084,53,756,95,661,2,30,1,1,allow,0,0,Normal
57167,53,27604,53,195,102,93,2,30,1,1,allow,0,0,Normal
37936,443,26226,443,5463,1378,4085,16,145,10,6,allow,1,0,Potential Threat
52039,80,39126,80,366,240,126,7,25,5,2,allow,0,0,Normal
27005,28002,27297,28002,918,126,792,2,31,1,1,allow,1,0,Potential Threat
57698,64147,0,0,62,62,0,1,0,1,0,deny,1,1,High Risk
50052,65008,0,0,60,60,0,1,0,1,0,deny,1,1,High Risk
443,52504,0,0,97,97,0,1,0,1,0,deny,1,1,High Risk
58638,5900,0,0,62,62,0,1,0,1,0,deny,0,1,Known Attack
8411,8411,36899,8411,66,66,0,1,30,1,0,allow,1,0,Potential Threat
26900,27017,38373,27017,422,164,258,6,30,3,3,allow,1,0,Potential Threat
53166,61600,0,0,62,62,0,1,0,1,0,deny,1,1,High Risk
63843,445,0,0,66,66,0,1,0,1,0,drop,0,1,Known Attack
64739,53,37126,53,193,102,91,2,30,1,1,allow,0,0,Normal
27005,27015,65142,27015,883,126,757,2,30,1,1,allow,1,0,Potential Threat
55050,443,4346,443,7372,2875,4497,23,61,13,10,allow,1,0,Potential Threat
64393,445,0,0,66,66,0,1,0,1,0,drop,0,1,Known Attack
35058,23,0,0,60,60,0,1,0,1,0,deny,0,1,Known Attack
55178,80,55178,80,374,240,134,7,15,5,2,allow,0,0,Normal
61343,443,57856,443,1784740,34746,1749994,1769,331,357,1412,allow,1,0,Potential Threat
49218,5222,44351,5222,85080,31769,53311,661,1172,305,356,allow,1,0,Potential Threat
37580,443,41939,443,24810,10597,14213,51,123,22,29,allow,1,0,Potential Threat
49882,445,0,0,70,70,0,1,0,1,0,drop,0,1,Known Attack
57176,443,31036,443,12844,2619,10225,23,120,10,13,allow,1,0,Potential Threat
50919,443,47767,443,6412,1370,5042,19,129,9,10,allow,1,0,Potential Threat
9323,443,4707,443,26959,1764,25195,42,48,18,24,allow,1,0,Potential Threat
57473,23,0,0,60,60,0,1,0,1,0,deny,0,1,Known Attack
23553,37965,0,0,62,62,0,1,0,1,0,deny,0,1,Known Attack
52264,445,0,0,70,70,0,1,0,1,0,drop,0,1,Known Attack
63313,445,0,0,70,70,0,1,0,1,0,drop,0,1,Known Attack
25973,26467,0,0,66,66,0,1,0,1,0,deny,0,1,Known Attack
41690,443,19019,443,1478937,62961,1415976,1678,148,649,1029,allow,1,0,Potential Threat
65344,53,52002,53,190,90,100,3,60,2,1,allow,0,0,Normal
55727,53,61818,53,177,94,83,2,30,1,1,allow,0,0,Normal
56866,53,52471,53,194,102,92,2,30,1,1,allow,0,0,Normal
53625,64147,0,0,62,62,0,1,0,1,0,deny,1,1,High Risk
57394,53,17167,53,193,102,91,2,31,1,1,allow,0,0,Normal
64569,53,45660,53,183,94,89,2,30,1,1,allow,0,0,Normal
42963,443,15595,443,7681,4711,2970,36,28,17,19,allow,1,0,Potential Threat
64789,53,51641,53,199,102,97,2,30,1,1,allow,0,0,Normal
50473,123,38470,123,184,94,90,2,30,1,1,allow,0,0,Normal
52110,35411,42303,35411,70,70,0,2,8,2,0,allow,1,0,Potential Threat
20962,22114,0,0,62,62,0,1,0,1,0,deny,0,1,Known Attack
49631,53,0,0,82,82,0,1,30,1,0,allow,0,0,Normal
48305,443,59833,443,572565,17274,555291,546,147,124,422,allow,1,0,Potential Threat
27110,22114,0,0,62,62,0,1,0,1,0,deny,0,1,Known Attack
48886,443,65287,443,8468,2867,5601,23,144,10,13,allow,1,0,Potential Threat
63615,445,0,0,70,70,0,1,0,1,0,drop,0,1,Known Attack
64929,53,8681,53,168,86,82,2,31,1,1,allow,0,0,Normal
36924,53,36924,53,257,106,151,2,30,1,1,allow,0,0,Normal
59100,445,0,0,70,70,0,1,0,1,0,drop,0,1,Known Attack
62079,30188,0,0,62,62,0,1,0,1,0,deny,0,1,Known Attack
55545,53,1793,53,821,102,719,2,30,1,1,allow,0,0,Normal
50687,443,7518,443,1199,618,581,13,29,6,7,allow,1,0,Potential Threat
33595,23,0,0,60,60,0,1,0,1,0,deny,0,1,Known Attack
65268,53,12409,53,395,107,288,4,46,2,2,allow,0,0,Normal
65383,443,27965,443,839325,38439,800886,1027,94,451,576,allow,1,0,Potential Threat
36816,1812,36816,1812,204,138,66,2,29,1,1,allow,1,0,Potential Threat
443,20087,0,0,83,83,0,1,0,1,0,deny,1,1,High Risk
49821,445,0,0,70,70,0,1,0,1,0,drop,0,1,Known Attack
64519,53,52190,53,184,94,90,2,30,1,1,allow,0,0,Normal
65405,53,50341,53,560,104,456,4,43,2,2,allow,0,0,Normal
64585,53,55669,53,210,110,100,2,30,1,1,allow,0,0,Normal
58638,5900,0,0,62,62,0,1,0,1,0,deny,0,1,Known Attack
33245,443,3684,443,7279,2884,4395,28,16,16,12,allow,1,0,Potential Threat
43677,443,54935,443,30090,19982,10108,77,543,41,36,allow,1,0,Potential Threat
56433,53,56287,53,177,94,83,2,30,1,1,allow,0,0,Normal
50208,1688,32119,1688,70,70,0,2,8,2,0,allow,0,0,Normal
57265,53,15033,53,200,102,98,2,30,1,1,allow,0,0,Normal
33809,80,12746,80,1052,612,440,10,15,5,5,allow,1,0,Potential Threat
5859,11392,0,0,66,66,0,1,0,1,0,deny,1,1,High Risk
56872,21247,0,0,74,74,0,1,0,1,0,deny,0,1,Known Attack
53469,44847,0,0,66,66,0,1,0,1,0,deny,0,1,Known Attack
59049,53,37929,53,199,94,105,2,30,1,1,allow,0,0,Normal
6703,21247,0,0,62,62,0,1,0,1,0,deny,1,1,High Risk
37455,50584,0,0,62,62,0,1,0,1,0,deny,0,1,Known Attack
51589,445,0,0,70,70,0,1,0,1,0,drop,0,1,Known Attack
62654,35440,0,0,62,62,0,1,0,1,0,deny,0,1,Known Attack
60375,445,0,0,66,66,0,1,0,1,0,drop,0,1,Known Attack
53952,26973,7961,26973,70,70,0,1,4,1,0,allow,1,0,Potential Threat
50471,53,24459,53,168,78,90,2,30,1,1,allow,0,0,Normal
51104,445,0,0,66,66,0,1,0,1,0,drop,0,1,Known Attack
52667,80,52667,80,2011,1422,589,12,48,6,6,allow,0,0,Normal
62586,445,0,0,66,66,0,1,0,1,0,drop,0,1,Known Attack
49281,53,63913,53,251,102,149,2,30,1,1,allow,1,0,Potential Threat
52107,11191,10065,11191,70,70,0,1,4,1,0,allow,1,0,Potential Threat
12878,25174,0,0,146,146,0,1,0,1,0,deny,1,1,High Risk
49746,53,11363,53,236,94,142,2,29,1,1,allow,0,0,Normal
54034,443,22227,443,43491,8521,34970,69,50,34,35,allow,1,0,Potential Threat
25197,1433,0,0,60,60,0,1,0,1,0,deny,0,1,Known Attack
26795,443,14434,443,21804,16558,5246,43,21,24,19,allow,1,0,Potential Threat
55808,53,45901,53,738,86,652,2,31,1,1,allow,0,0,Normal
56433,53,3210,53,177,94,83,2,30,1,1,allow,0,0,Normal
44847,51413,1303,51413,475,150,325,2,1200,1,1,allow,1,0,Potential Threat
58638,5900,0,0,62,62,0,1,0,1,0,deny,0,1,Known Attack
65053,53,65053,53,235,90,145,2,31,1,1,allow,1,0,Potential Threat
49935,53,45170,53,168,86,82,2,30,1,1,allow,0,0,Normal
49351,445,0,0,70,70,0,1,0,1,0,drop,0,1,Known Attack
9468,80,22561,80,1835,421,1414,9,15,4,5,allow,1,0,Potential Threat
49624,53,59918,53,293,126,167,2,30,1,1,allow,0,0,Normal
59734,445,0,0,66,66,0,1,0,1,0,drop,0,1,Known Attack
54320,27016,28839,27016,924,924,0,3,30,3,0,allow,1,0,Potential Threat
27321,25174,0,0,146,146,0,1,0,1,0,deny,1,1,High Risk
51880,18468,1087,18468,70,70,0,2,8,2,0,allow,1,0,Potential Threat
64266,445,0,0,70,70,0,1,0,1,0,drop,0,1,Known Attack
65040,53,62726,53,176,90,86,2,31,1,1,allow,1,0,Potential Threat
39396,443,4891,443,7531,2720,4811,24,331,13,11,allow,1,0,Potential Threat
63453,445,0,0,70,70,0,1,0,1,0,drop,0,1,Known Attack
57242,53,53275,53,184,86,98,2,29,1,1,allow,0,0,Normal
55450,64147,0,0,66,66,0,1,0,1,0,deny,1,1,High Risk
49308,22114,0,0,62,62,0,1,0,1,0,deny,0,1,Known Attack
46980,443,8668,443,7633,5620,2013,31,60,19,12,allow,1,0,Potential Threat
57934,445,0,0,66,66,0,1,0,1,0,drop,0,1,Known Attack
59947,445,0,0,66,66,0,1,0,1,0,drop,0,1,Known Attack
34335,23,0,0,60,60,0,1,0,1,0,deny,0,1,Known Attack
55687,47613,14281,47613,164,70,94,2,5,1,1,allow,1,0,Potential Threat
57987,56125,0,0,90,90,0,1,0,1,0,deny,1,1,High Risk
57790,443,14547,443,6321,3341,2980,19,135,9,10,allow,1,0,Potential Threat
65219,53,52496,53,197,102,95,2,31,1,1,allow,0,0,Normal
64543,50265,0,0,66,66,0,1,0,1,0,deny,1,1,High Risk
53300,37807,0,0,66,66,0,1,0,1,0,deny,0,1,Known Attack
60129,55442,0,0,62,62,0,1,0,1,0,deny,1,1,High Risk
50704,80,8069,80,499,192,307,6,26,4,2,allow,0,0,Normal
55647,53,13562,53,168,86,82,2,31,1,1,allow,0,0,Normal
49125,53,10970,53,168,78,90,2,30,1,1,allow,0,0,Normal
63108,443,56013,443,4609,2177,2432,11,120,6,5,allow,1,0,Potential Threat
55315,53,41500,53,192,98,94,2,31,1,1,allow,0,0,Normal
60409,44739,64818,44739,70,70,0,1,5,1,0,allow,1,0,Potential Threat
1038,37965,0,0,62,62,0,1,0,1,0,deny,1,1,High Risk
49441,443,28685,443,2921276,89544,2831732,3090,63,1086,2004,allow,1,0,Potential Threat
50494,80,52508,80,18059,13615,4444,29,27,16,13,allow,1,0,Potential Threat
49637,53,0,0,86,86,0,1,30,1,0,allow,0,0,Normal
63927,50265,0,0,62,62,0,1,0,1,0,deny,1,1,High Risk
49466,53,24088,53,209,110,99,2,30,1,1,allow,0,0,Normal
59790,44847,0,0,66,66,0,1,0,1,0,deny,0,1,Known Attack
22683,39210,0,0,60,60,0,1,0,1,0,deny,1,1,High Risk
55083,53,43737,53,751,95,656,2,30,1,1,allow,0,0,Normal
65439,53,5065,53,198,94,104,2,30,1,1,allow,0,0,Normal
51324,11392,0,0,66,66,0,1,0,1,0,deny,0,1,Known Attack
52076,28895,29171,28895,66,66,0,1,5,1,0,allow,1,0,Potential Threat
65366,53,65366,53,244,98,146,2,33,1,1,allow,1,0,Potential Threat
55579,53,62219,53,178,94,84,2,30,1,1,allow,0,0,Normal
55070,445,0,0,70,70,0,1,0,1,0,drop,0,1,Known Attack
59409,443,2486,443,7775,3174,4601,25,16,11,14,allow,1,0,Potential Threat
42867,443,28433,443,15769,1619,14150,17,137,4,13,allow,1,0,Potential Threat
54990,80,38273,80,9054746,285623,8769123,10474,214,4673,5801,allow,1,0,Potential Threat
58638,5900,0,0,62,62,0,1,0,1,0,deny,0,1,Known Attack
55379,53,3403,53,358,102,256,2,30,1,1,allow,0,0,Normal
64017,53,64345,53,325,103,222,4,45,2,2,allow,1,0,Potential Threat
65516,443,35348,443,451899,13130,438769,463,16,162,301,allow,1,0,Potential Threat
53500,1,0,0,66,66,0,1,0,1,0,deny,0,1,Known Attack
58638,5900,0,0,62,62,0,1,0,1,0,deny,0,1,Known Attack
65430,80,47649,80,306,180,126,6,29,4,2,allow,0,0,Normal
64065,445,0,0,70,70,0,1,0,1,0,drop,0,1,Known Attack
65483,53,14095,53,701,88,613,2,31,1,1,allow,0,0,Normal
52587,443,5455,443,6170,918,5252,18,15,10,8,allow,1,0,Potential Threat
46529,80,23858,80,1119,388,731,9,223,5,4,allow,1,0,Potential Threat
60561,53,50880,53,343,86,257,2,30,1,1,allow,0,0,Normal
9480,443,14084,443,6100,777,5323,17,25,9,8,allow,1,0,Potential Threat
59355,51505,0,0,66,66,0,1,0,1,0,deny,0,1,Known Attack
49370,11392,0,0,66,66,0,1,0,1,0,deny,0,1,Known Attack
50387,8080,50387,8080,7241,3224,4017,23,61,14,9,allow,1,0,Potential Threat
28234,36653,45143,36653,64,64,0,1,10,1,0,allow,1,0,Potential Threat
56769,53,51571,53,183,94,89,2,31,1,1,allow,0,0,Normal
56278,52752,0,0,62,62,0,1,0,1,0,deny,0,1,Known Attack
50968,80,19228,80,109660,1992,107668,99,35,20,79,allow,1,0,Potential Threat
41744,37965,0,0,62,62,0,1,0,1,0,deny,0,1,Known Attack
16319,44847,0,0,146,146,0,1,0,1,0,deny,1,1,High Risk
56367,53,52598,53,188,96,92,2,31,1,1,allow,0,0,Normal
62178,445,0,0,70,70,0,1,0,1,0,drop,0,1,Known Attack
58359,64147,0,0,72,72,0,1,0,1,0,deny,1,1,High Risk
50720,443,25123,443,6336,1377,4959,19,169,9,10,allow,1,0,Potential Threat
53505,445,0,0,70,70,0,1,0,1,0,drop,0,1,Known Attack
49456,445,0,0,66,66,0,1,0,1,0,drop,0,1,Known Attack
53023,443,2353,443,9625,3512,6113,41,92,21,20,allow,1,0,Potential Threat
39888,53,65133,53,168,78,90,2,30,1,1,allow,1,0,Potential Threat
19634,64147,0,0,62,62,0,1,0,1,0,deny,1,1,High Risk
56842,24233,12414,24233,70,70,0,2,8,2,0,allow,1,0,Potential Threat
53128,443,20598,443,14603,4208,10395,39,48,20,19,allow,1,0,Potential Threat
55058,443,16741,443,12435,4022,8413,27,62,15,12,allow,1,0,Potential Threat
59874,443,18993,443,1066,545,521,11,28,5,6,allow,1,0,Potential Threat
49912,80,32939,80,1590,858,732,10,110,6,4,allow,0,0,Normal
55165,53,33843,53,186,95,91,2,31,1,1,allow,0,0,Normal
59920,443,55787,443,3063,1068,1995,12,134,6,6,allow,1,0,Potential Threat
64917,53,41071,53,194,94,100,2,30,1,1,allow,0,0,Normal
64929,53,59059,53,168,86,82,2,30,1,1,allow,0,0,Normal
50799,445,0,0,66,66,0,1,0,1,0,drop,0,1,Known Attack
50848,445,0,0,66,66,0,1,0,1,0,drop,0,1,Known Attack
60594,445,0,0,70,70,0,1,0,1,0,drop,0,1,Known Attack
49418,27015,49804,27015,248,78,170,2,30,1,1,allow,1,0,Potential Threat
55616,56205,0,0,66,66,0,1,0,1,0,deny,0,1,Known Attack
65060,35440,0,0,62,62,0,1,0,1,0,deny,1,1,High Risk
57162,443,26306,443,1798,1223,575,13,25,8,5,allow,1,0,Potential Threat
61078,57470,0,0,145,145,0,1,0,1,0,deny,1,1,High Risk
57345,445,0,0,70,70,0,1,0,1,0,drop,0,1,Known Attack
60948,53,22265,53,168,78,90,2,30,1,1,allow,0,0,Normal
9420,443,29951,443,9308,2125,7183,27,34,13,14,allow,1,0,Potential Threat
52257,445,0,0,70,70,0,1,0,1,0,drop,0,1,Known Attack
63463,53,56932,53,199,86,113,2,29,1,1,allow,0,0,Normal
52326,443,52326,443,5433,2251,3182,23,86,12,11,allow,1,0,Potential Threat
14869,44847,0,0,62,62,0,1,0,1,0,deny,1,1,High Risk
12668,42707,0,0,62,62,0,1,0,1,0,deny,1,1,High Risk
48223,5222,8848,5222,14939,1037,13902,35,579,11,24,allow,1,0,Potential Threat
42898,443,46834,443,4999,2845,2154,41,87,22,19,allow,1,0,Potential Threat
25857,57354,0,0,145,145,0,1,0,1,0,deny,1,1,High Risk
41628,15000,25474,15000,130,70,60,2,6,1,1,allow,1,0,Potential Threat
65514,445,0,0,70,70,0,1,0,1,0,drop,0,1,Known Attack
55828,443,52104,443,5278,1026,4252,20,15,11,9,allow,1,0,Potential Threat
65477,53,48091,53,183,94,89,2,30,1,1,allow,0,0,Normal
64001,53,52493,53,183,94,89,2,29,1,1,allow,0,0,Normal
60709,443,60709,443,1092,645,447,10,34,6,4,allow,1,0,Potential Threat
9264,80,28949,80,318,192,126,6,26,4,2,allow,1,0,Potential Threat
50806,445,0,0,70,70,0,1,0,1,0,drop,0,1,Known Attack
49917,53,29420,53,209,110,99,2,29,1,1,allow,0,0,Normal
56629,80,58427,80,234,234,0,4,12,4,0,allow,0,0,Normal
64265,53,25534,53,550,133,417,4,47,2,2,allow,0,0,Normal
58436,443,57353,443,18290,3012,15278,46,136,24,22,allow,1,0,Potential Threat
65079,445,0,0,70,70,0,1,0,1,0,drop,0,1,Known Attack
58253,25174,0,0,146,146,0,1,0,1,0,deny,1,1,High Risk
46159,443,12485,443,124567,6787,117780,175,263,82,93,allow,1,0,Potential Threat
58638,5900,0,0,62,62,0,1,0,1,0,deny,0,1,Known Attack
49339,445,0,0,70,70,0,1,0,1,0,drop,0,1,Known Attack
58673,443,8091,443,3330,737,2593,10,121,5,5,allow,1,0,Potential Threat
37965,1025,42195,1025,158,158,0,1,1200,1,0,allow,1,0,Potential Threat
53583,15354,6378,15354,70,70,0,2,7,2,0,allow,1,0,Potential Threat
52989,53,36046,53,406,94,312,2,30,1,1,allow,0,0,Normal
10306,44847,0,0,66,66,0,1,0,1,0,deny,1,1,High Risk
21133,41620,37961,41620,150,150,0,1,1199,1,0,allow,1,0,Potential Threat
50795,443,7705,443,18444,12288,6156,36,149,20,16,allow,1,0,Potential Threat
62820,445,0,0,70,70,0,1,0,1,0,drop,0,1,Known Attack
59097,2767,0,0,66,66,0,1,0,1,0,deny,0,1,Known Attack
49944,80,31108,80,3695,550,3145,12,15,6,6,allow,0,0,Normal
59038,53,59038,53,832,106,726,2,30,1,1,allow,0,0,Normal
54395,445,0,0,66,66,0,1,0,1,0,drop,0,1,Known Attack
37586,443,60521,443,499,425,74,4,0,3,1,allow,1,0,Potential Threat
59693,445,0,0,70,70,0,1,0,1,0,drop,0,1,Known Attack
50385,445,0,0,70,70,0,1,0,1,0,drop,0,1,Known Attack
63945,53,11861,53,216,110,106,2,31,1,1,allow,0,0,Normal
64174,53,47378,53,438,130,308,4,35,2,2,allow,0,0,Normal
51756,53,33754,53,168,78,90,2,30,1,1,allow,0,0,Normal
50018,53,63073,53,350,91,259,4,41,2,2,allow,1,0,Potential Threat
55142,26467,0,0,66,66,0,1,0,1,0,deny,0,1,Known Attack
62792,53,0,0,88,88,0,1,0,1,0,deny,0,1,Known Attack
51946,445,0,0,70,70,0,1,0,1,0,drop,0,1,Known Attack
55260,53,54111,53,183,94,89,2,30,1,1,allow,0,0,Normal
61637,445,0,0,70,70,0,1,0,1,0,drop,0,1,Known Attack
51843,445,0,0,70,70,0,1,0,1,0,drop,0,1,Known Attack
57093,26467,0,0,66,66,0,1,0,1,0,deny,0,1,Known Attack
56066,53,20182,53,212,110,102,2,30,1,1,allow,0,0,Normal
51566,445,0,0,70,70,0,1,0,1,0,drop,0,1,Known Attack
60896,53,29321,53,168,78,90,2,31,1,1,allow,0,0,Normal
49576,80,6202,80,174140,4942,169198,166,65,47,119,allow,1,0,Potential Threat
53449,445,0,0,66,66,0,1,0,1,0,drop,0,1,Known Attack
54968,53,59116,53,199,102,97,2,30,1,1,allow,0,0,Normal
45908,33330,0,0,60,60,0,1,0,1,0,deny,0,1,Known Attack
26900,27017,40342,27017,422,164,258,6,30,3,3,allow,1,0,Potential Threat
58863,443,30901,443,4546411,95150,4451261,4312,109,1197,3115,allow,1,0,Potential Threat
64531,53,41084,53,183,94,89,2,30,1,1,allow,0,0,Normal
51534,443,19846,443,262,70,192,5,21,2,3,allow,0,0,Normal
57251,53,30748,53,780,104,676,2,31,1,1,allow,0,0,Normal
58459,445,0,0,70,70,0,1,0,1,0,drop,0,1,Known Attack
59088,445,0,0,66,66,0,1,0,1,0,drop,0,1,Known Attack
55206,445,0,0,70,70,0,1,0,1,0,drop,0,1,Known Attack
64135,53,50232,53,192,98,94,2,31,1,1,allow,0,0,Normal
59549,445,0,0,70,70,0,1,0,1,0,drop,0,1,Known Attack
56062,53,34305,53,196,102,94,2,30,1,1,allow,0,0,Normal
50073,443,27421,443,22729,6539,16190,54,93,27,27,allow,1,0,Potential Threat
39056,22114,0,0,62,62,0,1,0,1,0,deny,0,1,Known Attack
41429,50584,0,0,66,66,0,1,0,1,0,deny,0,1,Known Attack
49233,53,6991,53,819,102,717,2,29,1,1,allow,0,0,Normal
40386,443,23622,443,600,156,444,8,25,2,6,allow,0,0,Normal
63905,19899,5860,19899,312,132,180,6,7,3,3,allow,1,0,Potential Threat
52207,4637,29875,4637,136,136,0,3,14,3,0,allow,1,0,Potential Threat
52980,445,0,0,66,66,0,1,0,1,0,drop,0,1,Known Attack
52663,443,53022,443,4416,1702,2714,19,126,9,10,allow,1,0,Potential Threat
64862,53,23535,53,223,94,129,2,29,1,1,allow,0,0,Normal
51942,443,54861,443,2646,1322,1324,28,36,15,13,allow,1,0,Potential Threat
56213,53,25430,53,168,78,90,2,30,1,1,allow,0,0,Normal
33356,80,44491,80,1658,1344,314,10,15,5,5,allow,1,0,Potential Threat
43215,443,60115,443,9781,3108,6673,28,15,15,13,allow,1,0,Potential Threat
57504,44847,0,0,66,66,0,1,0,1,0,deny,0,1,Known Attack
57307,53,5441,53,177,94,83,2,30,1,1,allow,0,0,Normal
58868,445,0,0,66,66,0,1,0,1,0,drop,0,1,Known Attack
50237,445,0,0,70,70,0,1,0,1,0,drop,0,1,Known Attack
36579,30188,0,0,66,66,0,1,0,1,0,deny,0,1,Known Attack
58063,445,0,0,70,70,0,1,0,1,0,drop,0,1,Known Attack
63997,445,0,0,70,70,0,1,0,1,0,drop,0,1,Known Attack
50584,64368,19845,64368,161,161,0,2,1200,2,0,allow,1,0,Potential Threat
50299,53,31351,53,770,102,668,2,30,1,1,allow,0,0,Normal
11964,53,13321,53,268,94,174,2,30,1,1,allow,0,0,Normal
56014,443,56014,443,4334,1427,2907,19,30,11,8,allow,1,0,Potential Threat
57470,24451,64687,24451,166,166,0,1,1200,1,0,allow,1,0,Potential Threat
2425,23117,0,0,66,66,0,1,0,1,0,deny,1,1,High Risk
54721,22114,0,0,62,62,0,1,0,1,0,deny,0,1,Known Attack
56387,445,0,0,70,70,0,1,0,1,0,drop,0,1,Known Attack
52217,22114,0,0,66,66,0,1,0,1,0,deny,0,1,Known Attack
37536,80,9440,80,3565,1020,2545,16,15,9,7,allow,1,0,Potential Threat
38771,443,39867,443,7407,3501,3906,18,15,10,8,allow,1,0,Potential Threat
64566,53,26350,53,194,102,92,2,29,1,1,allow,0,0,Normal
27005,50001,15883,50001,1656,126,1530,4,31,2,2,allow,1,0,Potential Threat
56173,37807,0,0,62,62,0,1,0,1,0,deny,0,1,Known Attack
56314,53,50014,53,183,94,89,2,30,1,1,allow,0,0,Normal
44721,443,28122,443,24317,1518,22799,38,218,16,22,allow,1,0,Potential Threat
56755,445,0,0,66,66,0,1,0,1,0,drop,0,1,Known Attack
59148,445,0,0,70,70,0,1,0,1,0,drop,0,1,Known Attack
53456,443,13197,443,25555,2220,23335,44,30,20,24,allow,1,0,Potential Threat
56044,80,25395,80,1515,481,1034,11,16,6,5,allow,0,0,Normal
6881,6881,3673,6881,237,118,119,2,1200,1,1,allow,1,0,Potential Threat
54594,445,0,0,70,70,0,1,0,1,0,drop,0,1,Known Attack
59933,80,46618,80,1756,414,1342,12,15,6,6,allow,1,0,Potential Threat
56993,445,0,0,70,70,0,1,0,1,0,drop,0,1,Known Attack
62835,445,0,0,70,70,0,1,0,1,0,drop,0,1,Known Attack
56395,53,54170,53,199,102,97,2,29,1,1,allow,0,0,Normal
56896,445,0,0,70,70,0,1,0,1,0,drop,0,1,Known Attack
49197,30188,0,0,62,62,0,1,0,1,0,deny,0,1,Known Attack
56157,50584,0,0,66,66,0,1,0,1,0,deny,0,1,Known Attack
42379,443,33462,443,1622,1137,485,11,26,7,4,allow,1,0,Potential Threat
57307,53,57558,53,170,87,83,2,31,1,1,allow,0,0,Normal
5222,32859,0,0,66,66,0,1,0,1,0,deny,1,1,High Risk
61711,35440,0,0,66,66,0,1,0,1,0,deny,0,1,Known Attack
58925,25174,0,0,66,66,0,1,0,1,0,deny,0,1,Known Attack
45941,23386,0,0,60,60,0,1,0,1,0,deny,0,1,Known Attack
54280,3385,0,0,60,60,0,1,0,1,0,deny,0,1,Known Attack
58361,445,0,0,70,70,0,1,0,1,0,drop,0,1,Known Attack
50928,80,36754,80,875,518,357,10,75,6,4,allow,0,0,Normal
48841,51221,0,0,62,62,0,1,0,1,0,deny,0,1,Known Attack
56415,53,16835,53,740,93,647,2,30,1,1,allow,0,0,Normal
55372,53,7749,53,271,93,178,4,43,2,2,allow,0,0,Normal
7275,9524,0,0,66,66,0,1,0,1,0,deny,0,1,Known Attack
55162,445,0,0,66,66,0,1,0,1,0,drop,0,1,Known Attack
59112,445,0,0,70,70,0,1,0,1,0,drop,0,1,Known Attack
52100,80,3260,80,30068,3203,26865,43,35,19,24,allow,1,0,Potential Threat
50604,443,50604,443,4401,1494,2907,19,28,11,8,allow,1,0,Potential Threat
49418,27019,26998,27019,242,78,164,2,30,1,1,allow,1,0,Potential Threat
50511,443,12647,443,6352,1073,5279,22,85,12,10,allow,1,0,Potential Threat
62916,993,58185,993,8832,3647,5185,77,41,35,42,allow,1,0,Potential Threat
37927,50265,0,0,66,66,0,1,0,1,0,deny,0,1,Known Attack
59432,445,0,0,66,66,0,1,0,1,0,drop,0,1,Known Attack
64689,53,47457,53,763,102,661,2,30,1,1,allow,0,0,Normal
6666,2001,0,0,60,60,0,1,0,1,0,deny,0,1,Known Attack
55379,53,30186,53,256,93,163,2,31,1,1,allow,0,0,Normal
55085,443,57915,443,5803,4960,843,19,124,11,8,allow,1,0,Potential Threat
29988,44847,0,0,66,66,0,1,0,1,0,deny,1,1,High Risk
64433,53,29795,53,214,102,112,2,30,1,1,allow,0,0,Normal
56263,445,0,0,66,66,0,1,0,1,0,drop,0,1,Known Attack
59055,11392,0,0,66,66,0,1,0,1,0,deny,0,1,Known Attack
54627,445,0,0,70,70,0,1,0,1,0,drop,0,1,Known Attack
52246,52840,54967,52840,258,70,188,4,9,2,2,allow,1,0,Potential Threat
7231,53,7231,53,215,80,135,2,33,1,1,allow,1,0,Potential Threat
3478,61463,0,0,1262,1262,0,1,0,1,0,deny,1,1,High Risk
56588,443,28580,443,10615,5909,4706,28,42,14,14,allow,1,0,Potential Threat
44147,64147,0,0,62,62,0,1,0,1,0,deny,1,1,High Risk
61729,445,0,0,70,70,0,1,0,1,0,drop,0,1,Known Attack
43463,443,25009,443,6919,1449,5470,21,186,12,9,allow,1,0,Potential Threat
49421,443,23073,443,301494,6917,294577,306,48,101,205,allow,1,0,Potential Threat
61843,445,0,0,70,70,0,1,0,1,0,drop,0,1,Known Attack
19875,30170,0,0,145,145,0,1,0,1,0,deny,1,1,High Risk
58314,445,0,0,66,66,0,1,0,1,0,drop,0,1,Known Attack
55072,445,0,0,70,70,0,1,0,1,0,drop,0,1,Known Attack
61159,445,0,0,66,66,0,1,0,1,0,drop,0,1,Known Attack
60222,22114,0,0,66,66,0,1,0,1,0,deny,0,1,Known Attack
57913,443,36692,443,10457,4216,6241,70,194,31,39,allow,1,0,Potential Threat
49171,53,63019,53,301,102,199,2,30,1,1,allow,1,0,Potential Threat
54123,443,54123,443,79652,20710,58942,112,84,58,54,allow,1,0,Potential Threat
36712,53,0,0,139,70,69,2,30,1,1,allow,0,0,Normal
57800,445,0,0,66,66,0,1,0,1,0,drop,0,1,Known Attack
3730,17372,0,0,62,62,0,1,0,1,0,deny,1,1,High Risk
49719,445,0,0,70,70,0,1,0,1,0,drop,0,1,Known Attack
55321,53,21988,53,193,102,91,2,31,1,1,allow,0,0,Normal
57020,53,49369,53,738,86,652,2,31,1,1,allow,0,0,Normal
52575,445,0,0,70,70,0,1,0,1,0,drop,0,1,Known Attack
63666,445,0,0,66,66,0,1,0,1,0,drop,0,1,Known Attack
64414,445,0,0,70,70,0,1,0,1,0,drop,0,1,Known Attack
60481,445,0,0,70,70,0,1,0,1,0,drop,0,1,Known Attack
54490,445,0,0,70,70,0,1,0,1,0,drop,0,1,Known Attack
55865,53,64490,53,168,86,82,2,30,1,1,allow,1,0,Potential Threat
49920,443,45165,443,8888,2265,6623,18,15,9,9,allow,1,0,Potential Threat
36097,443,29806,443,6131,1384,4747,27,50,15,12,allow,1,0,Potential Threat
64354,53,25529,53,240,78,162,2,30,1,1,allow,0,0,Normal
55502,53,15110,53,194,102,92,2,30,1,1,allow,0,0,Normal
56269,53,62645,53,816,102,714,2,30,1,1,allow,1,0,Potential Threat
2791,7302,0,0,62,62,0,1,0,1,0,deny,1,1,High Risk
53676,445,0,0,66,66,0,1,0,1,0,drop,0,1,Known Attack
57899,443,40248,443,6115,1035,5080,21,170,11,10,allow,1,0,Potential Threat
49216,53,25748,53,178,91,87,2,31,1,1,allow,0,0,Normal
65081,26467,0,0,66,66,0,1,0,1,0,deny,0,1,Known Attack
56261,53,22541,53,184,94,90,2,31,1,1,allow,0,0,Normal
64185,445,0,0,70,70,0,1,0,1,0,drop,0,1,Known Attack
42349,443,27589,443,90562,4227,86335,118,200,49,69,allow,1,0,Potential Threat
53406,44847,0,0,66,66,0,1,0,1,0,deny,0,1,Known Attack
62049,443,56388,443,7856,2410,5446,30,17,16,14,allow,1,0,Potential Threat
55999,443,22014,443,3640,606,3034,13,120,6,7,allow,1,0,Potential Threat
57327,443,38850,443,5613,733,4880,16,15,9,7,allow,1,0,Potential Threat
27064,51221,0,0,72,72,0,1,0,1,0,deny,1,1,High Risk
61361,443,58250,443,7653,1226,6427,24,18,14,10,allow,1,0,Potential Threat
31738,51505,0,0,62,62,0,1,0,1,0,deny,1,1,High Risk
50052,65008,0,0,60,60,0,1,0,1,0,deny,1,1,High Risk
55595,443,57179,443,448,166,282,2,30,1,1,allow,0,0,Normal
25309,53,25309,53,371,237,134,3,33,2,1,allow,1,0,Potential Threat
56019,53,13898,53,194,102,92,2,30,1,1,allow,0,0,Normal
57378,53,5726,53,350,94,256,2,30,1,1,allow,0,0,Normal
50700,80,7007,80,142,142,0,1,5,1,0,allow,0,0,Normal
55856,445,0,0,66,66,0,1,0,1,0,drop,0,1,Known Attack
53815,44847,0,0,66,66,0,1,0,1,0,deny,0,1,Known Attack
49981,53,18517,53,200,94,106,2,30,1,1,allow,0,0,Normal
59052,53,10639,53,504,110,394,2,30,1,1,allow,0,0,Normal
35937,25174,0,0,66,66,0,1,0,1,0,deny,0,1,Known Attack
34217,23,0,0,60,60,0,1,0,1,0,deny,0,1,Known Attack
55627,53,4823,53,193,102,91,2,30,1,1,allow,0,0,Normal
35214,8635,35214,8635,138,78,60,2,5,1,1,allow,1,0,Potential Threat
49418,27054,42342,27054,272,78,194,2,30,1,1,allow,1,0,Potential Threat
50443,445,0,0,66,66,0,1,0,1,0,drop,0,1,Known Attack
40648,443,10699,443,130,70,60,3,5,2,1,allow,0,0,Normal
25342,8168,0,0,66,66,0,1,0,1,0,deny,0,1,Known Attack
64321,53,56788,53,195,102,93,2,31,1,1,allow,0,0,Normal
64825,53,49543,53,184,94,90,2,31,1,1,allow,0,0,Normal
41210,443,11454,443,234,234,0,4,11,4,0,allow,0,0,Normal
44410,443,17016,443,2359,1436,923,18,38,10,8,allow,1,0,Potential Threat
56112,53,3199,53,198,101,97,2,31,1,1,allow,0,0,Normal
49670,443,5760,443,886,541,345,11,15,6,5,allow,1,0,Potential Threat
49501,11392,0,0,62,62,0,1,0,1,0,deny,0,1,Known Attack
443,20995,0,0,83,83,0,1,0,1,0,deny,1,1,High Risk
49953,80,9395,80,11209,819,10390,19,15,9,10,allow,1,0,Potential Threat
56528,64147,0,0,62,62,0,1,0,1,0,deny,1,1,High Risk
0,0,0,0,124,64,60,2,0,1,1,allow,1,0,Potential Threat
54453,443,34094,443,257837,37453,220384,446,952,175,271,allow,1,0,Potential Threat
57246,443,63215,443,360050,17258,342792,432,68,185,247,allow,1,0,Potential Threat
61440,443,7179,443,7896,1207,6689,20,26,10,10,allow,1,0,Potential Threat
5222,18733,0,0,66,66,0,1,0,1,0,deny,1,1,High Risk
58921,443,58921,443,4627,1720,2907,19,28,11,8,allow,1,0,Potential Threat
53519,64147,0,0,66,66,0,1,0,1,0,deny,1,1,High Risk
52332,445,0,0,70,70,0,1,0,1,0,drop,0,1,Known Attack
54267,53,33061,53,86,86,0,1,30,1,0,allow,0,0,Normal
62745,445,0,0,66,66,0,1,0,1,0,drop,0,1,Known Attack
50023,445,0,0,66,66,0,1,0,1,0,drop,0,1,Known Attack
51146,23117,0,0,66,66,0,1,0,1,0,deny,0,1,Known Attack
52211,80,22459,80,8559,5109,3450,23,160,12,11,allow,1,0,Potential Threat
55535,53,31917,53,198,101,97,2,30,1,1,allow,0,0,Normal
50387,443,3636,443,2227,1018,1209,17,16,8,9,allow,1,0,Potential Threat
8868,50584,0,0,146,146,0,1,0,1,0,deny,1,1,High Risk
38861,443,38861,443,90303,5838,84465,140,103,68,72,allow,1,0,Potential Threat
55082,25174,0,0,66,66,0,1,0,1,0,deny,0,1,Known Attack
53192,443,46060,443,35788,2073,33715,54,21,20,34,allow,1,0,Potential Threat
62156,445,0,0,66,66,0,1,0,1,0,drop,0,1,Known Attack
57470,26944,61791,26944,480,149,331,2,1200,1,1,allow,1,0,Potential Threat
45941,23388,0,0,60,60,0,1,0,1,0,deny,0,1,Known Attack
55545,53,31002,53,177,94,83,2,30,1,1,allow,0,0,Normal
43487,443,8725,443,6886,1291,5595,27,285,15,12,allow,1,0,Potential Threat
11133,51505,0,0,66,66,0,1,0,1,0,deny,1,1,High Risk
62089,8604,0,0,66,66,0,1,0,1,0,deny,0,1,Known Attack
57010,53,20752,53,198,101,97,2,30,1,1,allow,0,0,Normal
59107,25174,0,0,66,66,0,1,0,1,0,deny,0,1,Known Attack
52720,443,21173,443,11732,4753,6979,41,397,17,24,allow,1,0,Potential Threat
50648,80,8370,80,62,62,0,1,5,1,0,allow,0,0,Normal
52432,443,37828,443,330,190,140,6,15,4,2,allow,0,0,Normal
64168,53,53054,53,306,94,212,2,30,1,1,allow,0,0,Normal
45525,53,45525,53,86,86,0,1,30,1,0,allow,0,0,Normal
49297,53,2852,53,183,94,89,2,30,1,1,allow,0,0,Normal
55840,53,55617,53,177,94,83,2,30,1,1,allow,0,0,Normal
49532,53,59388,53,331,92,239,4,40,2,2,allow,0,0,Normal
34396,443,45872,443,6214,1750,4464,24,316,12,12,allow,1,0,Potential Threat
16387,20045,0,0,60,60,0,1,0,1,0,deny,0,1,Known Attack
63941,80,15778,80,314,192,122,6,15,4,2,allow,0,0,Normal
55604,53,44456,53,758,93,665,2,31,1,1,allow,0,0,Normal
51114,445,0,0,70,70,0,1,0,1,0,drop,0,1,Known Attack
50193,3389,50193,3389,3473,1518,1955,17,19,9,8,allow,1,0,Potential Threat
21606,80,0,0,60,60,0,1,0,1,0,deny,0,1,Known Attack
49341,53,19411,53,199,102,97,2,29,1,1,allow,0,0,Normal
51893,63924,1367,63924,70,70,0,1,5,1,0,allow,1,0,Potential Threat
56375,80,51111,80,1609,919,690,15,72,8,7,allow,1,0,Potential Threat
50037,53,63751,53,195,102,93,2,31,1,1,allow,1,0,Potential Threat
53632,58037,54997,58037,70,70,0,1,5,1,0,allow,1,0,Potential Threat
57201,53,44480,53,165,86,79,2,30,1,1,allow,0,0,Normal
63369,445,0,0,66,66,0,1,0,1,0,drop,0,1,Known Attack
49764,53,33834,53,198,101,97,2,31,1,1,allow,0,0,Normal
41547,80,41547,80,120443,1965,118478,108,20,21,87,allow,1,0,Potential Threat
38702,443,49260,443,1117339,17881,1099458,1006,16,256,750,allow,1,0,Potential Threat
56660,445,0,0,66,66,0,1,0,1,0,drop,0,1,Known Attack
50566,443,4143,443,2064,1287,777,16,139,9,7,allow,1,0,Potential Threat
49340,53,57846,53,387,134,253,2,30,1,1,allow,0,0,Normal
50265,5554,7404,5554,472,150,322,2,1200,1,1,allow,1,0,Potential Threat
51966,80,56206,80,83302,3780,79522,105,66,47,58,allow,1,0,Potential Threat
49545,53,14108,53,195,102,93,2,30,1,1,allow,0,0,Normal
51963,21638,62624,21638,70,70,0,2,8,2,0,allow,1,0,Potential Threat
46292,42873,0,0,72,72,0,1,0,1,0,deny,0,1,Known Attack
50644,35440,0,0,66,66,0,1,0,1,0,deny,0,1,Known Attack
47266,25174,0,0,146,146,0,1,0,1,0,deny,1,1,High Risk
57956,445,0,0,70,70,0,1,0,1,0,drop,0,1,Known Attack
52036,52608,61881,52608,70,70,0,2,8,2,0,allow,1,0,Potential Threat
46212,443,60547,443,9753,1572,8181,22,362,11,11,allow,1,0,Potential Threat
50377,53,41134,53,214,110,104,2,30,1,1,allow,0,0,Normal
55529,44847,0,0,66,66,0,1,0,1,0,deny,0,1,Known Attack
41390,443,29292,443,7240,2035,5205,25,316,12,13,allow,1,0,Potential Threat
3478,61463,0,0,164,164,0,1,0,1,0,deny,1,1,High Risk
63839,445,0,0,66,66,0,1,0,1,0,drop,0,1,Known Attack
53449,443,9843,443,12474,4810,7664,39,66,19,20,allow,1,0,Potential Threat
56876,11392,0,0,66,66,0,1,0,1,0,deny,0,1,Known Attack
41346,30188,0,0,62,62,0,1,0,1,0,deny,0,1,Known Attack
37267,443,16640,443,3296,1636,1660,17,255,9,8,allow,1,0,Potential Threat
57959,21247,0,0,66,66,0,1,0,1,0,deny,0,1,Known Attack
39600,5900,0,0,60,60,0,1,0,1,0,deny,0,1,Known Attack
6882,42505,24055,42505,207,118,89,2,1200,1,1,allow,1,0,Potential Threat
54670,445,0,0,66,66,0,1,0,1,0,drop,0,1,Known Attack
60774,443,14767,443,29739,1164,28575,40,120,15,25,allow,1,0,Potential Threat
47303,31170,0,0,145,145,0,1,0,1,0,deny,1,1,High Risk
60349,445,0,0,70,70,0,1,0,1,0,drop,0,1,Known Attack
49869,53,17507,53,414,103,311,4,31,2,2,allow,0,0,Normal
52017,445,0,0,66,66,0,1,0,1,0,drop,0,1,Known Attack
65388,53,55189,53,764,99,665,2,31,1,1,allow,1,0,Potential Threat
49826,53,26730,53,650,286,364,8,84,4,4,allow,0,0,Normal
56752,53,3213,53,183,94,89,2,29,1,1,allow,0,0,Normal
50584,60395,46252,60395,166,166,0,1,1200,1,0,allow,1,0,Potential Threat
63834,27037,60626,27037,1592,1386,206,6,31,4,2,allow,1,0,Potential Threat
47073,7275,39561,7275,416,210,206,7,15,4,3,allow,1,0,Potential Threat
50406,443,46416,443,6470,897,5573,24,55,9,15,allow,1,0,Potential Threat
10099,80,20785,80,130,70,60,2,15,1,1,allow,1,0,Potential Threat
64381,53,47350,53,196,100,96,2,30,1,1,allow,0,0,Normal
58703,443,1950,443,15202,6356,8846,40,119,22,18,allow,1,0,Potential Threat
52195,50930,43224,50930,70,70,0,2,8,2,0,allow,1,0,Potential Threat
44037,5223,40215,5223,5096,1030,4066,25,1751,9,16,allow,1,0,Potential Threat
49198,64509,55959,64509,70,70,0,1,5,1,0,allow,1,0,Potential Threat
55421,53,63396,53,168,78,90,2,30,1,1,allow,1,0,Potential Threat
51861,445,0,0,70,70,0,1,0,1,0,drop,0,1,Known Attack
16403,16385,35308,16385,308,128,180,6,30,3,3,allow,1,0,Potential Threat
43033,443,43033,443,10239,2017,8222,23,18,14,9,allow,1,0,Potential Threat
11876,22,0,0,60,60,0,1,0,1,0,deny,0,1,Known Attack
65052,53,65052,53,240,98,142,2,30,1,1,allow,1,0,Potential Threat
57176,445,0,0,66,66,0,1,0,1,0,drop,0,1,Known Attack
49842,445,0,0,66,66,0,1,0,1,0,drop,0,1,Known Attack
49404,53,23314,53,200,94,106,2,30,1,1,allow,0,0,Normal
6069,45680,0,0,159,159,0,1,0,1,0,deny,1,1,High Risk
63023,443,14505,443,382,164,218,2,30,1,1,allow,0,0,Normal
60427,61137,28150,61137,70,70,0,1,5,1,0,allow,1,0,Potential Threat
62122,53,41697,53,179,86,93,2,30,1,1,allow,0,0,Normal
58638,5900,0,0,62,62,0,1,0,1,0,deny,0,1,Known Attack
56737,53,36153,53,817,98,719,2,31,1,1,allow,0,0,Normal
55032,5222,63875,5222,138,64,74,3,5,2,1,allow,1,0,Potential Threat
16980,53,16980,53,197,90,107,2,30,1,1,allow,0,0,Normal
35567,443,35567,443,5413,2166,3247,22,39,13,9,allow,1,0,Potential Threat
53496,445,0,0,66,66,0,1,0,1,0,drop,0,1,Known Attack
39948,5223,55367,5223,5551,1338,4213,28,1323,11,17,allow,1,0,Potential Threat
56445,53,29245,53,199,102,97,2,30,1,1,allow,0,0,Normal
51221,64767,41578,64767,330,330,0,6,1200,6,0,allow,1,0,Potential Threat
45941,23386,0,0,60,60,0,1,0,1,0,deny,0,1,Known Attack
56796,443,60351,443,8074,2054,6020,20,15,11,9,allow,1,0,Potential Threat
7222,57470,0,0,62,62,0,1,0,1,0,deny,1,1,High Risk
52148,29104,16660,29104,70,70,0,1,5,1,0,allow,1,0,Potential Threat
61415,445,0,0,66,66,0,1,0,1,0,drop,0,1,Known Attack
51375,445,0,0,66,66,0,1,0,1,0,drop,0,1,Known Attack
62262,445,0,0,66,66,0,1,0,1,0,drop,0,1,Known Attack
57853,64147,0,0,66,66,0,1,0,1,0,deny,1,1,High Risk
55839,56535,0,0,62,62,0,1,0,1,0,deny,0,1,Known Attack
14997,57470,0,0,72,72,0,1,0,1,0,deny,1,1,High Risk
53718,445,0,0,70,70,0,1,0,1,0,drop,0,1,Known Attack
59576,445,0,0,70,70,0,1,0,1,0,drop,0,1,Known Attack
50792,445,0,0,70,70,0,1,0,1,0,drop,0,1,Known Attack
0,0,0,0,134,64,70,2,0,1,1,allow,1,0,Potential Threat
65356,53,36098,53,199,102,97,2,30,1,1,allow,0,0,Normal
59087,445,0,0,70,70,0,1,0,1,0,drop,0,1,Known Attack
56658,53,51855,53,177,94,83,2,30,1,1,allow,0,0,Normal
54981,53,59429,53,757,102,655,2,29,1,1,allow,0,0,Normal
56491,53,2856,53,165,86,79,2,30,1,1,allow,0,0,Normal
6881,6881,0,0,62,62,0,1,0,1,0,deny,0,1,Known Attack
58944,445,0,0,66,66,0,1,0,1,0,drop,0,1,Known Attack
57452,57470,0,0,62,62,0,1,0,1,0,deny,1,1,High Risk
64687,53,62553,53,182,93,89,2,31,1,1,allow,1,0,Potential Threat
61411,80,31645,80,145440,11034,134406,292,158,135,157,allow,1,0,Potential Threat
51892,445,0,0,66,66,0,1,0,1,0,drop,0,1,Known Attack
3802,55777,0,0,66,66,0,1,0,1,0,deny,1,1,High Risk
1111,25174,0,0,62,62,0,1,0,1,0,deny,1,1,High Risk
64588,53,5541,53,264,102,162,2,30,1,1,allow,0,0,Normal
59395,445,0,0,70,70,0,1,0,1,0,drop,0,1,Known Attack
50318,80,21534,80,3855,828,3027,11,15,5,6,allow,1,0,Potential Threat
63961,51641,64148,51641,504,382,122,8,16,6,2,allow,1,0,Potential Threat
38624,443,30332,443,6385,1090,5295,18,33,10,8,allow,1,0,Potential Threat
54522,443,63026,443,4728282,133897,4594385,4756,80,1650,3106,allow,1,0,Potential Threat
11676,25174,0,0,146,146,0,1,0,1,0,deny,1,1,High Risk
51226,445,0,0,70,70,0,1,0,1,0,drop,0,1,Known Attack
39252,53,39252,53,197,90,107,2,29,1,1,allow,0,0,Normal
52235,48910,47820,48910,136,136,0,3,14,3,0,allow,1,0,Potential Threat
25453,35776,0,0,145,145,0,1,0,1,0,deny,1,1,High Risk
19845,30024,0,0,62,62,0,1,0,1,0,deny,0,1,Known Attack
48817,16156,48817,16156,513,152,361,2,1200,1,1,allow,1,0,Potential Threat
57302,62413,0,0,66,66,0,1,0,1,0,deny,1,1,High Risk
58040,445,0,0,70,70,0,1,0,1,0,drop,0,1,Known Attack
49516,35894,0,0,145,145,0,1,0,1,0,deny,1,1,High Risk
52772,445,0,0,70,70,0,1,0,1,0,drop,0,1,Known Attack
53835,7000,53835,7000,2099,676,1423,13,15,7,6,allow,1,0,Potential Threat
60771,58414,0,0,66,66,0,1,0,1,0,deny,1,1,High Risk
55898,53,25351,53,757,102,655,2,30,1,1,allow,0,0,Normal
52483,445,0,0,70,70,0,1,0,1,0,drop,0,1,Known Attack
45837,443,61728,443,39986,3118,36868,72,82,30,42,allow,1,0,Potential Threat
43129,20220,0,0,62,62,0,1,0,1,0,deny,0,1,Known Attack
56006,53,56453,53,200,102,98,2,30,1,1,allow,0,0,Normal
49876,53,41654,53,199,102,97,2,30,1,1,allow,0,0,Normal
33215,37965,0,0,62,62,0,1,0,1,0,deny,0,1,Known Attack
63938,26204,5698,26204,66,66,0,2,7,2,0,allow,1,0,Potential Threat
56965,445,0,0,70,70,0,1,0,1,0,drop,0,1,Known Attack
60312,57470,0,0,74,74,0,1,0,1,0,deny,1,1,High Risk
50116,22,50116,22,152,66,86,2,10,1,1,allow,0,0,Normal
55615,445,0,0,70,70,0,1,0,1,0,deny,0,1,Known Attack
55449,443,46191,443,480989,16896,464093,507,22,178,329,allow,1,0,Potential Threat
54251,445,0,0,70,70,0,1,0,1,0,drop,0,1,Known Attack
50987,80,34293,80,8047,2291,5756,22,19,13,9,allow,1,0,Potential Threat
58562,57587,0,0,66,66,0,1,0,1,0,deny,1,1,High Risk
53186,443,23298,443,10332,2735,7597,36,21,17,19,allow,1,0,Potential Threat
65410,53,40006,53,229,110,119,2,31,1,1,allow,0,0,Normal
52476,443,35367,443,7787,3056,4731,19,87,10,9,allow,1,0,Potential Threat
65304,53,18529,53,209,110,99,2,30,1,1,allow,0,0,Normal
49424,53,11040,53,198,102,96,2,33,1,1,allow,0,0,Normal
49888,53,17695,53,198,102,96,2,29,1,1,allow,0,0,Normal
53536,34200,55165,34200,70,70,0,1,4,1,0,allow,1,0,Potential Threat
57284,22114,0,0,62,62,0,1,0,1,0,deny,0,1,Known Attack
55214,53,41945,53,711,87,624,2,31,1,1,allow,0,0,Normal
53268,443,17713,443,22541,2143,20398,38,322,16,22,allow,1,0,Potential Threat
56998,53,8754,53,170,87,83,2,31,1,1,allow,0,0,Normal
51763,34121,50527,34121,70,70,0,1,5,1,0,allow,1,0,Potential Threat
53432,445,0,0,66,66,0,1,0,1,0,drop,0,1,Known Attack
60312,57470,0,0,74,74,0,1,0,1,0,deny,1,1,High Risk
47803,64147,0,0,145,145,0,1,0,1,0,deny,1,1,High Risk
10102,443,2452,443,5415,864,4551,19,360,9,10,allow,1,0,Potential Threat
60802,445,0,0,70,70,0,1,0,1,0,drop,0,1,Known Attack
6881,21416,0,0,146,146,0,1,0,1,0,deny,1,1,High Risk
49487,60043,0,0,62,62,0,1,0,1,0,deny,1,1,High Risk
46212,443,38830,443,67265,57889,9376,174,102,98,76,allow,1,0,Potential Threat
64582,53,17757,53,209,110,99,2,30,1,1,allow,0,0,Normal
60823,25174,0,0,66,66,0,1,0,1,0,deny,0,1,Known Attack
49631,53,37899,53,184,102,82,2,30,1,1,allow,0,0,Normal
64561,53,50313,53,209,110,99,2,30,1,1,allow,0,0,Normal
60443,50284,16097,50284,258,70,188,4,8,2,2,allow,1,0,Potential Threat
27005,27015,18996,27015,1618,126,1492,4,30,2,2,allow,1,0,Potential Threat
59895,53,59895,53,643,88,555,2,30,1,1,allow,0,0,Normal
55462,53,64670,53,214,110,104,2,29,1,1,allow,1,0,Potential Threat
53166,39564,27898,39564,70,70,0,2,8,2,0,allow,1,0,Potential Threat
27260,443,46156,443,4329,2374,1955,23,520,8,15,allow,1,0,Potential Threat
63582,445,0,0,70,70,0,1,0,1,0,drop,0,1,Known Attack
58268,445,0,0,70,70,0,1,0,1,0,drop,0,1,Known Attack
54773,50584,0,0,66,66,0,1,0,1,0,deny,0,1,Known Attack
64573,445,0,0,70,70,0,1,0,1,0,drop,0,1,Known Attack
56524,53,26224,53,182,102,80,2,30,1,1,allow,0,0,Normal
50920,60182,0,0,66,66,0,1,0,1,0,deny,1,1,High Risk
50907,445,0,0,70,70,0,1,0,1,0,drop,0,1,Known Attack
49364,53,15202,53,182,94,88,2,30,1,1,allow,0,0,Normal
50584,6881,63450,6881,1320,300,1020,6,1200,3,3,allow,1,0,Potential Threat
63959,445,0,0,66,66,0,1,0,1,0,drop,0,1,Known Attack
5664,36237,0,0,66,66,0,1,0,1,0,deny,1,1,High Risk
55180,53,4513,53,209,110,99,2,30,1,1,allow,0,0,Normal
7222,57470,0,0,62,62,0,1,0,1,0,deny,1,1,High Risk
57012,445,0,0,66,66,0,1,0,1,0,drop,0,1,Known Attack
54352,53,16730,53,578,286,292,9,16,5,4,allow,0,0,Normal
55553,37965,0,0,66,66,0,1,0,1,0,deny,0,1,Known Attack
55790,53,39330,53,177,94,83,2,30,1,1,allow,0,0,Normal
14614,25174,0,0,66,66,0,1,0,1,0,deny,0,1,Known Attack
12794,35440,0,0,146,146,0,1,0,1,0,deny,1,1,High Risk
53807,443,54173,443,499,425,74,4,0,3,1,allow,0,0,Normal
61929,445,0,0,70,70,0,1,0,1,0,drop,0,1,Known Attack
51028,445,0,0,70,70,0,1,0,1,0,drop,0,1,Known Attack
51244,59353,0,0,100,100,0,1,0,1,0,deny,1,1,High Risk
56840,53,4523,53,242,110,132,2,30,1,1,allow,0,0,Normal
59893,80,45322,80,130,70,60,2,15,1,1,allow,0,0,Normal
58886,15000,23434,15000,138,78,60,2,5,1,1,allow,1,0,Potential Threat
51866,23431,28853,23431,70,70,0,1,5,1,0,allow,1,0,Potential Threat
55502,445,0,0,70,70,0,1,0,1,0,drop,0,1,Known Attack
46570,443,45902,443,8897,2184,6713,24,516,13,11,allow,1,0,Potential Threat
40510,1488,40510,1488,156,156,0,3,7,3,0,allow,1,0,Potential Threat
63734,28221,59198,28221,66,66,0,2,7,2,0,allow,1,0,Potential Threat
53482,445,0,0,70,70,0,1,0,1,0,drop,0,1,Known Attack
64684,53,23170,53,199,94,105,2,30,1,1,allow,0,0,Normal
51889,44348,37588,44348,70,70,0,1,5,1,0,allow,1,0,Potential Threat
50732,445,0,0,70,70,0,1,0,1,0,drop,0,1,Known Attack
53671,60416,42593,60416,70,70,0,2,7,2,0,allow,1,0,Potential Threat
35497,443,49704,443,162,102,60,2,4,1,1,allow,0,0,Normal
12663,62413,0,0,66,66,0,1,0,1,0,deny,1,1,High Risk
26180,35440,0,0,62,62,0,1,0,1,0,deny,1,1,High Risk
53964,445,0,0,70,70,0,1,0,1,0,drop,0,1,Known Attack
62744,62413,0,0,66,66,0,1,0,1,0,deny,1,1,High Risk
57470,8999,29205,8999,863,363,500,4,1200,2,2,allow,1,0,Potential Threat
56504,443,16127,443,4467051,102279,4364772,4340,46,1452,2888,allow,1,0,Potential Threat
55272,53,17246,53,285,103,182,4,50,2,2,allow,0,0,Normal
65084,53,19424,53,215,102,113,2,29,1,1,allow,0,0,Normal
50523,445,0,0,70,70,0,1,0,1,0,drop,0,1,Known Attack
50273,443,63017,443,13363,4645,8718,54,241,32,22,allow,1,0,Potential Threat
53121,8986,41857,8986,70,70,0,2,8,2,0,allow,1,0,Potential Threat
49740,53,58621,53,167,86,81,2,29,1,1,allow,0,0,Normal
57276,443,44097,443,14236,2699,11537,51,31,27,24,allow,1,0,Potential Threat
64647,53,15086,53,718,94,624,2,30,1,1,allow,0,0,Normal
1067,51221,0,0,145,145,0,1,0,1,0,deny,1,1,High Risk
47771,25174,0,0,62,62,0,1,0,1,0,deny,0,1,Known Attack
45535,25174,0,0,66,66,0,1,0,1,0,deny,0,1,Known Attack
1865,25174,0,0,62,62,0,1,0,1,0,deny,1,1,High Risk
63950,53,13148,53,200,102,98,2,31,1,1,allow,0,0,Normal
57768,37965,0,0,62,62,0,1,0,1,0,deny,0,1,Known Attack
41508,53,41508,53,244,98,146,2,32,1,1,allow,0,0,Normal
30129,37965,0,0,72,72,0,1,0,1,0,deny,0,1,Known Attack
64633,53,57902,53,231,110,121,2,30,1,1,allow,0,0,Normal
54976,2273,0,0,60,60,0,1,0,1,0,deny,0,1,Known Attack
58809,443,34899,443,4054,2590,1464,18,16,9,9,allow,1,0,Potential Threat
55090,445,0,0,66,66,0,1,0,1,0,drop,0,1,Known Attack
59734,445,0,0,70,70,0,1,0,1,0,drop,0,1,Known Attack
60923,49903,0,0,66,66,0,1,0,1,0,deny,0,1,Known Attack
47042,443,19544,443,2809,1884,925,19,25,11,8,allow,1,0,Potential Threat
65414,53,56360,53,216,102,114,2,30,1,1,allow,0,0,Normal
1024,44847,0,0,62,62,0,1,0,1,0,deny,1,1,High Risk
58899,445,0,0,70,70,0,1,0,1,0,drop,0,1,Known Attack
52861,445,0,0,70,70,0,1,0,1,0,drop,0,1,Known Attack
52178,30922,2429,30922,70,70,0,1,5,1,0,allow,1,0,Potential Threat
51263,443,57364,443,162,102,60,2,5,1,1,allow,0,0,Normal
65524,443,51488,443,282968,9210,273758,296,15,106,190,allow,1,0,Potential Threat
56085,53,41627,53,167,86,81,2,30,1,1,allow,0,0,Normal
47053,5228,30906,5228,11647,2439,9208,47,3724,21,26,allow,1,0,Potential Threat
16477,37807,0,0,66,66,0,1,0,1,0,deny,1,1,High Risk
65067,53,43932,53,411,115,296,4,38,2,2,allow,0,0,Normal
64824,37965,0,0,62,62,0,1,0,1,0,deny,1,1,High Risk
60550,50584,0,0,62,62,0,1,0,1,0,deny,1,1,High Risk
64005,445,0,0,66,66,0,1,0,1,0,drop,0,1,Known Attack
51429,443,6993,443,8804,1597,7207,25,50,14,11,allow,1,0,Potential Threat
51925,80,55386,80,51645,3868,47777,67,28,30,37,allow,1,0,Potential Threat
62643,445,0,0,66,66,0,1,0,1,0,drop,0,1,Known Attack
64949,53,23952,53,208,106,102,2,31,1,1,allow,0,0,Normal
58247,57866,0,0,66,66,0,1,0,1,0,deny,1,1,High Risk
57131,7774,0,0,145,145,0,1,0,1,0,deny,0,1,Known Attack
48841,51221,0,0,62,62,0,1,0,1,0,deny,0,1,Known Attack
50593,64147,0,0,62,62,0,1,0,1,0,deny,1,1,High Risk
55735,53,13880,53,198,101,97,2,31,1,1,allow,0,0,Normal
55439,53,11568,53,177,94,83,2,30,1,1,allow,0,0,Normal
58638,5900,0,0,62,62,0,1,0,1,0,deny,0,1,Known Attack
53861,53065,56189,53065,70,70,0,1,5,1,0,allow,1,0,Potential Threat
60969,445,0,0,66,66,0,1,0,1,0,drop,0,1,Known Attack
35609,443,52136,443,9225,2759,6466,27,100,16,11,allow,1,0,Potential Threat
57987,3478,22536,3478,312,140,172,4,30,2,2,allow,0,0,Normal
61477,443,48304,443,30516,3311,27205,49,47,25,24,allow,1,0,Potential Threat
55648,445,0,0,70,70,0,1,0,1,0,drop,0,1,Known Attack
50386,53,42277,53,782,110,672,2,30,1,1,allow,0,0,Normal
64721,53,36880,53,212,108,104,2,30,1,1,allow,0,0,Normal
55627,53,20054,53,174,89,85,2,31,1,1,allow,0,0,Normal
58074,11392,0,0,62,62,0,1,0,1,0,deny,0,1,Known Attack
64595,53,56897,53,183,94,89,2,29,1,1,allow,0,0,Normal
55155,53,65476,53,188,96,92,2,31,1,1,allow,1,0,Potential Threat
53140,51221,0,0,74,74,0,1,0,1,0,deny,0,1,Known Attack
16630,44847,0,0,62,62,0,1,0,1,0,deny,1,1,High Risk
64276,53,2363,53,354,102,252,2,30,1,1,allow,0,0,Normal
65482,53,43448,53,179,94,85,2,30,1,1,allow,0,0,Normal
52096,443,15286,443,283,163,120,4,15,2,2,allow,0,0,Normal
49780,53,9183,53,183,94,89,2,31,1,1,allow,0,0,Normal
53192,445,0,0,66,66,0,1,0,1,0,drop,0,1,Known Attack
34731,22114,0,0,62,62,0,1,0,1,0,deny,0,1,Known Attack
59252,443,29438,443,8442,1134,7308,23,15,13,10,allow,1,0,Potential Threat
64621,53,62273,53,214,102,112,2,30,1,1,allow,1,0,Potential Threat
34417,53,11898,53,168,78,90,2,30,1,1,allow,0,0,Normal
50930,443,54294,443,134,60,74,3,10,2,1,allow,0,0,Normal
51104,13011,33495,13011,948,473,475,13,15,7,6,allow,1,0,Potential Threat
55325,53,2560,53,210,110,100,2,30,1,1,allow,0,0,Normal
7871,3389,7871,3389,4166,2141,2025,18,18,9,9,allow,1,0,Potential Threat
26978,443,38800,443,7547,2728,4819,26,20,13,13,allow,1,0,Potential Threat
50683,443,31278,443,12362,1650,10712,33,300,14,19,allow,1,0,Potential Threat
49609,53,44498,53,177,94,83,2,30,1,1,allow,0,0,Normal
49666,80,7693,80,2356,499,1857,10,125,6,4,allow,1,0,Potential Threat
22592,443,22592,443,29021,6752,22269,48,30,29,19,allow,1,0,Potential Threat
49324,445,0,0,70,70,0,1,0,1,0,drop,0,1,Known Attack
55625,445,0,0,66,66,0,1,0,1,0,drop,0,1,Known Attack
53758,63975,2179,63975,2016,1076,940,14,17,8,6,allow,1,0,Potential Threat
55386,53,64239,53,822,102,720,2,30,1,1,allow,1,0,Potential Threat
55655,53,55322,53,304,110,194,4,34,2,2,allow,0,0,Normal
61337,443,54439,443,31111,6287,24824,62,247,25,37,allow,1,0,Potential Threat
52707,443,49592,443,39551,4663,34888,60,357,27,33,allow,1,0,Potential Threat
11136,15503,0,0,62,62,0,1,0,1,0,deny,0,1,Known Attack
59262,80,59262,80,94514,14468,80046,152,15,41,111,allow,1,0,Potential Threat
54080,443,18578,443,6673,1531,5142,22,341,10,12,allow,1,0,Potential Threat
63731,445,0,0,66,66,0,1,0,1,0,drop,0,1,Known Attack
60246,80,10832,80,17231,6415,10816,26,149,12,14,allow,1,0,Potential Threat
64361,53,3934,53,194,94,100,2,30,1,1,allow,0,0,Normal
54535,443,39884,443,9859,3252,6607,24,74,12,12,allow,1,0,Potential Threat
58413,445,0,0,70,70,0,1,0,1,0,drop,0,1,Known Attack
49260,53,23458,53,199,86,113,2,30,1,1,allow,0,0,Normal
33801,62413,0,0,62,62,0,1,0,1,0,deny,1,1,High Risk
57866,53,0,0,216,80,136,2,30,1,1,allow,0,0,Normal
54442,445,0,0,66,66,0,1,0,1,0,drop,0,1,Known Attack
51691,445,0,0,70,70,0,1,0,1,0,drop,0,1,Known Attack
54625,53,52244,53,168,78,90,2,30,1,1,allow,0,0,Normal
49418,27018,61835,27018,248,71,177,2,30,1,1,allow,1,0,Potential Threat
55628,53,5942,53,821,102,719,2,30,1,1,allow,0,0,Normal
64794,80,22092,80,22646,1660,20986,29,135,10,19,allow,1,0,Potential Threat
63876,445,0,0,70,70,0,1,0,1,0,drop,0,1,Known Attack
59124,445,0,0,70,70,0,1,0,1,0,drop,0,1,Known Attack
47910,7454,0,0,60,60,0,1,0,1,0,deny,0,1,Known Attack
50918,80,48461,80,9643,812,8831,18,128,8,10,allow,1,0,Potential Threat
53835,62413,0,0,62,62,0,1,0,1,0,deny,1,1,High Risk
55849,443,27388,443,5944,1501,4443,27,163,13,14,allow,1,0,Potential Threat
49703,53,62145,53,228,110,118,2,30,1,1,allow,0,0,Normal
58021,22114,0,0,66,66,0,1,0,1,0,deny,0,1,Known Attack
45186,443,63714,443,5959,169,5790,10,121,3,7,allow,1,0,Potential Threat
53495,445,0,0,70,70,0,1,0,1,0,drop,0,1,Known Attack
56675,445,0,0,70,70,0,1,0,1,0,drop,0,1,Known Attack
51951,65387,33774,65387,70,70,0,1,5,1,0,allow,1,0,Potential Threat
57679,445,0,0,70,70,0,1,0,1,0,drop,0,1,Known Attack
58638,5900,0,0,62,62,0,1,0,1,0,deny,0,1,Known Attack
57021,445,0,0,70,70,0,1,0,1,0,drop,0,1,Known Attack
53601,30160,62732,30160,70,70,0,1,4,1,0,allow,1,0,Potential Threat
55377,53,41334,53,195,102,93,2,30,1,1,allow,0,0,Normal
7810,25174,0,0,66,66,0,1,0,1,0,deny,1,1,High Risk
65444,3389,65444,3389,4305,2521,1784,19,34,10,9,allow,1,0,Potential Threat
32914,5222,62781,5222,8702,4668,4034,92,626,50,42,allow,1,0,Potential Threat
42355,443,21738,443,4181,998,3183,14,26,7,7,allow,1,0,Potential Threat
56999,80,32577,80,214,140,74,4,35,3,1,allow,0,0,Normal
9687,57470,0,0,78,78,0,1,0,1,0,deny,1,1,High Risk
62345,443,13195,443,6343025,74037,6268988,5018,58,765,4253,allow,1,0,Potential Threat
56861,445,0,0,70,70,0,1,0,1,0,drop,0,1,Known Attack
58638,5900,0,0,62,62,0,1,0,1,0,deny,0,1,Known Attack
8889,9794,0,0,60,60,0,1,0,1,0,deny,0,1,Known Attack
14352,8055,0,0,148,148,0,1,0,1,0,deny,1,1,High Risk
52226,48784,61623,48784,70,70,0,1,5,1,0,allow,1,0,Potential Threat
52102,19604,10302,19604,70,70,0,2,8,2,0,allow,1,0,Potential Threat
44847,17977,12872,17977,502,150,352,2,1200,1,1,allow,1,0,Potential Threat
33886,52255,0,0,162,162,0,1,0,1,0,deny,1,1,High Risk
56785,445,0,0,70,70,0,1,0,1,0,drop,0,1,Known Attack
64695,53,7882,53,275,118,157,2,30,1,1,allow,0,0,Normal
53246,443,31450,443,6066,1046,5020,20,69,11,9,allow,1,0,Potential Threat
53310,443,4749,443,2253,1403,850,15,121,9,6,allow,1,0,Potential Threat
65259,37965,0,0,66,66,0,1,0,1,0,deny,0,1,Known Attack
49913,445,0,0,70,70,0,1,0,1,0,drop,0,1,Known Attack
56799,1,48991,1,316,136,180,6,6,3,3,allow,0,0,Normal
54493,445,0,0,70,70,0,1,0,1,0,drop,0,1,Known Attack
49919,80,15298,80,992,524,468,10,125,6,4,allow,0,0,Normal
63860,445,0,0,66,66,0,1,0,1,0,drop,0,1,Known Attack
65239,53,46235,53,198,101,97,2,31,1,1,allow,0,0,Normal
50228,53,36486,53,173,94,79,2,30,1,1,allow,0,0,Normal
49961,53,9720,53,327,126,201,2,30,1,1,allow,0,0,Normal
5938,37145,0,0,60,60,0,1,90,1,0,allow,1,0,Potential Threat
54749,443,23422,443,273283,194709,78574,1567,3312,746,821,allow,1,0,Potential Threat
54139,445,0,0,66,66,0,1,0,1,0,drop,0,1,Known Attack
55173,445,0,0,70,70,0,1,0,1,0,drop,0,1,Known Attack
0,0,0,0,156,156,0,2,0,2,0,deny,1,1,High Risk
56940,443,15296,443,4184,2787,1397,19,345,10,9,allow,1,0,Potential Threat
43323,1,0,0,62,62,0,1,0,1,0,deny,0,1,Known Attack
53856,443,18832,443,495,421,74,4,0,3,1,allow,0,0,Normal
23021,25174,0,0,66,66,0,1,0,1,0,deny,0,1,Known Attack
51439,443,28008,443,10119,1855,8264,26,28,15,11,allow,1,0,Potential Threat
64994,53,18089,53,216,102,114,2,30,1,1,allow,0,0,Normal
57398,53,47898,53,232,110,122,2,30,1,1,allow,0,0,Normal
32520,50265,0,0,145,145,0,1,0,1,0,deny,1,1,High Risk
42298,40020,47579,40020,148,86,62,2,31,1,1,allow,1,0,Potential Threat
58876,80,60067,80,32098,2435,29663,47,75,24,23,allow,1,0,Potential Threat
44774,22114,0,0,146,146,0,1,0,1,0,deny,1,1,High Risk
59934,35440,0,0,66,66,0,1,0,1,0,deny,0,1,Known Attack
50556,80,38454,80,378,192,186,7,26,4,3,allow,0,0,Normal
64115,2767,0,0,62,62,0,1,0,1,0,deny,0,1,Known Attack
20,17095,0,0,554,554,0,1,0,1,0,deny,1,1,High Risk
58849,64147,0,0,66,66,0,1,0,1,0,deny,1,1,High Risk
62041,445,0,0,70,70,0,1,0,1,0,drop,0,1,Known Attack
53907,45622,50876,45622,70,70,0,2,7,2,0,allow,1,0,Potential Threat
38857,443,38857,443,115031,5628,109403,143,104,55,88,allow,1,0,Potential Threat
64311,53,1855,53,198,101,97,2,31,1,1,allow,0,0,Normal
56852,53,36624,53,762,101,661,2,31,1,1,allow,0,0,Normal
53459,37807,0,0,62,62,0,1,0,1,0,deny,0,1,Known Attack
61315,48817,0,0,62,62,0,1,0,1,0,deny,1,1,High Risk
56598,443,16755,443,8630,2126,6504,20,15,11,9,allow,1,0,Potential Threat
52044,445,0,0,70,70,0,1,0,1,0,drop,0,1,Known Attack
36010,443,44715,443,5689,1505,4184,24,19,13,11,allow,1,0,Potential Threat
52704,53,49844,53,168,78,90,2,30,1,1,allow,0,0,Normal
41220,59356,0,0,62,62,0,1,0,1,0,deny,1,1,High Risk
38959,25174,0,0,62,62,0,1,0,1,0,deny,0,1,Known Attack
65062,53,47695,53,229,110,119,2,30,1,1,allow,0,0,Normal
54909,445,0,0,70,70,0,1,0,1,0,drop,0,1,Known Attack
3755,443,3755,443,12079,1344,10735,24,17,10,14,allow,1,0,Potential Threat
60227,443,25151,443,6553,871,5682,19,45,9,10,allow,1,0,Potential Threat
59605,445,0,0,66,66,0,1,0,1,0,drop,0,1,Known Attack
56532,445,0,0,70,70,0,1,0,1,0,drop,0,1,Known Attack
1176,64147,0,0,62,62,0,1,0,1,0,deny,1,1,High Risk
54999,445,0,0,70,70,0,1,0,1,0,drop,0,1,Known Attack
50116,22,50116,22,184,120,64,4,10,3,1,allow,0,0,Normal
56046,53,6511,53,193,102,91,2,31,1,1,allow,0,0,Normal
64013,57470,0,0,74,74,0,1,0,1,0,deny,1,1,High Risk
51283,445,0,0,70,70,0,1,0,1,0,drop,0,1,Known Attack
45205,443,55089,443,7221,3151,4070,20,162,9,11,allow,1,0,Potential Threat
60462,47967,0,0,148,148,0,1,0,1,0,deny,1,1,High Risk
52328,445,0,0,70,70,0,1,0,1,0,drop,0,1,Known Attack
64939,445,0,0,66,66,0,1,0,1,0,drop,0,1,Known Attack
63956,44512,0,0,145,145,0,1,0,1,0,deny,1,1,High Risk
57051,53,59033,53,711,87,624,2,30,1,1,allow,0,0,Normal
65119,53,47223,53,568,188,380,6,60,3,3,allow,1,0,Potential Threat
60141,30188,0,0,66,66,0,1,0,1,0,deny,0,1,Known Attack
46838,80,4801,80,70,70,0,1,120,1,0,allow,0,0,Normal
53000,80,5659,80,1991,686,1305,10,335,6,4,allow,1,0,Potential Threat
64722,443,16301,443,61890,2830,59060,73,120,27,46,allow,1,0,Potential Threat
10265,64147,0,0,66,66,0,1,0,1,0,deny,1,1,High Risk
50642,53,41798,53,165,86,79,2,30,1,1,allow,0,0,Normal
61860,10443,7961,10443,10811,2571,8240,27,48,15,12,allow,1,0,Potential Threat
58309,445,0,0,66,66,0,1,0,1,0,drop,0,1,Known Attack
57673,445,0,0,70,70,0,1,0,1,0,drop,0,1,Known Attack
51234,80,58624,80,6798,4486,2312,42,107,22,20,allow,1,0,Potential Threat
52131,443,17836,443,6565,1251,5314,27,31,14,13,allow,1,0,Potential Threat
37576,443,42873,443,499,425,74,4,0,3,1,allow,1,0,Potential Threat
63012,53,5232,53,304,86,218,2,30,1,1,allow,0,0,Normal
50131,445,0,0,70,70,0,1,0,1,0,drop,0,1,Known Attack
59210,8168,0,0,66,66,0,1,0,1,0,deny,0,1,Known Attack
443,56513,0,0,78,78,0,1,0,1,0,deny,1,1,High Risk
55799,445,0,0,70,70,0,1,0,1,0,drop,0,1,Known Attack
34981,80,29727,80,1658,1344,314,10,15,5,5,allow,1,0,Potential Threat
55547,445,0,0,70,70,0,1,0,1,0,drop,0,1,Known Attack
53298,26467,0,0,62,62,0,1,0,1,0,deny,0,1,Known Attack
48856,53,0,0,86,86,0,1,30,1,0,allow,0,0,Normal
62530,445,0,0,70,70,0,1,0,1,0,drop,0,1,Known Attack
26458,80,26458,80,490,264,226,8,32,5,3,allow,1,0,Potential Threat
64978,53,20864,53,198,102,96,2,30,1,1,allow,0,0,Normal
1024,48817,0,0,148,148,0,1,0,1,0,deny,1,1,High Risk
1594,44847,0,0,62,62,0,1,0,1,0,deny,1,1,High Risk
64721,53,12160,53,466,108,358,4,45,2,2,allow,0,0,Normal
30800,25174,0,0,146,146,0,1,0,1,0,deny,1,1,High Risk
59153,35440,0,0,62,62,0,1,0,1,0,deny,0,1,Known Attack
58959,53,45652,53,307,86,221,2,30,1,1,allow,0,0,Normal
55212,53733,0,0,66,66,0,1,0,1,0,deny,0,1,Known Attack
52348,80,52348,80,2910,1489,1421,10,16,6,4,allow,1,0,Potential Threat
0,0,0,0,98,98,0,1,0,1,0,deny,1,1,High Risk
57419,445,0,0,66,66,0,1,0,1,0,drop,0,1,Known Attack
65196,445,0,0,70,70,0,1,0,1,0,drop,0,1,Known Attack
22683,39210,0,0,60,60,0,1,0,1,0,deny,1,1,High Risk
64595,53,24899,53,167,86,81,2,29,1,1,allow,0,0,Normal
58780,443,38855,443,8661,1687,6974,30,244,16,14,allow,1,0,Potential Threat
56127,443,17365,443,6103,2710,3393,58,212,28,30,allow,1,0,Potential Threat
49380,21247,0,0,66,66,0,1,0,1,0,deny,0,1,Known Attack
41207,5900,0,0,60,60,0,1,0,1,0,deny,0,1,Known Attack
10126,57470,0,0,62,62,0,1,0,1,0,deny,1,1,High Risk
65089,53,20611,53,199,102,97,2,30,1,1,allow,0,0,Normal
64614,53,55255,53,168,86,82,2,30,1,1,allow,0,0,Normal
56295,443,26147,443,8550,1880,6670,22,376,12,10,allow,1,0,Potential Threat
56459,53,20811,53,209,110,99,2,30,1,1,allow,0,0,Normal
55626,53,3780,53,319,126,193,2,29,1,1,allow,0,0,Normal
56663,443,26937,443,1299,730,569,13,25,7,6,allow,0,0,Normal
51243,445,0,0,70,70,0,1,0,1,0,drop,0,1,Known Attack
57446,443,49278,443,9642,3343,6299,37,16,17,20,allow,1,0,Potential Threat
64899,53,16096,53,199,102,97,2,30,1,1,allow,0,0,Normal
64311,53,39516,53,199,102,97,2,30,1,1,allow,0,0,Normal
27005,27025,48292,27025,1774,252,1522,5,31,3,2,allow,1,0,Potential Threat
60222,445,0,0,70,70,0,1,0,1,0,drop,0,1,Known Attack
49886,445,0,0,70,70,0,1,0,1,0,drop,0,1,Known Attack
65317,51221,0,0,78,78,0,1,0,1,0,deny,1,1,High Risk
53927,37828,58314,37828,552,306,246,9,16,5,4,allow,1,0,Potential Threat
49817,445,0,0,70,70,0,1,0,1,0,drop,0,1,Known Attack
443,64347,0,0,131,131,0,1,0,1,0,deny,1,1,High Risk
57588,443,14769,443,7629,3270,4359,34,337,17,17,allow,1,0,Potential Threat
54138,445,0,0,66,66,0,1,0,1,0,drop,0,1,Known Attack
60120,445,0,0,66,66,0,1,0,1,0,drop,0,1,Known Attack
56799,443,34365,443,5057,880,4177,16,70,8,8,allow,1,0,Potential Threat
55838,443,50460,443,11446,4102,7344,32,20,16,16,allow,1,0,Potential Threat
35589,25174,0,0,66,66,0,1,0,1,0,deny,0,1,Known Attack
3818,37965,0,0,66,66,0,1,0,1,0,deny,1,1,High Risk
62320,445,0,0,70,70,0,1,0,1,0,drop,0,1,Known Attack
1038,37965,0,0,62,62,0,1,0,1,0,deny,1,1,High Risk
55705,53,9254,53,281,101,180,4,58,2,2,allow,0,0,Normal
25151,58833,0,0,62,62,0,1,0,1,0,deny,1,1,High Risk
64963,445,0,0,70,70,0,1,0,1,0,drop,0,1,Known Attack
51245,445,0,0,66,66,0,1,0,1,0,drop,0,1,Known Attack
56938,53,31467,53,452,101,351,4,36,2,2,allow,0,0,Normal
65461,53,60419,53,226,94,132,2,30,1,1,allow,0,0,Normal
58638,5900,0,0,62,62,0,1,0,1,0,deny,0,1,Known Attack
64073,53,37819,53,520,211,309,6,39,3,3,allow,1,0,Potential Threat
49931,25174,0,0,66,66,0,1,0,1,0,deny,0,1,Known Attack
49418,53,2882,53,165,86,79,2,30,1,1,allow,0,0,Normal
39945,443,42447,443,5446,805,4641,17,26,9,8,allow,1,0,Potential Threat
49473,80,51676,80,388,262,126,7,29,5,2,allow,0,0,Normal
58638,5900,0,0,62,62,0,1,0,1,0,deny,0,1,Known Attack
58528,445,0,0,66,66,0,1,0,1,0,drop,0,1,Known Attack
52158,3841,53385,3841,70,70,0,1,5,1,0,allow,1,0,Potential Threat
56970,443,2688,443,20635942,626393,20009549,21680,138,6969,14711,allow,1,0,Potential Threat
57470,6881,28610,6881,396,396,0,7,1200,7,0,allow,1,0,Potential Threat
58752,443,52846,443,5167,700,4467,16,15,7,9,allow,1,0,Potential Threat
25237,25174,0,0,62,62,0,1,0,1,0,deny,0,1,Known Attack
39297,443,49533,443,9320,3888,5432,21,119,10,11,allow,1,0,Potential Threat
56579,443,24024,443,23150,13858,9292,52,49,32,20,allow,1,0,Potential Threat
59865,445,0,0,66,66,0,1,0,1,0,drop,0,1,Known Attack
51275,10924,61359,10924,70,70,0,2,8,2,0,allow,1,0,Potential Threat
50208,1688,43148,1688,70,70,0,1,5,1,0,allow,0,0,Normal
60175,445,0,0,70,70,0,1,0,1,0,drop,0,1,Known Attack
50316,25604,0,0,62,62,0,1,0,1,0,deny,0,1,Known Attack
43671,37965,0,0,62,62,0,1,0,1,0,deny,0,1,Known Attack
49874,53,61806,53,165,86,79,2,29,1,1,allow,0,0,Normal
26900,27017,5951,27017,422,164,258,6,30,3,3,allow,1,0,Potential Threat
49175,53,18016,53,193,102,91,2,30,1,1,allow,0,0,Normal
57008,53,37986,53,255,110,145,2,30,1,1,allow,0,0,Normal
60527,35440,0,0,66,66,0,1,0,1,0,deny,0,1,Known Attack
56489,53,32825,53,178,94,84,2,30,1,1,allow,0,0,Normal
64117,445,0,0,70,70,0,1,0,1,0,drop,0,1,Known Attack
58497,39004,0,0,66,66,0,1,0,1,0,deny,0,1,Known Attack
65114,53,27541,53,196,102,94,2,31,1,1,allow,0,0,Normal
52928,443,12845,443,56910,3384,53526,85,115,33,52,allow,1,0,Potential Threat
24838,39828,0,0,60,60,0,1,0,1,0,deny,1,1,High Risk
63885,445,0,0,66,66,0,1,0,1,0,drop,0,1,Known Attack
27005,27015,5725,27015,876,126,750,2,30,1,1,allow,1,0,Potential Threat
52470,443,33189,443,7915,1213,6702,23,50,12,11,allow,1,0,Potential Threat
61423,443,8022,443,1113,589,524,12,28,6,6,allow,1,0,Potential Threat
62489,23117,0,0,62,62,0,1,0,1,0,deny,0,1,Known Attack
3272,1433,0,0,60,60,0,1,0,1,0,deny,1,1,High Risk
58772,443,9884,443,5106,700,4406,15,15,7,8,allow,1,0,Potential Threat
49622,50584,0,0,62,62,0,1,0,1,0,deny,0,1,Known Attack
50063,35776,0,0,148,148,0,1,0,1,0,deny,1,1,High Risk
41857,443,32439,443,1633,1010,623,14,2424,7,7,allow,1,0,Potential Threat
51732,54299,27558,54299,70,70,0,2,8,2,0,allow,1,0,Potential Threat
53575,1025,56604,1025,70,70,0,2,8,2,0,allow,0,0,Normal
52209,37241,61696,37241,136,136,0,3,14,3,0,allow,1,0,Potential Threat
53724,445,0,0,70,70,0,1,0,1,0,drop,0,1,Known Attack
37035,443,37035,443,4510,1603,2907,19,28,11,8,allow,1,0,Potential Threat
54382,53,54382,53,414,268,146,3,33,2,1,allow,0,0,Normal
50265,11035,48783,11035,132,132,0,3,1200,3,0,allow,1,0,Potential Threat
57702,53,57702,53,398,255,143,3,32,2,1,allow,0,0,Normal
62976,445,0,0,70,70,0,1,0,1,0,drop,0,1,Known Attack
56499,80,63072,80,277848,13775,264073,301,63,118,183,allow,1,0,Potential Threat
61355,443,38386,443,17666,3045,14621,52,213,21,31,allow,1,0,Potential Threat
64251,53,54906,53,451,118,333,2,30,1,1,allow,0,0,Normal
44847,6881,3655,6881,324,150,174,2,1201,1,1,allow,1,0,Potential Threat
52179,14354,22942,14354,70,70,0,1,5,1,0,allow,1,0,Potential Threat
55855,445,0,0,70,70,0,1,0,1,0,drop,0,1,Known Attack
53851,443,36931,443,11779,3603,8176,42,142,21,21,allow,1,0,Potential Threat
62101,445,0,0,70,70,0,1,0,1,0,drop,0,1,Known Attack
54444,443,16103,443,6275,3787,2488,17,147,8,9,allow,1,0,Potential Threat
38711,443,23557,443,459089,10521,448568,449,16,141,308,allow,1,0,Potential Threat
57094,53,10369,53,196,102,94,2,30,1,1,allow,0,0,Normal
62197,22114,0,0,66,66,0,1,0,1,0,deny,0,1,Known Attack
49930,53,51940,53,258,110,148,2,30,1,1,allow,0,0,Normal
59575,445,0,0,70,70,0,1,0,1,0,drop,0,1,Known Attack
64424,53,30245,53,211,102,109,2,30,1,1,allow,0,0,Normal
34076,53,22329,53,168,78,90,2,30,1,1,allow,0,0,Normal
40736,443,40736,443,4380,1473,2907,19,26,11,8,allow,1,0,Potential Threat
50515,80,58648,80,7871,1409,6462,17,75,7,10,allow,1,0,Potential Threat
64457,53,27221,53,261,102,159,2,30,1,1,allow,0,0,Normal
60870,53,30144,53,220,94,126,2,30,1,1,allow,0,0,Normal
52079,80,61511,80,366,240,126,7,25,5,2,allow,1,0,Potential Threat
54858,51505,0,0,66,66,0,1,0,1,0,deny,0,1,Known Attack
51930,57470,0,0,66,66,0,1,0,1,0,deny,0,1,Known Attack
49620,53,15285,53,211,110,101,2,30,1,1,allow,0,0,Normal
31609,26296,0,0,148,148,0,1,0,1,0,deny,1,1,High Risk
50548,443,50022,443,9277,2865,6412,31,200,18,13,allow,1,0,Potential Threat
58638,5900,0,0,62,62,0,1,0,1,0,deny,0,1,Known Attack
53408,50243,0,0,145,145,0,1,0,1,0,deny,1,1,High Risk
64559,53,6054,53,196,100,96,2,31,1,1,allow,0,0,Normal
43016,53,43016,53,235,90,145,2,32,1,1,allow,0,0,Normal
57585,51221,0,0,62,62,0,1,0,1,0,deny,0,1,Known Attack
54012,443,7741,443,4318,726,3592,14,16,7,7,allow,1,0,Potential Threat
57470,43576,31912,43576,545,166,379,2,1200,1,1,allow,1,0,Potential Threat
53177,443,2633,443,6512167,186944,6325223,6347,1216,2089,4258,allow,1,0,Potential Threat
50337,445,0,0,66,66,0,1,0,1,0,drop,0,1,Known Attack
51815,443,62038,443,9061,3443,5618,64,121,27,37,allow,1,0,Potential Threat
55818,445,0,0,70,70,0,1,0,1,0,drop,0,1,Known Attack
57853,64147,0,0,66,66,0,1,0,1,0,deny,1,1,High Risk
37981,80,45214,80,1572,755,817,11,15,6,5,allow,1,0,Potential Threat
16059,22114,0,0,146,146,0,1,0,1,0,deny,1,1,High Risk
53884,48754,60851,48754,70,70,0,2,7,2,0,allow,1,0,Potential Threat
3478,61463,0,0,933,933,0,1,0,1,0,deny,1,1,High Risk
49209,52030,40486,52030,70,70,0,2,8,2,0,allow,1,0,Potential Threat
50164,53,36057,53,260,86,174,2,29,1,1,allow,0,0,Normal
53776,445,0,0,70,70,0,1,0,1,0,drop,0,1,Known Attack
45981,51505,0,0,146,146,0,1,0,1,0,deny,1,1,High Risk
50514,445,0,0,70,70,0,1,0,1,0,drop,0,1,Known Attack
65074,53,29931,53,284,118,166,2,30,1,1,allow,0,0,Normal
48191,5223,34035,5223,4164,1264,2900,23,1140,13,10,allow,1,0,Potential Threat
60384,443,3369,443,4315,928,3387,16,15,10,6,allow,1,0,Potential Threat
59899,445,0,0,66,66,0,1,0,1,0,drop,0,1,Known Attack
54370,443,2250,443,11876,2769,9107,30,76,15,15,allow,1,0,Potential Threat
15922,44847,0,0,66,66,0,1,0,1,0,deny,1,1,High Risk
63583,37965,0,0,62,62,0,1,0,1,0,deny,0,1,Known Attack
49850,443,7446,443,147320,5771,141549,184,72,73,111,allow,1,0,Potential Threat
49734,53,34033,53,216,110,106,2,30,1,1,allow,0,0,Normal
65479,445,0,0,70,70,0,1,0,1,0,drop,0,1,Known Attack
64928,445,0,0,70,70,0,1,0,1,0,drop,0,1,Known Attack
64135,445,0,0,70,70,0,1,0,1,0,drop,0,1,Known Attack
51401,6881,0,0,62,62,0,1,0,1,0,deny,0,1,Known Attack
57987,3478,50170,3478,312,140,172,4,30,2,2,allow,1,0,Potential Threat
64937,53,12503,53,210,110,100,2,30,1,1,allow,0,0,Normal
27005,27019,44528,27019,880,126,754,2,30,1,1,allow,1,0,Potential Threat
55355,445,0,0,70,70,0,1,0,1,0,drop,0,1,Known Attack
45935,25,35960,25,511,191,320,9,60,4,5,allow,0,0,Normal
57294,443,36134,443,5614,733,4881,16,15,9,7,allow,0,0,Normal
25091,64147,0,0,66,66,0,1,0,1,0,deny,1,1,High Risk
46851,53,12035,53,168,78,90,2,30,1,1,allow,0,0,Normal
64642,53,40634,53,265,94,171,2,30,1,1,allow,0,0,Normal
64013,57470,0,0,74,74,0,1,0,1,0,deny,1,1,High Risk
3478,61463,0,0,1248,1248,0,1,0,1,0,deny,1,1,High Risk
63985,43081,42263,43081,66,66,0,2,7,2,0,allow,1,0,Potential Threat
54094,445,0,0,70,70,0,1,0,1,0,drop,0,1,Known Attack
6338,23117,0,0,66,66,0,1,0,1,0,deny,1,1,High Risk
6881,31026,35308,31026,509,150,359,2,1199,1,1,allow,1,0,Potential Threat
55645,18904,52547,18904,320,140,180,6,6,3,3,allow,1,0,Potential Threat
63116,22114,0,0,62,62,0,1,0,1,0,deny,0,1,Known Attack
38330,123,58815,123,184,94,90,2,30,1,1,allow,0,0,Normal
7377,57470,0,0,62,62,0,1,0,1,0,deny,1,1,High Risk
60793,53733,0,0,66,66,0,1,0,1,0,deny,1,1,High Risk
56851,445,0,0,70,70,0,1,0,1,0,drop,0,1,Known Attack
49628,53,48622,53,168,86,82,2,31,1,1,allow,0,0,Normal
53722,445,0,0,70,70,0,1,0,1,0,drop,0,1,Known Attack
50425,443,34304,443,5653,1079,4574,14,26,8,6,allow,1,0,Potential Threat
52712,80,52712,80,2012,1423,589,12,48,6,6,allow,0,0,Normal
32609,64097,0,0,66,66,0,1,0,1,0,deny,1,1,High Risk
60320,443,1355,443,4679,2232,2447,15,136,7,8,allow,1,0,Potential Threat
58638,5900,0,0,62,62,0,1,0,1,0,deny,0,1,Known Attack
12694,12446,0,0,62,62,0,1,0,1,0,deny,0,1,Known Attack
62455,443,9859,443,8302,2895,5407,22,25,11,11,allow,1,0,Potential Threat
27005,30008,41191,30008,881,126,755,2,31,1,1,allow,1,0,Potential Threat
56723,53,2628,53,733,85,648,2,31,1,1,allow,0,0,Normal
53692,16624,3177,16624,320,140,180,6,6,3,3,allow,1,0,Potential Threat
48230,22114,0,0,146,146,0,1,0,1,0,deny,1,1,High Risk
1156,53,45394,53,278,86,192,2,29,1,1,allow,1,0,Potential Threat
61419,443,15902,443,6661,862,5799,18,28,9,9,allow,1,0,Potential Threat
27005,27016,17329,27016,883,126,757,2,30,1,1,allow,1,0,Potential Threat
55684,53,0,0,219,86,133,2,29,1,1,allow,0,0,Normal
59030,445,0,0,70,70,0,1,0,1,0,drop,0,1,Known Attack
51688,445,0,0,70,70,0,1,0,1,0,drop,0,1,Known Attack
27005,27216,53096,27216,883,126,757,2,31,1,1,allow,1,0,Potential Threat
41813,8080,0,0,60,60,0,1,0,1,0,deny,0,1,Known Attack
49512,443,49512,443,217225,47956,169269,284,64,149,135,allow,1,0,Potential Threat
49648,7275,24792,7275,8962,1625,7337,28,16,15,13,allow,1,0,Potential Threat
35207,22114,0,0,62,62,0,1,0,1,0,deny,0,1,Known Attack
37314,80,28984,80,1348,844,504,13,255,8,5,allow,1,0,Potential Threat
57257,53,4922,53,173,94,79,2,30,1,1,allow,0,0,Normal
55593,53,39878,53,288,288,0,4,47,4,0,allow,0,0,Normal
49713,53,41539,53,233,94,139,2,30,1,1,allow,0,0,Normal
57615,80,57615,80,126266,7980,118286,126,25,37,89,allow,1,0,Potential Threat
55939,53,41055,53,177,94,83,2,30,1,1,allow,0,0,Normal
59705,445,0,0,70,70,0,1,0,1,0,drop,0,1,Known Attack
55376,53,17349,53,199,102,97,2,30,1,1,allow,0,0,Normal
60244,80,21449,80,1114,534,580,12,16,7,5,allow,1,0,Potential Threat
46975,443,49913,443,70,70,0,1,5,1,0,allow,0,0,Normal
49591,80,27431,80,314,128,186,6,27,3,3,allow,0,0,Normal
49879,443,31980,443,6121,1042,5079,21,53,11,10,allow,1,0,Potential Threat
52596,17372,0,0,66,66,0,1,0,1,0,deny,0,1,Known Attack
49888,53,58972,53,363,97,266,4,34,2,2,allow,0,0,Normal
51356,22114,0,0,66,66,0,1,0,1,0,deny,0,1,Known Attack
48830,5900,0,0,60,60,0,1,0,1,0,deny,0,1,Known Attack
39566,443,50145,443,9748,5209,4539,22,121,11,11,allow,1,0,Potential Threat
55469,53,16063,53,817,98,719,2,31,1,1,allow,0,0,Normal
53117,445,0,0,70,70,0,1,0,1,0,drop,0,1,Known Attack
65155,445,0,0,70,70,0,1,0,1,0,drop,0,1,Known Attack
58638,5900,0,0,62,62,0,1,0,1,0,deny,0,1,Known Attack
56787,53,13426,53,209,110,99,2,30,1,1,allow,0,0,Normal
53152,443,44569,443,16706,6162,10544,39,29,19,20,allow,1,0,Potential Threat
49791,443,35792,443,20149,14507,5642,40,355,24,16,allow,1,0,Potential Threat
49240,443,49240,443,8448,3368,5080,25,48,15,10,allow,1,0,Potential Threat
59993,443,5215,443,6452,2146,4306,30,125,14,16,allow,1,0,Potential Threat
5223,21557,0,0,60,60,0,1,0,1,0,deny,1,1,High Risk
51221,52423,24107,52423,322,149,173,2,1201,1,1,allow,1,0,Potential Threat
59189,53,53487,53,222,94,128,2,30,1,1,allow,0,0,Normal
57183,53,22943,53,178,94,84,2,29,1,1,allow,0,0,Normal
61985,445,0,0,70,70,0,1,0,1,0,drop,0,1,Known Attack
45657,443,4313,443,2553,1355,1198,22,77,13,9,allow,1,0,Potential Threat
52061,35717,8703,35717,70,70,0,2,8,2,0,allow,1,0,Potential Threat
62610,445,0,0,70,70,0,1,0,1,0,drop,0,1,Known Attack
58230,443,58230,443,4465,1558,2907,19,27,11,8,allow,1,0,Potential Threat
55190,53,7214,53,733,86,647,2,31,1,1,allow,0,0,Normal
65144,53,24637,53,210,110,100,2,30,1,1,allow,0,0,Normal
64745,3389,64745,3389,3413,1458,1955,16,18,8,8,allow,1,0,Potential Threat
52598,445,0,0,66,66,0,1,0,1,0,drop,0,1,Known Attack
49246,80,49246,80,133699,9415,124284,169,23,77,92,allow,1,0,Potential Threat
49747,445,0,0,70,70,0,1,0,1,0,drop,0,1,Known Attack
52202,64241,11975,64241,164,70,94,2,4,1,1,allow,1,0,Potential Threat
52212,80,6091,80,366,246,120,6,34,4,2,allow,0,0,Normal
62550,51505,0,0,66,66,0,1,0,1,0,deny,0,1,Known Attack
65049,53,4020,53,210,110,100,2,31,1,1,allow,0,0,Normal
56217,53,61344,53,183,94,89,2,31,1,1,allow,0,0,Normal
65211,445,0,0,70,70,0,1,0,1,0,drop,0,1,Known Attack
62432,445,0,0,70,70,0,1,0,1,0,drop,0,1,Known Attack
50535,80,27169,80,36985,3992,32993,56,151,25,31,allow,1,0,Potential Threat
46341,443,54451,443,9172,3518,5654,39,103,21,18,allow,1,0,Potential Threat
56660,53,55953,53,183,94,89,2,31,1,1,allow,0,0,Normal
61810,443,52096,443,3109,812,2297,13,136,6,7,allow,1,0,Potential Threat
55056,53,8605,53,170,87,83,2,30,1,1,allow,0,0,Normal
53928,15503,0,0,62,62,0,1,0,1,0,deny,0,1,Known Attack
52754,445,0,0,70,70,0,1,0,1,0,drop,0,1,Known Attack
63525,53,0,0,174,77,97,2,30,1,1,allow,0,0,Normal
56607,443,1098,443,7862,1873,5989,20,15,11,9,allow,1,0,Potential Threat
58802,443,8176,443,5167,700,4467,16,15,7,9,allow,1,0,Potential Threat
57132,53,39108,53,216,110,106,2,30,1,1,allow,0,0,Normal
56967,35440,0,0,66,66,0,1,0,1,0,deny,0,1,Known Attack
56658,53,56658,53,257,114,143,2,30,1,1,allow,0,0,Normal
55424,38303,0,0,66,66,0,1,0,1,0,deny,0,1,Known Attack
65424,53,5090,53,210,110,100,2,31,1,1,allow,0,0,Normal
59748,53,55446,53,230,110,120,2,29,1,1,allow,0,0,Normal
56224,445,0,0,70,70,0,1,0,1,0,drop,0,1,Known Attack
53270,445,0,0,70,70,0,1,0,1,0,drop,0,1,Known Attack
63676,445,0,0,70,70,0,1,0,1,0,drop,0,1,Known Attack
46576,23718,0,0,66,66,0,1,0,1,0,deny,0,1,Known Attack
57613,445,0,0,70,70,0,1,0,1,0,drop,0,1,Known Attack
49374,53,42809,53,197,94,103,2,30,1,1,allow,0,0,Normal
55538,445,0,0,70,70,0,1,0,1,0,drop,0,1,Known Attack
57094,53,18443,53,196,102,94,2,31,1,1,allow,0,0,Normal
1025,25174,0,0,62,62,0,1,0,1,0,deny,1,1,High Risk
55617,53,37518,53,194,102,92,2,31,1,1,allow,0,0,Normal
54157,445,0,0,70,70,0,1,0,1,0,drop,0,1,Known Attack
56004,445,0,0,66,66,0,1,0,1,0,drop,0,1,Known Attack
57578,80,57578,80,55886,2728,53158,68,148,25,43,allow,1,0,Potential Threat
53897,443,3893,443,10781,3635,7146,27,221,15,12,allow,1,0,Potential Threat
62859,35440,0,0,66,66,0,1,0,1,0,deny,0,1,Known Attack
49968,445,0,0,66,66,0,1,0,1,0,drop,0,1,Known Attack
50482,443,60480,443,7653,1188,6465,21,15,12,9,allow,1,0,Potential Threat
26900,27017,26989,27017,422,164,258,6,30,3,3,allow,1,0,Potential Threat
53774,443,4137,443,499,425,74,4,0,3,1,allow,0,0,Normal
22409,55442,0,0,74,74,0,1,0,1,0,deny,1,1,High Risk
50739,443,62875,443,6335,1376,4959,19,165,9,10,allow,1,0,Potential Threat
51566,443,47460,443,9451,3719,5732,45,76,25,20,allow,1,0,Potential Threat
63022,53,50452,53,384,166,218,2,29,1,1,allow,0,0,Normal
443,20995,0,0,83,83,0,1,0,1,0,deny,1,1,High Risk
47368,443,14689,443,7057,2186,4871,25,316,13,12,allow,1,0,Potential Threat
46404,53,18296,53,240,86,154,2,30,1,1,allow,0,0,Normal
37605,443,2336,443,573,425,148,5,0,3,2,allow,1,0,Potential Threat
51985,38904,1159,38904,70,70,0,1,5,1,0,allow,1,0,Potential Threat
64771,53,46292,53,793,101,692,2,30,1,1,allow,0,0,Normal
64788,53,47380,53,168,86,82,2,30,1,1,allow,0,0,Normal
33042,443,32323,443,130,70,60,2,14,1,1,allow,0,0,Normal
55583,445,0,0,66,66,0,1,0,1,0,drop,0,1,Known Attack
63970,28423,20673,28423,564,382,182,9,15,6,3,allow,1,0,Potential Threat
55843,445,0,0,70,70,0,1,0,1,0,drop,0,1,Known Attack
49575,80,43723,80,318,192,126,6,43,4,2,allow,0,0,Normal
52602,445,0,0,66,66,0,1,0,1,0,drop,0,1,Known Attack
50280,38558,0,0,62,62,0,1,0,1,0,deny,0,1,Known Attack
56830,53,56847,53,195,102,93,2,30,1,1,allow,0,0,Normal
56665,443,57309,443,1299,730,569,13,25,7,6,allow,1,0,Potential Threat
62030,53,0,0,229,85,144,2,31,1,1,allow,0,0,Normal
50344,445,0,0,70,70,0,1,0,1,0,drop,0,1,Known Attack
54549,445,0,0,66,66,0,1,0,1,0,drop,0,1,Known Attack
51967,12110,53548,12110,70,70,0,1,4,1,0,allow,1,0,Potential Threat
57169,53,55765,53,458,188,270,6,31,3,3,allow,0,0,Normal
56620,53,43601,53,762,98,664,2,30,1,1,allow,0,0,Normal
60947,445,0,0,70,70,0,1,0,1,0,drop,0,1,Known Attack
64244,53,64721,53,199,102,97,2,29,1,1,allow,1,0,Potential Threat
65486,53,8619,53,193,102,91,2,30,1,1,allow,0,0,Normal
65258,53,48935,53,193,102,91,2,30,1,1,allow,0,0,Normal
64477,3478,36622,3478,189,79,110,2,301,1,1,allow,1,0,Potential Threat
60168,35440,0,0,66,66,0,1,0,1,0,deny,0,1,Known Attack
53123,445,0,0,70,70,0,1,0,1,0,drop,0,1,Known Attack
58638,5900,0,0,62,62,0,1,0,1,0,deny,0,1,Known Attack
64095,443,64095,443,17046,2620,14426,42,159,19,23,allow,1,0,Potential Threat
59075,445,0,0,70,70,0,1,0,1,0,drop,0,1,Known Attack
50038,445,0,0,66,66,0,1,0,1,0,drop,0,1,Known Attack
64022,60918,60664,60918,70,70,0,1,4,1,0,allow,1,0,Potential Threat
55453,445,0,0,70,70,0,1,0,1,0,drop,0,1,Known Attack
55475,80,10225,80,350,210,140,6,27,4,2,allow,0,0,Normal
55516,445,0,0,70,70,0,1,0,1,0,drop,0,1,Known Attack
53513,56205,0,0,62,62,0,1,0,1,0,deny,0,1,Known Attack
5223,44091,0,0,220,220,0,1,0,1,0,deny,1,1,High Risk
51215,443,16837,443,11490,3671,7819,33,93,18,15,allow,1,0,Potential Threat
53589,3389,53589,3389,3407,1518,1889,16,16,9,7,allow,1,0,Potential Threat
61241,22114,0,0,66,66,0,1,0,1,0,deny,0,1,Known Attack
57343,53,26142,53,178,91,87,2,31,1,1,allow,0,0,Normal
64915,53,11027,53,177,94,83,2,30,1,1,allow,0,0,Normal
53870,24535,42849,24535,70,70,0,2,8,2,0,allow,1,0,Potential Threat
65111,53,19274,53,355,96,259,4,38,2,2,allow,0,0,Normal
56535,53,61823,53,200,94,106,2,30,1,1,allow,0,0,Normal
56297,53,12569,53,168,86,82,2,30,1,1,allow,0,0,Normal
41501,80,33952,80,306627,58973,247654,556,297,246,310,allow,1,0,Potential Threat
65185,27126,57830,27126,268,78,190,2,30,1,1,allow,1,0,Potential Threat
57131,31061,0,0,145,145,0,1,0,1,0,deny,1,1,High Risk
52843,445,0,0,70,70,0,1,0,1,0,drop,0,1,Known Attack
49927,80,35490,80,1126,609,517,11,15,6,5,allow,0,0,Normal
14397,37965,0,0,62,62,0,1,0,1,0,deny,1,1,High Risk
53215,445,0,0,70,70,0,1,0,1,0,drop,0,1,Known Attack
58369,445,0,0,66,66,0,1,0,1,0,drop,0,1,Known Attack
61635,37965,0,0,66,66,0,1,0,1,0,deny,0,1,Known Attack
55542,53,62446,53,177,94,83,2,30,1,1,allow,0,0,Normal
65530,53,21720,53,167,86,81,2,30,1,1,allow,0,0,Normal
9180,443,3139,443,5731,495,5236,14,15,7,7,allow,1,0,Potential Threat
49301,443,34200,443,7616,3064,4552,14,120,6,8,allow,1,0,Potential Threat
19245,64147,0,0,66,66,0,1,0,1,0,deny,1,1,High Risk
63618,445,0,0,70,70,0,1,0,1,0,drop,0,1,Known Attack
37889,53,32762,53,199,94,105,2,30,1,1,allow,0,0,Normal
55440,445,0,0,70,70,0,1,0,1,0,drop,0,1,Known Attack
51221,50861,60298,50861,490,149,341,2,1200,1,1,allow,1,0,Potential Threat
53670,32016,15201,32016,70,70,0,1,4,1,0,allow,1,0,Potential Threat
55627,53,32877,53,179,94,85,2,30,1,1,allow,0,0,Normal
49194,443,50497,443,159850,5338,154512,179,200,64,115,allow,1,0,Potential Threat
4438,23,0,0,60,60,0,1,0,1,0,deny,1,1,High Risk
6881,6881,0,0,62,62,0,1,0,1,0,deny,0,1,Known Attack
53033,445,0,0,66,66,0,1,0,1,0,drop,0,1,Known Attack
64403,53,23409,53,193,102,91,2,30,1,1,allow,0,0,Normal
56472,53,9100,53,166,85,81,2,31,1,1,allow,0,0,Normal
65109,53,18311,53,753,94,659,2,30,1,1,allow,0,0,Normal
48717,443,44246,443,232,172,60,3,5,2,1,allow,0,0,Normal
53073,32468,0,0,66,66,0,1,0,1,0,deny,0,1,Known Attack
50719,445,0,0,70,70,0,1,0,1,0,drop,0,1,Known Attack
60210,80,21481,80,5141,3706,1435,17,151,10,7,allow,1,0,Potential Threat
63873,44847,0,0,66,66,0,1,0,1,0,deny,1,1,High Risk
61461,445,0,0,70,70,0,1,0,1,0,drop,0,1,Known Attack
63742,445,0,0,70,70,0,1,0,1,0,drop,0,1,Known Attack
54118,443,28446,443,115373,6904,108469,171,117,87,84,allow,1,0,Potential Threat
26900,27017,63917,27017,422,164,258,6,30,3,3,allow,1,0,Potential Threat
63387,445,0,0,70,70,0,1,0,1,0,drop,0,1,Known Attack
52836,36829,0,0,66,66,0,1,0,1,0,deny,0,1,Known Attack
57031,443,21412,443,2963,797,2166,10,120,5,5,allow,1,0,Potential Threat
56138,53,42749,53,259,86,173,2,30,1,1,allow,0,0,Normal
52644,6881,4484,6881,719,413,306,10,14,5,5,allow,1,0,Potential Threat
31227,53,31227,53,407,261,146,3,32,2,1,allow,0,0,Normal
60270,443,24845,443,6155,1709,4446,29,1710,15,14,allow,1,0,Potential Threat
22452,443,22452,443,5785,2575,3210,24,76,14,10,allow,1,0,Potential Threat
48171,443,3704,443,10420,3506,6914,33,274,18,15,allow,1,0,Potential Threat
57099,445,0,0,70,70,0,1,0,1,0,drop,0,1,Known Attack
1646,23,0,0,60,60,0,1,0,1,0,deny,1,1,High Risk
55156,53,28197,53,256,87,169,4,36,2,2,allow,0,0,Normal
52808,57470,0,0,146,146,0,1,0,1,0,deny,1,1,High Risk
58511,53,45280,53,302,86,216,2,30,1,1,allow,0,0,Normal
38851,443,9016,443,5993,2348,3645,15,120,8,7,allow,1,0,Potential Threat
50914,51505,0,0,66,66,0,1,0,1,0,deny,0,1,Known Attack
65048,53,15306,53,297,96,201,4,42,2,2,allow,0,0,Normal
55520,445,0,0,70,70,0,1,0,1,0,drop,0,1,Known Attack
52472,51221,0,0,74,74,0,1,0,1,0,deny,0,1,Known Attack
49295,53,60133,53,194,102,92,2,32,1,1,allow,0,0,Normal
65325,53,48288,53,216,110,106,2,30,1,1,allow,0,0,Normal
50167,445,0,0,70,70,0,1,0,1,0,drop,0,1,Known Attack
50410,443,7615,443,14049,602,13447,19,35,6,13,allow,1,0,Potential Threat
50667,445,0,0,66,66,0,1,0,1,0,drop,0,1,Known Attack
11716,37965,0,0,62,62,0,1,0,1,0,deny,1,1,High Risk
42298,40019,18664,40019,597,79,518,2,31,1,1,allow,1,0,Potential Threat
49160,16767,65061,16767,854,150,704,4,1200,2,2,allow,1,0,Potential Threat
53751,445,0,0,70,70,0,1,0,1,0,drop,0,1,Known Attack
16387,35244,0,0,60,60,0,1,0,1,0,deny,1,1,High Risk
56256,80,30485,80,25043,1750,23293,44,30,23,21,allow,1,0,Potential Threat
62597,53,49610,53,306,306,0,4,47,4,0,allow,0,0,Normal
50938,53,64544,53,209,81,128,2,30,1,1,allow,1,0,Potential Threat
61768,445,0,0,66,66,0,1,0,1,0,drop,0,1,Known Attack
58484,445,0,0,66,66,0,1,0,1,0,drop,0,1,Known Attack
50481,443,48883,443,7653,1188,6465,21,15,12,9,allow,1,0,Potential Threat
65102,53,65408,53,183,94,89,2,30,1,1,allow,1,0,Potential Threat
61053,443,61053,443,40415,2911,37504,57,18,27,30,allow,1,0,Potential Threat
49946,443,3936,443,8725,3341,5384,25,136,12,13,allow,1,0,Potential Threat
41694,443,48276,443,16107,3200,12907,35,362,17,18,allow,1,0,Potential Threat
51917,26077,8998,26077,70,70,0,2,8,2,0,allow,1,0,Potential Threat
61231,443,59948,443,1864,250,1614,8,121,4,4,allow,1,0,Potential Threat
55867,53,51725,53,184,94,90,2,29,1,1,allow,0,0,Normal
55650,53,4298,53,179,94,85,2,29,1,1,allow,0,0,Normal
62005,80,62005,80,11822,1162,10660,22,20,11,11,allow,1,0,Potential Threat
54743,80,43064,80,6453,1316,5137,16,315,9,7,allow,1,0,Potential Threat
56467,80,52250,80,22601,1621,20980,35,142,18,17,allow,1,0,Potential Threat
55712,445,0,0,70,70,0,1,0,1,0,drop,0,1,Known Attack
64268,53,55887,53,679,179,500,6,69,3,3,allow,1,0,Potential Threat
49765,53,11309,53,194,102,92,2,30,1,1,allow,0,0,Normal
24662,26467,0,0,66,66,0,1,0,1,0,deny,0,1,Known Attack
58721,51505,0,0,66,66,0,1,0,1,0,deny,0,1,Known Attack
58681,36829,0,0,70,70,0,1,0,1,0,deny,0,1,Known Attack
65228,53,53617,53,212,86,126,2,30,1,1,allow,0,0,Normal
64661,445,0,0,66,66,0,1,0,1,0,drop,0,1,Known Attack
443,60496,0,0,320,320,0,1,0,1,0,deny,1,1,High Risk
55564,80,32717,80,944,529,415,11,315,6,5,allow,1,0,Potential Threat
61197,445,0,0,70,70,0,1,0,1,0,drop,0,1,Known Attack
55392,53,63211,53,418,94,324,2,30,1,1,allow,1,0,Potential Threat
39718,443,30883,443,10457,3150,7307,25,217,13,12,allow,1,0,Potential Threat
59753,443,43725,443,303,85,218,2,30,1,1,allow,0,0,Normal
49531,53,39343,53,289,94,195,4,31,2,2,allow,0,0,Normal
61898,445,0,0,70,70,0,1,0,1,0,drop,0,1,Known Attack
50329,443,35211,443,12026,3494,8532,28,82,14,14,allow,1,0,Potential Threat
57325,60043,0,0,62,62,0,1,0,1,0,deny,1,1,High Risk
60427,61137,3652,61137,70,70,0,2,8,2,0,allow,1,0,Potential Threat
19473,41049,5316,41049,149,149,0,1,1200,1,0,allow,1,0,Potential Threat
39484,80,6764,80,1403,651,752,10,16,6,4,allow,1,0,Potential Threat
60479,445,0,0,70,70,0,1,0,1,0,drop,0,1,Known Attack
15503,63425,41497,63425,481,150,331,2,1200,1,1,allow,1,0,Potential Threat
1114,46824,0,0,62,62,0,1,0,1,0,deny,1,1,High Risk
53079,80,59311,80,2424,1110,1314,11,78,7,4,allow,1,0,Potential Threat
65515,53,3298,53,210,110,100,2,30,1,1,allow,0,0,Normal
64698,53,59784,53,430,106,324,4,58,2,2,allow,1,0,Potential Threat
55997,445,0,0,66,66,0,1,0,1,0,drop,0,1,Known Attack
53060,1433,53060,1433,60,60,0,1,5,1,0,allow,0,0,Normal
65422,445,0,0,70,70,0,1,0,1,0,drop,0,1,Known Attack
51300,445,0,0,70,70,0,1,0,1,0,drop,0,1,Known Attack
53352,445,0,0,70,70,0,1,0,1,0,drop,0,1,Known Attack
65487,445,0,0,66,66,0,1,0,1,0,drop,0,1,Known Attack
52949,445,0,0,70,70,0,1,0,1,0,drop,0,1,Known Attack
59303,21247,0,0,62,62,0,1,0,1,0,deny,0,1,Known Attack
41650,443,33832,443,6356,1857,4499,48,229,20,28,allow,1,0,Potential Threat
17027,1,0,0,62,62,0,1,0,1,0,deny,0,1,Known Attack
50063,35776,0,0,148,148,0,1,0,1,0,deny,1,1,High Risk
51764,443,51764,443,4632,1725,2907,19,27,11,8,allow,1,0,Potential Threat
60375,80,60375,80,172473,8713,163760,205,33,91,114,allow,1,0,Potential Threat
59124,443,18887,443,9612,1720,7892,32,130,15,17,allow,1,0,Potential Threat
63962,53,53078,53,188,96,92,2,31,1,1,allow,0,0,Normal
13484,37965,0,0,66,66,0,1,0,1,0,deny,1,1,High Risk
46999,53,31962,53,168,78,90,2,30,1,1,allow,0,0,Normal
57585,51221,0,0,62,62,0,1,0,1,0,deny,0,1,Known Attack
58835,443,12321,443,9823,2600,7223,46,195,23,23,allow,1,0,Potential Threat
58922,57470,0,0,66,66,0,1,0,1,0,deny,1,1,High Risk
55809,445,0,0,66,66,0,1,0,1,0,drop,0,1,Known Attack
52470,445,0,0,66,66,0,1,0,1,0,drop,0,1,Known Attack
26699,35253,0,0,62,62,0,1,0,1,0,deny,0,1,Known Attack
63840,36829,0,0,62,62,0,1,0,1,0,deny,0,1,Known Attack
51887,445,0,0,66,66,0,1,0,1,0,drop,0,1,Known Attack
56525,443,34500,443,5022,973,4049,17,60,9,8,allow,1,0,Potential Threat
62799,25174,0,0,62,62,0,1,0,1,0,deny,0,1,Known Attack
49512,80,18348,80,2225,1649,576,10,38,6,4,allow,0,0,Normal
65069,445,0,0,66,66,0,1,0,1,0,drop,0,1,Known Attack
51761,19136,54705,19136,70,70,0,2,8,2,0,allow,1,0,Potential Threat
51221,20864,10145,20864,7308,6812,496,71,3243,63,8,allow,1,0,Potential Threat
39980,443,30240,443,2674,1386,1288,17,120,8,9,allow,1,0,Potential Threat
64414,53,2206,53,183,94,89,2,30,1,1,allow,0,0,Normal
45275,443,51304,443,9908271,123308,9784963,8531,359,1708,6823,allow,1,0,Potential Threat
51203,445,0,0,70,70,0,1,0,1,0,drop,0,1,Known Attack
50625,443,48490,443,3090,1707,1383,15,19,9,6,allow,1,0,Potential Threat
49526,53,35749,53,272,97,175,4,58,2,2,allow,0,0,Normal
64742,53,28467,53,173,94,79,2,29,1,1,allow,0,0,Normal
58504,445,0,0,66,66,0,1,0,1,0,drop,0,1,Known Attack
58250,35440,0,0,66,66,0,1,0,1,0,deny,0,1,Known Attack
60393,443,18640,443,3371,2029,1342,16,360,8,8,allow,1,0,Potential Threat
55788,445,0,0,70,70,0,1,0,1,0,drop,0,1,Known Attack
53880,61393,8542,61393,320,140,180,6,6,3,3,allow,1,0,Potential Threat
50703,80,3596,80,54304,27807,26497,227,175,113,114,allow,1,0,Potential Threat
62217,37807,0,0,66,66,0,1,0,1,0,deny,0,1,Known Attack
46285,443,47233,443,40877,5947,34930,81,56,39,42,allow,1,0,Potential Threat
63915,445,0,0,70,70,0,1,0,1,0,drop,0,1,Known Attack
57001,445,0,0,70,70,0,1,0,1,0,drop,0,1,Known Attack
56810,53,20653,53,438,180,258,6,30,3,3,allow,0,0,Normal
49887,443,18602,443,977,590,387,10,87,6,4,allow,0,0,Normal
10151,53,10151,53,220,90,130,2,30,1,1,allow,1,0,Potential Threat
50502,80,37094,80,318,192,126,6,25,4,2,allow,0,0,Normal
57891,80,37829,80,6518,1210,5308,15,24,8,7,allow,1,0,Potential Threat
55841,443,33701,443,9333,2019,7314,41,255,19,22,allow,1,0,Potential Threat
64294,64147,0,0,62,62,0,1,0,1,0,deny,1,1,High Risk
58923,445,0,0,66,66,0,1,0,1,0,drop,0,1,Known Attack
65267,445,0,0,66,66,0,1,0,1,0,drop,0,1,Known Attack
49903,445,0,0,70,70,0,1,0,1,0,drop,0,1,Known Attack
60168,35440,0,0,66,66,0,1,0,1,0,deny,0,1,Known Attack
2427,25174,0,0,146,146,0,1,0,1,0,deny,1,1,High Risk
55836,443,16714,443,3538,2015,1523,28,323,14,14,allow,1,0,Potential Threat
30782,36237,0,0,62,62,0,1,0,1,0,deny,0,1,Known Attack
56765,1841,2876,1841,70,70,0,1,5,1,0,allow,0,0,Normal
62184,445,0,0,70,70,0,1,0,1,0,drop,0,1,Known Attack
443,18411,0,0,74,74,0,1,0,1,0,deny,1,1,High Risk
50912,445,0,0,70,70,0,1,0,1,0,drop,0,1,Known Attack
15450,53,15450,53,216,82,134,2,33,1,1,allow,0,0,Normal
55656,31165,21172,31165,70,70,0,2,8,2,0,allow,1,0,Potential Threat
58638,5900,0,0,62,62,0,1,0,1,0,deny,0,1,Known Attack
26821,57866,0,0,62,62,0,1,0,1,0,deny,1,1,High Risk
11754,25174,0,0,62,62,0,1,0,1,0,deny,0,1,Known Attack
8889,29421,0,0,60,60,0,1,0,1,0,deny,1,1,High Risk
50116,443,45796,443,48255,4798,43457,100,149,47,53,allow,1,0,Potential Threat
58627,64097,0,0,62,62,0,1,0,1,0,deny,1,1,High Risk
49467,53,63815,53,811,94,717,2,30,1,1,allow,1,0,Potential Threat
50840,57470,0,0,66,66,0,1,0,1,0,deny,0,1,Known Attack
36013,53,23635,53,86,86,0,1,30,1,0,allow,0,0,Normal
64520,53,48129,53,198,102,96,2,30,1,1,allow,0,0,Normal
8282,25916,26002,25916,133,64,69,3,33,2,1,allow,1,0,Potential Threat
56467,445,0,0,70,70,0,1,0,1,0,drop,0,1,Known Attack
50335,80,17897,80,3855,828,3027,11,15,5,6,allow,1,0,Potential Threat
48440,443,28168,443,6945,1551,5394,25,200,12,13,allow,1,0,Potential Threat
60378,443,38205,443,130,70,60,2,15,1,1,allow,0,0,Normal
43611,32480,0,0,109,109,0,1,0,1,0,deny,1,1,High Risk
64883,445,0,0,70,70,0,1,0,1,0,drop,0,1,Known Attack
35261,15503,0,0,74,74,0,1,0,1,0,deny,0,1,Known Attack
45713,53,45713,53,217,87,130,2,30,1,1,allow,0,0,Normal
25237,25174,0,0,146,146,0,1,0,1,0,deny,1,1,High Risk
49945,53,62137,53,198,102,96,2,30,1,1,allow,0,0,Normal
1024,62609,0,0,148,148,0,1,0,1,0,deny,1,1,High Risk
9836,22114,0,0,62,62,0,1,0,1,0,deny,0,1,Known Attack
65354,53,6099,53,168,86,82,2,31,1,1,allow,0,0,Normal
54991,53,33819,53,177,94,83,2,30,1,1,allow,0,0,Normal
27402,37628,0,0,62,62,0,1,0,1,0,deny,1,1,High Risk
62690,445,0,0,66,66,0,1,0,1,0,drop,0,1,Known Attack
57447,443,62052,443,7847,1377,6470,27,15,12,15,allow,1,0,Potential Threat
55938,445,0,0,70,70,0,1,0,1,0,drop,0,1,Known Attack
38633,443,38633,443,4378,1471,2907,19,29,11,8,allow,1,0,Potential Threat
53003,11392,0,0,66,66,0,1,0,1,0,deny,0,1,Known Attack
55707,26816,41675,26816,320,140,180,6,6,3,3,allow,1,0,Potential Threat
49514,52255,0,0,162,162,0,1,0,1,0,deny,1,1,High Risk
50595,443,32592,443,8981,4625,4356,22,135,11,11,allow,1,0,Potential Threat
49547,443,61463,443,7817,1780,6037,26,172,13,13,allow,1,0,Potential Threat
64220,53,21263,53,265,110,155,2,30,1,1,allow,0,0,Normal
46409,35440,0,0,66,66,0,1,0,1,0,deny,0,1,Known Attack
50619,53,43137,53,815,95,720,2,30,1,1,allow,0,0,Normal
52963,80,22153,80,1600,581,1019,10,15,6,4,allow,0,0,Normal
45239,443,9489,443,11147,3412,7735,36,458,20,16,allow,1,0,Potential Threat
30188,14038,49780,14038,502,150,352,2,1200,1,1,allow,1,0,Potential Threat
52231,445,0,0,66,66,0,1,0,1,0,drop,0,1,Known Attack
56677,53,50989,53,286,103,183,4,49,2,2,allow,0,0,Normal
57226,51505,0,0,66,66,0,1,0,1,0,deny,0,1,Known Attack
55520,445,0,0,70,70,0,1,0,1,0,drop,0,1,Known Attack
33845,443,64577,443,6495,1547,4948,19,318,10,9,allow,1,0,Potential Threat
60025,445,0,0,70,70,0,1,0,1,0,drop,0,1,Known Attack
23578,2323,0,0,60,60,0,1,0,1,0,deny,0,1,Known Attack
64366,445,0,0,66,66,0,1,0,1,0,drop,0,1,Known Attack
40159,443,53282,443,5360,4048,1312,22,265,11,11,allow,1,0,Potential Threat
59984,443,19518,443,1527,940,587,14,21,8,6,allow,1,0,Potential Threat
63166,443,63166,443,5407,2160,3247,22,38,13,9,allow,1,0,Potential Threat
50822,445,0,0,70,70,0,1,0,1,0,drop,0,1,Known Attack
61307,445,0,0,70,70,0,1,0,1,0,drop,0,1,Known Attack
56163,53,47774,53,194,102,92,2,30,1,1,allow,0,0,Normal
64921,53,46383,53,238,102,136,2,31,1,1,allow,0,0,Normal
56103,21247,0,0,66,66,0,1,0,1,0,deny,0,1,Known Attack
55585,445,0,0,70,70,0,1,0,1,0,drop,0,1,Known Attack
64020,53,46952,53,302,118,184,2,29,1,1,allow,0,0,Normal
64089,20260,49392,20260,66,66,0,1,5,1,0,allow,1,0,Potential Threat
33473,443,49097,443,146684,25233,121451,183,189,75,108,allow,1,0,Potential Threat
65191,53,55910,53,294,102,192,2,30,1,1,allow,0,0,Normal
55542,53,10496,53,177,94,83,2,29,1,1,allow,0,0,Normal
55649,42266,41427,42266,70,70,0,2,8,2,0,allow,1,0,Potential Threat
57204,53,62842,53,195,102,93,2,29,1,1,allow,1,0,Potential Threat
50522,443,12346,443,13347,4662,8685,40,202,24,16,allow,1,0,Potential Threat
58259,53,21594,53,578,286,292,9,15,5,4,allow,0,0,Normal
55417,53,14562,53,199,102,97,2,30,1,1,allow,0,0,Normal
56869,17637,0,0,66,66,0,1,0,1,0,deny,0,1,Known Attack
49248,53,1565,53,301,90,211,4,46,2,2,allow,0,0,Normal
49001,48817,0,0,160,160,0,1,0,1,0,deny,1,1,High Risk
65422,53,59464,53,208,94,114,2,30,1,1,allow,0,0,Normal
42971,3478,30766,3478,312,140,172,4,30,2,2,allow,0,0,Normal
49696,445,0,0,66,66,0,1,0,1,0,drop,0,1,Known Attack
26900,27017,65080,27017,422,164,258,6,30,3,3,allow,1,0,Potential Threat
56833,23117,0,0,62,62,0,1,0,1,0,deny,0,1,Known Attack
50685,80,30111,80,60374,30984,29390,250,175,123,127,allow,1,0,Potential Threat
56827,53,30639,53,195,102,93,2,29,1,1,allow,0,0,Normal
54542,25604,0,0,62,62,0,1,0,1,0,deny,0,1,Known Attack
57107,64147,0,0,66,66,0,1,0,1,0,deny,1,1,High Risk
57417,445,0,0,66,66,0,1,0,1,0,drop,0,1,Known Attack
63503,42707,0,0,66,66,0,1,0,1,0,deny,0,1,Known Attack
65144,53,2841,53,210,110,100,2,29,1,1,allow,0,0,Normal
58638,5900,0,0,62,62,0,1,0,1,0,deny,0,1,Known Attack
53971,18810,62225,18810,70,70,0,2,8,2,0,allow,1,0,Potential Threat
443,32698,0,0,89,89,0,1,0,1,0,deny,1,1,High Risk
34687,443,63653,443,3120,1862,1258,18,15,11,7,allow,1,0,Potential Threat
26451,80,26451,80,642,338,304,10,32,6,4,allow,1,0,Potential Threat
31627,64147,0,0,62,62,0,1,0,1,0,deny,1,1,High Risk
51806,443,51806,443,1466,856,610,13,27,6,7,allow,1,0,Potential Threat
60373,445,0,0,66,66,0,1,0,1,0,drop,0,1,Known Attack
34553,48637,0,0,60,60,0,1,0,1,0,deny,0,1,Known Attack
50929,445,0,0,66,66,0,1,0,1,0,drop,0,1,Known Attack
41039,443,10141,443,1053,566,487,10,31,6,4,allow,1,0,Potential Threat
55432,443,59316,443,256189,15094,241095,316,122,120,196,allow,1,0,Potential Threat
59905,443,11259,443,343,163,180,6,15,3,3,allow,0,0,Normal
50100,53,47683,53,216,110,106,2,30,1,1,allow,0,0,Normal
4545,1900,0,0,136,136,0,1,0,1,0,deny,1,1,High Risk
35405,53,35405,53,217,87,130,2,30,1,1,allow,0,0,Normal
65524,53,59878,53,183,94,89,2,30,1,1,allow,0,0,Normal
53011,80,53011,80,349769,6527,343242,368,22,100,268,allow,1,0,Potential Threat
63380,23,0,0,60,60,0,1,0,1,0,deny,0,1,Known Attack
65189,27202,50060,27202,230,78,152,2,29,1,1,allow,1,0,Potential Threat
50336,445,0,0,70,70,0,1,0,1,0,drop,0,1,Known Attack
50661,443,13443,443,298067,6719,291348,307,17,98,209,allow,1,0,Potential Threat
64249,53,29634,53,178,91,87,2,30,1,1,allow,0,0,Normal
52846,445,0,0,70,70,0,1,0,1,0,drop,0,1,Known Attack
60251,445,0,0,70,70,0,1,0,1,0,drop,0,1,Known Attack
57895,443,60971,443,10639,4680,5959,53,176,24,29,allow,1,0,Potential Threat
58746,443,54765,443,5107,700,4407,15,15,7,8,allow,1,0,Potential Threat
58901,445,0,0,70,70,0,1,0,1,0,drop,0,1,Known Attack
54689,445,0,0,70,70,0,1,0,1,0,drop,0,1,Known Attack
64204,53,27061,53,264,102,162,2,31,1,1,allow,0,0,Normal
27005,27057,9296,27057,917,126,791,2,31,1,1,allow,1,0,Potential Threat
57293,25174,0,0,146,146,0,1,0,1,0,deny,1,1,High Risk
58259,445,0,0,70,70,0,1,0,1,0,drop,0,1,Known Attack
6712,123,0,0,90,90,0,1,0,1,0,deny,0,1,Known Attack
41816,443,14209,443,88503,3914,84589,114,80,44,70,allow,1,0,Potential Threat
56912,53,5094,53,199,102,97,2,29,1,1,allow,0,0,Normal
33627,36237,0,0,66,66,0,1,0,1,0,deny,0,1,Known Attack
59364,44847,0,0,66,66,0,1,0,1,0,deny,0,1,Known Attack
64530,53,49179,53,782,105,677,2,30,1,1,allow,0,0,Normal
63944,30188,0,0,62,62,0,1,0,1,0,deny,0,1,Known Attack
57131,35776,0,0,145,145,0,1,0,1,0,deny,1,1,High Risk
13462,35440,0,0,66,66,0,1,0,1,0,deny,1,1,High Risk
51064,5529,0,0,146,146,0,1,0,1,0,deny,0,1,Known Attack
51026,37450,0,0,66,66,0,1,0,1,0,deny,0,1,Known Attack
49326,53,56279,53,765,102,663,2,30,1,1,allow,0,0,Normal
53853,53,0,0,139,70,69,2,30,1,1,allow,0,0,Normal
48706,23393,0,0,60,60,0,1,0,1,0,deny,0,1,Known Attack
56652,445,0,0,70,70,0,1,0,1,0,drop,0,1,Known Attack
55123,53,57840,53,198,102,96,2,31,1,1,allow,0,0,Normal
54227,443,59982,443,499,425,74,4,0,3,1,allow,1,0,Potential Threat
40512,57470,0,0,74,74,0,1,0,1,0,deny,1,1,High Risk
64288,53,49667,53,183,94,89,2,29,1,1,allow,0,0,Normal
55179,53,34684,53,182,93,89,2,31,1,1,allow,0,0,Normal
65201,53,5294,53,216,110,106,2,30,1,1,allow,0,0,Normal
57066,53,30352,53,197,94,103,2,30,1,1,allow,0,0,Normal
59023,64097,0,0,66,66,0,1,0,1,0,deny,1,1,High Risk
64813,16385,22226,16385,432,192,240,8,30,4,4,allow,1,0,Potential Threat
50477,80,59736,80,648,256,392,8,25,5,3,allow,0,0,Normal
50367,445,0,0,66,66,0,1,0,1,0,drop,0,1,Known Attack
16387,16862,0,0,60,60,0,1,0,1,0,deny,0,1,Known Attack
30697,57866,0,0,62,62,0,1,0,1,0,deny,1,1,High Risk
61143,445,0,0,66,66,0,1,0,1,0,drop,0,1,Known Attack
55745,53,56029,53,199,102,97,2,30,1,1,allow,0,0,Normal
55372,53,64639,53,271,93,178,4,43,2,2,allow,1,0,Potential Threat
62431,445,0,0,70,70,0,1,0,1,0,drop,0,1,Known Attack
63072,443,30970,443,304,86,218,2,30,1,1,allow,0,0,Normal
62392,445,0,0,70,70,0,1,0,1,0,drop,0,1,Known Attack
51757,54657,24157,54657,66,66,0,1,5,1,0,allow,1,0,Potential Threat
60467,51095,40128,51095,320,140,180,6,7,3,3,allow,1,0,Potential Threat
55667,19667,61736,19667,70,70,0,1,5,1,0,allow,1,0,Potential Threat
56822,53,57328,53,184,94,90,2,29,1,1,allow,0,0,Normal
63943,445,0,0,70,70,0,1,0,1,0,drop,0,1,Known Attack
55503,53,44075,53,216,110,106,2,30,1,1,allow,0,0,Normal
10333,22114,0,0,62,62,0,1,0,1,0,deny,0,1,Known Attack
37316,443,11978,443,19840,6479,13361,57,127,32,25,allow,1,0,Potential Threat
55051,53,44193,53,167,86,81,2,31,1,1,allow,0,0,Normal
49578,443,49511,443,6947,833,6114,20,54,9,11,allow,1,0,Potential Threat
52839,443,27104,443,11808,5409,6399,73,123,33,40,allow,1,0,Potential Threat
56198,53,28713,53,184,102,82,2,30,1,1,allow,0,0,Normal
56697,445,0,0,70,70,0,1,0,1,0,drop,0,1,Known Attack
55830,53,20748,53,177,94,83,2,30,1,1,allow,0,0,Normal
62620,3389,62620,3389,4410,2321,2089,22,18,12,10,allow,1,0,Potential Threat
53017,80,55649,80,1658,1344,314,10,15,5,5,allow,1,0,Potential Threat
56056,53,42855,53,164,86,78,2,29,1,1,allow,0,0,Normal
62930,21247,0,0,66,66,0,1,0,1,0,deny,0,1,Known Attack
54420,445,0,0,66,66,0,1,0,1,0,drop,0,1,Known Attack
53272,80,30742,80,11060,3925,7135,24,108,13,11,allow,1,0,Potential Threat
59658,443,33900,443,5433,925,4508,19,360,10,9,allow,1,0,Potential Threat
55413,37965,0,0,66,66,0,1,0,1,0,deny,0,1,Known Attack
7226,50584,0,0,146,146,0,1,0,1,0,deny,1,1,High Risk
57470,32177,25835,32177,480,149,331,2,1200,1,1,allow,1,0,Potential Threat
60901,443,60901,443,24367,4634,19733,52,49,26,26,allow,1,0,Potential Threat
53235,443,53235,443,1270,697,573,15,33,8,7,allow,1,0,Potential Threat
52471,445,0,0,66,66,0,1,0,1,0,drop,0,1,Known Attack
64172,445,0,0,66,66,0,1,0,1,0,drop,0,1,Known Attack
32770,51505,0,0,62,62,0,1,0,1,0,deny,1,1,High Risk
56098,64147,0,0,66,66,0,1,0,1,0,deny,1,1,High Risk
63690,445,0,0,70,70,0,1,0,1,0,drop,0,1,Known Attack
57761,15503,0,0,66,66,0,1,0,1,0,deny,0,1,Known Attack
50400,53,9416,53,177,94,83,2,30,1,1,allow,0,0,Normal
9170,80,30007,80,318,192,126,6,29,4,2,allow,1,0,Potential Threat
10151,11888,57602,11888,491,150,341,2,1200,1,1,allow,1,0,Potential Threat
56751,445,0,0,70,70,0,1,0,1,0,drop,0,1,Known Attack
49719,443,56556,443,560073,155518,404555,923,110,411,512,allow,1,0,Potential Threat
3591,53,3591,53,235,90,145,2,32,1,1,allow,1,0,Potential Threat
58549,445,0,0,70,70,0,1,0,1,0,drop,0,1,Known Attack
59658,443,21276,443,6695,1617,5078,23,200,13,10,allow,1,0,Potential Threat
64829,53,40836,53,213,102,111,2,30,1,1,allow,0,0,Normal
49282,53,18906,53,197,94,103,2,30,1,1,allow,0,0,Normal
2267,53,1779,53,204,118,86,2,31,1,1,allow,1,0,Potential Threat
51825,25501,31893,25501,66,66,0,1,5,1,0,allow,1,0,Potential Threat
37965,6881,16163,6881,452,248,204,4,1199,2,2,allow,1,0,Potential Threat
7928,80,7928,80,25909,3016,22893,40,83,15,25,allow,1,0,Potential Threat
54962,53,47568,53,241,102,139,2,31,1,1,allow,0,0,Normal
58026,445,0,0,66,66,0,1,0,1,0,drop,0,1,Known Attack
28378,56205,0,0,146,146,0,1,0,1,0,deny,1,1,High Risk
61278,56205,0,0,66,66,0,1,0,1,0,deny,1,1,High Risk
51300,64147,0,0,62,62,0,1,0,1,0,deny,1,1,High Risk
53146,50393,21783,50393,70,70,0,2,8,2,0,allow,1,0,Potential Threat
16387,26193,0,0,60,60,0,1,0,1,0,deny,0,1,Known Attack
57192,53,38984,53,177,94,83,2,30,1,1,allow,0,0,Normal
51880,18468,34831,18468,70,70,0,1,5,1,0,allow,1,0,Potential Threat
54423,21247,0,0,62,62,0,1,0,1,0,deny,0,1,Known Attack
38405,443,30504,443,9876,1976,7900,27,27,13,14,allow,1,0,Potential Threat
49415,53,62672,53,194,102,92,2,30,1,1,allow,0,0,Normal
54652,445,0,0,66,66,0,1,0,1,0,drop,0,1,Known Attack
55372,53,55372,53,216,90,126,2,30,1,1,allow,0,0,Normal
63775,445,0,0,70,70,0,1,0,1,0,drop,0,1,Known Attack
52210,80,30096,80,372,246,126,6,30,4,2,allow,0,0,Normal
56609,443,13546,443,11061,1566,9495,25,19,13,12,allow,1,0,Potential Threat
50158,53,45524,53,758,96,662,2,30,1,1,allow,0,0,Normal
40103,443,24820,443,161,101,60,2,5,1,1,allow,0,0,Normal
64093,53,55556,53,213,94,119,2,30,1,1,allow,0,0,Normal
42241,11392,0,0,62,62,0,1,0,1,0,deny,0,1,Known Attack
52405,443,59113,443,10506,2063,8443,31,46,17,14,allow,1,0,Potential Threat
57442,66,38674,66,70,70,0,1,5,1,0,allow,0,0,Normal
62492,445,0,0,66,66,0,1,0,1,0,drop,0,1,Known Attack
53762,443,60750,443,499,425,74,4,0,3,1,allow,1,0,Potential Threat
58764,443,5482,443,21960,14378,7582,49,18,26,23,allow,1,0,Potential Threat
65172,53,3984,53,211,102,109,2,30,1,1,allow,0,0,Normal
9755,53,9755,53,244,98,146,2,33,1,1,allow,1,0,Potential Threat
65515,53,35838,53,718,94,624,2,30,1,1,allow,0,0,Normal
40705,443,7502,443,5721,3240,2481,35,147,14,21,allow,1,0,Potential Threat
56830,53,35063,53,752,93,659,2,30,1,1,allow,0,0,Normal
80,37649,0,0,60,60,0,1,0,1,0,deny,1,1,High Risk
54141,445,0,0,70,70,0,1,0,1,0,drop,0,1,Known Attack
48817,6884,48817,6884,328,152,176,2,1200,1,1,allow,1,0,Potential Threat
54854,19847,0,0,66,66,0,1,0,1,0,deny,0,1,Known Attack
1045,36237,0,0,66,66,0,1,0,1,0,deny,1,1,High Risk
51885,445,0,0,70,70,0,1,0,1,0,drop,0,1,Known Attack
57964,445,0,0,70,70,0,1,0,1,0,drop,0,1,Known Attack
52097,80,35130,80,1621,896,725,11,19,7,4,allow,0,0,Normal
49744,445,0,0,70,70,0,1,0,1,0,drop,0,1,Known Attack
51571,443,51571,443,1724,916,808,17,128,7,10,allow,1,0,Potential Threat
62092,35440,0,0,66,66,0,1,0,1,0,deny,0,1,Known Attack
52435,445,0,0,70,70,0,1,0,1,0,drop,0,1,Known Attack
42165,443,38543,443,7583,607,6976,18,119,7,11,allow,1,0,Potential Threat
53453,443,33620,443,17494,6818,10676,46,46,25,21,allow,1,0,Potential Threat
50573,445,0,0,70,70,0,1,0,1,0,drop,0,1,Known Attack
36337,443,41043,443,3781,1917,1864,23,396,7,16,allow,1,0,Potential Threat
55867,53,49859,53,178,94,84,2,29,1,1,allow,0,0,Normal
56962,445,0,0,70,70,0,1,0,1,0,drop,0,1,Known Attack
60944,443,23317,443,8264,4269,3995,17,31,9,8,allow,1,0,Potential Threat
50716,50584,0,0,70,70,0,1,0,1,0,deny,0,1,Known Attack
52036,52608,31210,52608,70,70,0,1,4,1,0,allow,1,0,Potential Threat
52182,60769,63523,60769,70,70,0,2,8,2,0,allow,1,0,Potential Threat
55932,53,3248,53,209,110,99,2,30,1,1,allow,0,0,Normal
59254,443,5881,443,8332,1024,7308,21,25,11,10,allow,1,0,Potential Threat
51948,17372,0,0,62,62,0,1,0,1,0,deny,0,1,Known Attack
61719,80,27024,80,32457,1499,30958,42,50,16,26,allow,1,0,Potential Threat
59068,443,48115,443,11182,6150,5032,65,1775,41,24,allow,1,0,Potential Threat
9440,443,42891,443,7573,1528,6045,22,33,11,11,allow,1,0,Potential Threat
64628,53,28992,53,199,102,97,2,30,1,1,allow,0,0,Normal
53085,445,0,0,70,70,0,1,0,1,0,drop,0,1,Known Attack
47207,443,60906,443,11085,2554,8531,48,19,24,24,allow,1,0,Potential Threat
56113,443,21683,443,103486,7416,96070,161,42,82,79,allow,1,0,Potential Threat
49548,53,2066,53,263,102,161,2,29,1,1,allow,0,0,Normal
62005,445,0,0,70,70,0,1,0,1,0,drop,0,1,Known Attack
57470,23848,47855,23848,545,166,379,2,1199,1,1,allow,1,0,Potential Threat
65002,27064,63916,27064,735,462,273,2,30,1,1,allow,1,0,Potential Threat
21447,53,55331,53,245648,213726,31922,2763,89,2579,184,allow,1,0,Potential Threat
50432,80,29144,80,318,192,126,6,27,4,2,allow,0,0,Normal
54114,445,0,0,70,70,0,1,0,1,0,drop,0,1,Known Attack
65226,445,0,0,70,70,0,1,0,1,0,drop,0,1,Known Attack
53102,53,13819,53,70,70,0,1,30,1,0,allow,0,0,Normal
56919,53,23336,53,193,102,91,2,30,1,1,allow,0,0,Normal
65499,443,30170,443,410116,12150,397966,421,16,148,273,allow,1,0,Potential Threat
49898,443,38870,443,8191,2343,5848,33,394,11,22,allow,1,0,Potential Threat
53668,80,20063,80,1173,665,508,13,16,7,6,allow,0,0,Normal
46389,27098,0,0,66,66,0,1,0,1,0,deny,0,1,Known Attack
49355,53,6777,53,168,86,82,2,29,1,1,allow,0,0,Normal
63982,53,27288,53,244,94,150,2,30,1,1,allow,0,0,Normal
34951,443,13510,443,3308,2109,1199,30,751,16,14,allow,1,0,Potential Threat
58638,5900,0,0,62,62,0,1,0,1,0,deny,0,1,Known Attack
32520,47993,0,0,66,66,0,1,0,1,0,deny,1,1,High Risk
64679,53,50625,53,172,88,84,2,31,1,1,allow,0,0,Normal
56495,53,46439,53,199,102,97,2,30,1,1,allow,0,0,Normal
56842,24233,45791,24233,70,70,0,1,5,1,0,allow,1,0,Potential Threat
46516,80,0,0,60,60,0,1,0,1,0,deny,0,1,Known Attack
53053,64147,0,0,62,62,0,1,0,1,0,deny,1,1,High Risk
58638,5900,0,0,62,62,0,1,0,1,0,deny,0,1,Known Attack
64428,53,26819,53,299,97,202,4,44,2,2,allow,0,0,Normal
48368,443,5888,443,9157,3805,5352,39,100,18,21,allow,1,0,Potential Threat
58034,443,53963,443,10192,3621,6571,24,36,12,12,allow,1,0,Potential Threat
49869,53,64308,53,209,110,99,2,30,1,1,allow,1,0,Potential Threat
57912,443,57912,443,4559,1652,2907,19,27,11,8,allow,1,0,Potential Threat
5588,5588,0,0,3354,1792,1562,46,192,23,23,allow,1,0,Potential Threat
49372,443,30393,443,6158,3587,2571,37,104,19,18,allow,1,0,Potential Threat
27005,27016,36126,27016,883,126,757,2,30,1,1,allow,1,0,Potential Threat
63019,53,40745,53,512,166,346,2,29,1,1,allow,0,0,Normal
51026,37450,0,0,66,66,0,1,0,1,0,deny,0,1,Known Attack
65335,445,0,0,70,70,0,1,0,1,0,drop,0,1,Known Attack
38660,443,61188,443,7031,1824,5207,23,60,12,11,allow,1,0,Potential Threat
58638,5900,0,0,62,62,0,1,0,1,0,deny,0,1,Known Attack
44395,443,50721,443,18921,10848,8073,49,401,20,29,allow,1,0,Potential Threat
58638,5900,0,0,62,62,0,1,0,1,0,deny,0,1,Known Attack
64588,53,37209,53,186,95,91,2,31,1,1,allow,0,0,Normal
63741,50584,0,0,66,66,0,1,0,1,0,deny,1,1,High Risk
49713,445,0,0,66,66,0,1,0,1,0,drop,0,1,Known Attack
32549,37807,0,0,146,146,0,1,0,1,0,deny,1,1,High Risk
65255,445,0,0,70,70,0,1,0,1,0,drop,0,1,Known Attack
43584,24748,0,0,156,156,0,1,0,1,0,deny,1,1,High Risk
61321,445,0,0,66,66,0,1,0,1,0,drop,0,1,Known Attack
2267,53,18938,53,204,118,86,2,30,1,1,allow,1,0,Potential Threat
4366,51505,0,0,62,62,0,1,0,1,0,deny,1,1,High Risk
65381,53,45140,53,241,110,131,2,30,1,1,allow,0,0,Normal
64673,445,0,0,70,70,0,1,0,1,0,drop,0,1,Known Attack
49520,445,0,0,70,70,0,1,0,1,0,drop,0,1,Known Attack
65289,53,50124,53,564,193,371,6,51,3,3,allow,1,0,Potential Threat
57157,443,64238,443,1647,1375,272,9,48,5,4,allow,1,0,Potential Threat
52457,445,0,0,70,70,0,1,0,1,0,drop,0,1,Known Attack
64930,53,29648,53,193,102,91,2,29,1,1,allow,0,0,Normal
55520,53,33643,53,188,96,92,2,31,1,1,allow,0,0,Normal
65092,53,7341,53,197,102,95,2,30,1,1,allow,0,0,Normal
7181,64147,0,0,66,66,0,1,0,1,0,deny,1,1,High Risk
49168,53,14343,53,196,102,94,2,30,1,1,allow,0,0,Normal
6721,37965,0,0,66,66,0,1,0,1,0,deny,1,1,High Risk
55892,80,55892,80,1917,1468,449,10,20,6,4,allow,1,0,Potential Threat
59930,445,0,0,70,70,0,1,0,1,0,drop,0,1,Known Attack
443,14315,0,0,158,158,0,1,0,1,0,deny,1,1,High Risk
55773,53,61209,53,199,102,97,2,30,1,1,allow,0,0,Normal
49443,445,0,0,70,70,0,1,0,1,0,drop,0,1,Known Attack
57839,53,57631,53,231,231,0,4,47,4,0,allow,0,0,Normal
53694,8999,50905,8999,1179,606,573,12,17,7,5,allow,1,0,Potential Threat
49875,53,45365,53,445,94,351,2,30,1,1,allow,0,0,Normal
49493,445,0,0,70,70,0,1,0,1,0,drop,0,1,Known Attack
0,0,0,0,98,98,0,1,0,1,0,deny,1,1,High Risk
63878,22114,0,0,146,146,0,1,0,1,0,deny,1,1,High Risk
13375,53,13375,53,213,82,131,2,30,1,1,allow,0,0,Normal
57050,445,0,0,70,70,0,1,0,1,0,drop,0,1,Known Attack
45257,443,55440,443,36062,4663,31399,87,33,41,46,allow,1,0,Potential Threat
56649,53,35726,53,152,78,74,2,30,1,1,allow,0,0,Normal
64870,53,1765,53,200,102,98,2,33,1,1,allow,0,0,Normal
58715,57470,0,0,62,62,0,1,0,1,0,deny,1,1,High Risk
56883,445,0,0,66,66,0,1,0,1,0,drop,0,1,Known Attack
60951,443,8364,443,11464,5499,5965,54,15,29,25,allow,1,0,Potential Threat
56204,53,35086,53,195,102,93,2,30,1,1,allow,0,0,Normal
26722,11446,0,0,66,66,0,1,0,1,0,deny,0,1,Known Attack
60179,445,0,0,66,66,0,1,0,1,0,drop,0,1,Known Attack
60014,445,0,0,70,70,0,1,0,1,0,drop,0,1,Known Attack
53003,11392,0,0,66,66,0,1,0,1,0,deny,0,1,Known Attack
39941,2767,0,0,62,62,0,1,0,1,0,deny,0,1,Known Attack
52919,443,28761,443,7573,1986,5587,40,115,19,21,allow,1,0,Potential Threat
50976,445,0,0,66,66,0,1,0,1,0,drop,0,1,Known Attack
58634,445,0,0,70,70,0,1,0,1,0,drop,0,1,Known Attack
43108,443,11094,443,3117,1867,1250,19,16,9,10,allow,1,0,Potential Threat
64034,53,39969,53,194,102,92,2,31,1,1,allow,0,0,Normal
56785,28902,26302,28902,66,66,0,1,5,1,0,allow,1,0,Potential Threat
59397,445,0,0,70,70,0,1,0,1,0,drop,0,1,Known Attack
59476,23,0,0,60,60,0,1,0,1,0,deny,0,1,Known Attack
57048,53,62627,53,512,95,417,4,34,2,2,allow,1,0,Potential Threat
49480,53,58009,53,184,94,90,2,31,1,1,allow,0,0,Normal
52734,443,39307,443,257777,12962,244815,347,41,162,185,allow,1,0,Potential Threat
137,137,20437,137,384,384,0,5,51,5,0,allow,1,0,Potential Threat
21772,443,21772,443,17221,1314,15907,31,44,16,15,allow,1,0,Potential Threat
57470,6969,5895,6969,132,132,0,3,1199,3,0,allow,1,0,Potential Threat
51949,5484,1068,5484,70,70,0,2,8,2,0,allow,1,0,Potential Threat
49795,445,0,0,66,66,0,1,0,1,0,drop,0,1,Known Attack
57284,53,33476,53,173,94,79,2,29,1,1,allow,0,0,Normal
63999,53,20780,53,193,102,91,2,31,1,1,allow,0,0,Normal
65288,44847,0,0,66,66,0,1,0,1,0,deny,1,1,High Risk
60518,80,21543,80,1915,797,1118,8,16,5,3,allow,1,0,Potential Threat
50536,445,0,0,70,70,0,1,0,1,0,drop,0,1,Known Attack
49531,26467,0,0,66,66,0,1,0,1,0,deny,0,1,Known Attack
51979,443,24826,443,10613,3156,7457,42,15,24,18,allow,1,0,Potential Threat
65448,53,6069,53,264,110,154,2,30,1,1,allow,0,0,Normal
58601,53,45683,53,198,86,112,2,30,1,1,allow,0,0,Normal
49987,443,39263,443,426,180,246,8,21,4,4,allow,0,0,Normal
58574,21247,0,0,66,66,0,1,0,1,0,deny,0,1,Known Attack
55952,443,28479,443,24272,12428,11844,70,213,32,38,allow,1,0,Potential Threat
53145,44634,36222,44634,70,70,0,1,5,1,0,allow,1,0,Potential Threat
52024,80,44508,80,422,240,182,8,25,5,3,allow,0,0,Normal
56893,53,20902,53,177,94,83,2,31,1,1,allow,0,0,Normal
60801,40010,50650,40010,316,136,180,6,6,3,3,allow,1,0,Potential Threat
51166,31573,0,0,66,66,0,1,0,1,0,deny,0,1,Known Attack
54195,443,39081,443,1786,172,1614,7,120,3,4,allow,1,0,Potential Threat
56202,53,15464,53,196,102,94,2,29,1,1,allow,0,0,Normal
57885,80,59656,80,32460,9354,23106,67,71,40,27,allow,1,0,Potential Threat
50973,80,49428,80,1095221,7065,1088156,829,36,105,724,allow,1,0,Potential Threat
46093,32661,0,0,74,74,0,1,0,1,0,deny,0,1,Known Attack
49592,53,33191,53,177,94,83,2,30,1,1,allow,0,0,Normal
58638,5900,0,0,62,62,0,1,0,1,0,deny,0,1,Known Attack
43129,15503,0,0,62,62,0,1,0,1,0,deny,0,1,Known Attack
50949,45960,0,0,62,62,0,1,0,1,0,deny,0,1,Known Attack
52629,53,0,0,232,77,155,2,33,1,1,allow,0,0,Normal
52000,80,36562,80,416,210,206,7,26,4,3,allow,0,0,Normal
65012,445,0,0,70,70,0,1,0,1,0,drop,0,1,Known Attack
43113,443,54317,443,3083,1817,1266,18,15,8,10,allow,1,0,Potential Threat
64462,53,49415,53,179,94,85,2,30,1,1,allow,0,0,Normal
56442,53,53594,53,167,86,81,2,30,1,1,allow,0,0,Normal
50755,445,0,0,70,70,0,1,0,1,0,drop,0,1,Known Attack
49271,445,0,0,66,66,0,1,0,1,0,drop,0,1,Known Attack
55790,53,7477,53,170,87,83,2,31,1,1,allow,0,0,Normal
7811,44847,0,0,62,62,0,1,0,1,0,deny,1,1,High Risk
51202,445,0,0,70,70,0,1,0,1,0,drop,0,1,Known Attack
58877,53,28014,53,426,118,308,2,31,1,1,allow,0,0,Normal
48817,46429,48817,46429,763,296,467,4,1200,2,2,allow,1,0,Potential Threat
55427,443,18604,443,9255,2064,7191,43,78,18,25,allow,1,0,Potential Threat
64548,445,0,0,70,70,0,1,0,1,0,drop,0,1,Known Attack
61364,443,41959,443,8492,2950,5542,27,16,15,12,allow,1,0,Potential Threat
37042,48983,0,0,159,159,0,1,0,1,0,deny,1,1,High Risk
51933,80,40922,80,3676,2136,1540,15,40,10,5,allow,1,0,Potential Threat
55371,53,41494,53,168,86,82,2,30,1,1,allow,0,0,Normal
49283,445,0,0,70,70,0,1,0,1,0,drop,0,1,Known Attack
61711,80,55600,80,4448,2223,2225,18,49,10,8,allow,1,0,Potential Threat
49203,53,26385,53,240,94,146,2,29,1,1,allow,0,0,Normal
27773,56205,0,0,62,62,0,1,0,1,0,deny,1,1,High Risk
56509,53,49839,53,1165,94,1071,2,30,1,1,allow,0,0,Normal
60772,36829,0,0,66,66,0,1,0,1,0,deny,0,1,Known Attack
60380,443,8139,443,70,70,0,2,8,2,0,allow,0,0,Normal
58862,443,26650,443,5167,700,4467,16,15,7,9,allow,1,0,Potential Threat
46901,26672,0,0,60,60,0,1,0,1,0,deny,0,1,Known Attack
60530,445,0,0,70,70,0,1,0,1,0,drop,0,1,Known Attack
52915,445,0,0,66,66,0,1,0,1,0,drop,0,1,Known Attack
52123,1433,0,0,60,60,0,1,0,1,0,deny,0,1,Known Attack
57968,53,57968,53,371,237,134,3,32,2,1,allow,0,0,Normal
51927,63309,60569,63309,70,70,0,1,5,1,0,allow,1,0,Potential Threat
61400,64147,0,0,66,66,0,1,0,1,0,deny,1,1,High Risk
59485,80,39693,80,882,527,355,10,255,6,4,allow,1,0,Potential Threat
52045,445,0,0,70,70,0,1,0,1,0,drop,0,1,Known Attack
55057,53,53863,53,211,110,101,2,30,1,1,allow,0,0,Normal
1821,64147,0,0,66,66,0,1,0,1,0,deny,1,1,High Risk
50544,53,6922,53,193,102,91,2,30,1,1,allow,0,0,Normal
57444,53,22248,53,170,87,83,2,30,1,1,allow,0,0,Normal
53821,53,5224,53,199,94,105,2,30,1,1,allow,0,0,Normal
56114,53,59313,53,216,110,106,2,30,1,1,allow,0,0,Normal
64804,53,12585,53,383,97,286,4,58,2,2,allow,0,0,Normal
17932,53,17932,53,213,87,126,2,30,1,1,allow,0,0,Normal
64308,53,11059,53,258,102,156,2,29,1,1,allow,0,0,Normal
57470,45561,33811,45561,792,792,0,13,1201,13,0,allow,1,0,Potential Threat
50616,443,60964,443,8643,1918,6725,21,26,11,10,allow,1,0,Potential Threat
57695,443,41532,443,9493,2266,7227,24,14,13,11,allow,1,0,Potential Threat
50784,52952,0,0,66,66,0,1,0,1,0,deny,0,1,Known Attack
55877,12187,8942,12187,150,150,0,1,1200,1,0,allow,1,0,Potential Threat
49275,7000,49275,7000,2163,676,1487,14,15,7,7,allow,1,0,Potential Threat
52026,12523,2339,12523,70,70,0,2,7,2,0,allow,1,0,Potential Threat
27005,27013,56795,27013,879,126,753,2,30,1,1,allow,1,0,Potential Threat
60661,53,54714,53,278,102,176,2,31,1,1,allow,0,0,Normal
54219,443,4628,443,499,425,74,4,0,3,1,allow,0,0,Normal
52676,53733,0,0,62,62,0,1,0,1,0,deny,0,1,Known Attack
48817,51234,48817,51234,158,158,0,1,1200,1,0,allow,1,0,Potential Threat
49563,53,57038,53,199,94,105,2,29,1,1,allow,0,0,Normal
34310,80,6005,80,1614,1300,314,10,15,5,5,allow,1,0,Potential Threat
64381,53,50743,53,198,102,96,2,31,1,1,allow,0,0,Normal
49722,443,49212,443,28376,3058,25318,42,63,17,25,allow,1,0,Potential Threat
51584,445,0,0,70,70,0,1,0,1,0,drop,0,1,Known Attack
64323,445,0,0,70,70,0,1,0,1,0,drop,0,1,Known Attack
44922,57470,0,0,74,74,0,1,0,1,0,deny,1,1,High Risk
5223,1210,0,0,103,103,0,1,0,1,0,deny,1,1,High Risk
59070,445,0,0,70,70,0,1,0,1,0,drop,0,1,Known Attack
54140,17372,0,0,66,66,0,1,0,1,0,deny,0,1,Known Attack
60873,445,0,0,70,70,0,1,0,1,0,drop,0,1,Known Attack
55165,53,3036,53,193,102,91,2,29,1,1,allow,0,0,Normal
56976,80,37703,80,214,140,74,4,35,3,1,allow,0,0,Normal
59561,445,0,0,66,66,0,1,0,1,0,drop,0,1,Known Attack
55619,445,0,0,70,70,0,1,0,1,0,drop,0,1,Known Attack
64739,53,1998,53,816,102,714,2,30,1,1,allow,1,0,Potential Threat
57099,53,12968,53,278,102,176,2,31,1,1,allow,0,0,Normal
49162,53,30620,53,401,94,307,4,32,2,2,allow,0,0,Normal
1130,37965,0,0,145,145,0,1,0,1,0,deny,1,1,High Risk
58638,5900,0,0,62,62,0,1,0,1,0,deny,0,1,Known Attack
64576,53,14840,53,194,102,92,2,31,1,1,allow,0,0,Normal
36563,6851,45259,6851,7584,4075,3509,51,169,27,24,allow,1,0,Potential Threat
53552,8999,43016,8999,70,70,0,1,4,1,0,allow,1,0,Potential Threat
62388,39004,0,0,62,62,0,1,0,1,0,deny,0,1,Known Attack
55262,53,28090,53,762,98,664,2,31,1,1,allow,0,0,Normal
55264,53,48968,53,177,94,83,2,30,1,1,allow,0,0,Normal
57470,10154,49581,10154,924,924,0,15,1200,15,0,allow,1,0,Potential Threat
59966,37965,0,0,66,66,0,1,0,1,0,deny,0,1,Known Attack
36663,22114,0,0,146,146,0,1,0,1,0,deny,1,1,High Risk
57470,6969,29118,6969,528,528,0,9,1199,9,0,allow,1,0,Potential Threat
55915,445,0,0,70,70,0,1,0,1,0,drop,0,1,Known Attack
10079,443,27678,443,7122,1766,5356,27,331,14,13,allow,1,0,Potential Threat
63261,445,0,0,70,70,0,1,0,1,0,drop,0,1,Known Attack
57289,445,0,0,70,70,0,1,0,1,0,drop,0,1,Known Attack
53738,25760,39657,25760,2031,1019,1012,11,16,6,5,allow,1,0,Potential Threat
56743,53,42878,53,816,97,719,2,30,1,1,allow,0,0,Normal
54676,443,17245,443,5747,1892,3855,19,17,11,8,allow,0,0,Normal
443,35385,0,0,161,161,0,1,0,1,0,deny,1,1,High Risk
49762,53,65280,53,184,94,90,2,30,1,1,allow,1,0,Potential Threat
64089,53,37654,53,194,102,92,2,30,1,1,allow,0,0,Normal
43921,443,8788,443,8324,1658,6666,24,83,14,10,allow,1,0,Potential Threat
64907,53,21503,53,247,86,161,3,31,2,1,allow,0,0,Normal
54189,445,0,0,66,66,0,1,0,1,0,drop,0,1,Known Attack
53872,53,43483,53,70,70,0,1,30,1,0,allow,0,0,Normal
64506,53,14791,53,230,94,136,2,30,1,1,allow,0,0,Normal
43304,443,10226,443,4389,797,3592,15,70,8,7,allow,1,0,Potential Threat
49917,53,46665,53,168,78,90,2,29,1,1,allow,0,0,Normal
60372,53,60372,53,222,90,132,2,30,1,1,allow,0,0,Normal
64927,53,2368,53,315,110,205,2,30,1,1,allow,0,0,Normal
57289,31573,0,0,66,66,0,1,0,1,0,deny,0,1,Known Attack
50584,54993,58004,54993,652,300,352,4,1200,3,1,allow,1,0,Potential Threat
35005,53,35005,53,233,90,143,2,33,1,1,allow,0,0,Normal
61480,443,37591,443,5716,1341,4375,29,80,16,13,allow,1,0,Potential Threat
51576,445,0,0,66,66,0,1,0,1,0,drop,0,1,Known Attack
55009,445,0,0,70,70,0,1,0,1,0,drop,0,1,Known Attack
61595,50939,0,0,145,145,0,1,0,1,0,deny,1,1,High Risk
40797,25174,0,0,62,62,0,1,0,1,0,deny,0,1,Known Attack
53910,445,0,0,66,66,0,1,0,1,0,drop,0,1,Known Attack
28580,64147,0,0,62,62,0,1,0,1,0,deny,1,1,High Risk
50972,80,5146,80,1095399,7129,1088270,832,37,106,726,allow,1,0,Potential Threat
39313,37965,0,0,62,62,0,1,0,1,0,deny,0,1,Known Attack
56759,53,42507,53,338,118,220,2,30,1,1,allow,0,0,Normal
18904,57470,0,0,62,62,0,1,0,1,0,deny,1,1,High Risk
54766,445,0,0,70,70,0,1,0,1,0,drop,0,1,Known Attack
27005,27016,20035,27016,903,126,777,2,31,1,1,allow,1,0,Potential Threat
54995,53,57538,53,199,102,97,2,30,1,1,allow,0,0,Normal
43750,443,22954,443,248384,70243,178141,544,588,246,298,allow,1,0,Potential Threat
37965,61872,44512,61872,1548,265,1283,4,1201,2,2,allow,1,0,Potential Threat
1735,80,1735,80,78576,5218,73358,91,95,36,55,allow,1,0,Potential Threat
1480,12447,0,0,66,66,0,1,0,1,0,deny,1,1,High Risk
43196,80,6981,80,3494,1589,1905,16,186,9,7,allow,1,0,Potential Threat
49663,443,36491,443,4271,1075,3196,16,25,8,8,allow,0,0,Normal
50684,80,50889,80,1658,1247,411,8,15,5,3,allow,0,0,Normal
36834,443,25361,443,7251,5852,1399,34,75,18,16,allow,1,0,Potential Threat
50135,50584,0,0,62,62,0,1,0,1,0,deny,0,1,Known Attack
25833,53,31276,53,404,261,143,3,30,2,1,allow,0,0,Normal
49883,53,5470,53,177,94,83,2,29,1,1,allow,0,0,Normal
56296,53,37666,53,216,110,106,2,30,1,1,allow,0,0,Normal
49680,443,50049,443,63100,10145,52955,87,147,37,50,allow,1,0,Potential Threat
65115,50584,0,0,66,66,0,1,0,1,0,deny,1,1,High Risk
60159,22114,0,0,66,66,0,1,0,1,0,deny,0,1,Known Attack
35897,443,1439,443,6692,1642,5050,24,275,11,13,allow,1,0,Potential Threat
48340,443,49643,443,18198,13269,4929,47,324,20,27,allow,1,0,Potential Threat
35242,8635,35242,8635,138,78,60,2,6,1,1,allow,1,0,Potential Threat
50867,443,26907,443,6351,1370,4981,18,131,9,9,allow,1,0,Potential Threat
34351,443,4638,443,402051,17714,384337,520,83,228,292,allow,1,0,Potential Threat
53327,445,0,0,70,70,0,1,0,1,0,drop,0,1,Known Attack
49812,53,21383,53,164,84,80,2,31,1,1,allow,0,0,Normal
58638,5900,0,0,62,62,0,1,0,1,0,deny,0,1,Known Attack
61460,445,0,0,70,70,0,1,0,1,0,drop,0,1,Known Attack
51085,56205,0,0,66,66,0,1,0,1,0,deny,0,1,Known Attack
53521,443,50004,443,130,70,60,2,15,1,1,allow,0,0,Normal
55478,53,54641,53,177,94,83,2,30,1,1,allow,0,0,Normal
60357,5900,0,0,60,60,0,1,0,1,0,deny,0,1,Known Attack
53623,50093,42211,50093,552,306,246,9,38,5,4,allow,1,0,Potential Threat
59166,443,40050,443,130458,7920,122538,199,359,94,105,allow,1,0,Potential Threat
64288,53,3103,53,183,94,89,2,31,1,1,allow,0,0,Normal
56356,2710,17176,2710,1222,747,475,10,23,5,5,allow,1,0,Potential Threat
55514,445,0,0,70,70,0,1,0,1,0,drop,0,1,Known Attack
56826,22114,0,0,62,62,0,1,0,1,0,deny,0,1,Known Attack
55347,443,36174,443,3811,2320,1491,33,735,18,15,allow,1,0,Potential Threat
49755,443,49571,443,447301,17016,430285,539,128,196,343,allow,1,0,Potential Threat
56327,44512,0,0,66,66,0,1,0,1,0,deny,0,1,Known Attack
49752,53,10768,53,193,102,91,2,29,1,1,allow,0,0,Normal
30960,45730,17923,45730,330,330,0,6,3610,6,0,allow,1,0,Potential Threat
55717,13517,54958,13517,70,70,0,1,5,1,0,allow,1,0,Potential Threat
54754,50432,0,0,66,66,0,1,0,1,0,deny,0,1,Known Attack
9087,53,9087,53,215,80,135,2,33,1,1,allow,1,0,Potential Threat
50265,31240,10906,31240,726,726,0,12,1200,12,0,allow,1,0,Potential Threat
41472,443,61400,443,680618,28384,652234,828,84,356,472,allow,1,0,Potential Threat
46716,443,30978,443,7298,2661,4637,21,17,11,10,allow,1,0,Potential Threat
52912,53,52912,53,237,91,146,2,32,1,1,allow,0,0,Normal
64947,53,61833,53,275,96,179,4,41,2,2,allow,1,0,Potential Threat
52255,16087,20036,16087,70,70,0,2,8,2,0,allow,1,0,Potential Threat
55454,445,0,0,70,70,0,1,0,1,0,drop,0,1,Known Attack
51012,445,0,0,70,70,0,1,0,1,0,drop,0,1,Known Attack
58672,443,27008,443,4649,2114,2535,11,120,6,5,allow,1,0,Potential Threat
50008,445,0,0,70,70,0,1,0,1,0,drop,0,1,Known Attack
55439,53,52898,53,209,110,99,2,30,1,1,allow,0,0,Normal
50573,443,27732,443,7282,953,6329,18,16,10,8,allow,1,0,Potential Threat
51911,445,0,0,66,66,0,1,0,1,0,drop,0,1,Known Attack
65426,443,27740,443,14205,1527,12678,13,145,2,11,allow,1,0,Potential Threat
54342,80,39601,80,1515,481,1034,11,16,6,5,allow,0,0,Normal
55920,445,0,0,66,66,0,1,0,1,0,drop,0,1,Known Attack
52234,64624,43132,64624,136,136,0,3,14,3,0,allow,1,0,Potential Threat
53813,445,0,0,66,66,0,1,0,1,0,drop,0,1,Known Attack
55254,443,12972,443,3257,782,2475,17,140,8,9,allow,1,0,Potential Threat
54280,3398,0,0,60,60,0,1,0,1,0,deny,0,1,Known Attack
59773,443,43322,443,165464,10322,155142,189,71,69,120,allow,1,0,Potential Threat
60017,443,62960,443,5291,2624,2667,28,145,15,13,allow,1,0,Potential Threat
40204,40018,24038,40018,566,86,480,2,30,1,1,allow,1,0,Potential Threat
55795,443,23533,443,5283,2688,2595,14,135,7,7,allow,1,0,Potential Threat
64824,37965,0,0,62,62,0,1,0,1,0,deny,1,1,High Risk
59394,443,52019,443,5993,1987,4006,17,26,9,8,allow,1,0,Potential Threat
42664,80,62788,80,63654,7979,55675,90,91,49,41,allow,1,0,Potential Threat
49620,443,22598,443,4565,3479,1086,13,138,8,5,allow,1,0,Potential Threat
56639,443,28147,443,7849,1860,5989,20,16,11,9,allow,1,0,Potential Threat
42263,443,45775,443,224,164,60,3,5,2,1,allow,0,0,Normal
49675,5900,49675,5900,124,60,64,2,5,1,1,allow,1,0,Potential Threat
42231,57470,0,0,78,78,0,1,0,1,0,deny,1,1,High Risk
64431,53,52524,53,170,87,83,2,31,1,1,allow,0,0,Normal
21268,62609,0,0,146,146,0,1,0,1,0,deny,1,1,High Risk
51088,445,0,0,70,70,0,1,0,1,0,drop,0,1,Known Attack
15899,37807,0,0,62,62,0,1,0,1,0,deny,1,1,High Risk
64123,445,0,0,70,70,0,1,0,1,0,drop,0,1,Known Attack
58638,5900,0,0,62,62,0,1,0,1,0,deny,0,1,Known Attack
56955,53,2081,53,182,93,89,2,31,1,1,allow,0,0,Normal
56204,53,35079,53,190,97,93,2,31,1,1,allow,0,0,Normal
52151,80,38473,80,546,300,246,10,32,6,4,allow,0,0,Normal
50868,443,26459,443,7646,1697,5949,31,271,15,16,allow,1,0,Potential Threat
56052,53,55355,53,1392,85,1307,4,12,2,2,allow,0,0,Normal
58638,5900,0,0,62,62,0,1,0,1,0,deny,0,1,Known Attack
57400,443,4312,443,10169,1957,8212,26,136,11,15,allow,1,0,Potential Threat
45434,443,37816,443,74123,16210,57913,106,57,52,54,allow,1,0,Potential Threat
53724,53,53724,53,268,114,154,2,29,1,1,allow,0,0,Normal
50265,43974,25412,43974,132,132,0,3,1200,3,0,allow,1,0,Potential Threat
46478,443,23649,443,493,280,213,8,97,5,3,allow,0,0,Normal
44925,443,50958,443,153,93,60,2,5,1,1,allow,0,0,Normal
27005,32039,29232,32039,883,126,757,2,31,1,1,allow,1,0,Potential Threat
45269,50584,0,0,62,62,0,1,0,1,0,deny,0,1,Known Attack
54982,53,26204,53,282,96,186,4,48,2,2,allow,0,0,Normal
56677,443,24316,443,7941,1952,5989,20,15,11,9,allow,1,0,Potential Threat
59749,443,34617,443,304,86,218,2,29,1,1,allow,0,0,Normal
51787,35661,9669,35661,70,70,0,1,5,1,0,allow,1,0,Potential Threat
56328,36237,0,0,62,62,0,1,0,1,0,deny,0,1,Known Attack
57825,445,0,0,70,70,0,1,0,1,0,drop,0,1,Known Attack
61110,445,0,0,70,70,0,1,0,1,0,drop,0,1,Known Attack
64029,443,14573,443,252,70,182,3,120,1,2,allow,0,0,Normal
56822,39352,35185,39352,70,70,0,1,5,1,0,allow,1,0,Potential Threat
63404,445,0,0,66,66,0,1,0,1,0,drop,0,1,Known Attack
27005,1101,40896,1101,902,126,776,2,30,1,1,allow,1,0,Potential Threat
57536,443,25705,443,232,172,60,3,5,2,1,allow,0,0,Normal
53985,30188,0,0,66,66,0,1,0,1,0,deny,0,1,Known Attack
50878,53733,0,0,66,66,0,1,0,1,0,deny,0,1,Known Attack
64413,445,0,0,70,70,0,1,0,1,0,drop,0,1,Known Attack
57401,53,55696,53,179,94,85,2,31,1,1,allow,0,0,Normal
64075,445,0,0,70,70,0,1,0,1,0,drop,0,1,Known Attack
51806,443,40388,443,3182,1568,1614,8,121,4,4,allow,1,0,Potential Threat
60362,443,18140,443,130,70,60,2,15,1,1,allow,0,0,Normal
49543,445,0,0,66,66,0,1,0,1,0,drop,0,1,Known Attack
49436,53,61599,53,718,94,624,2,30,1,1,allow,1,0,Potential Threat
48551,443,38107,443,7104,888,6216,19,27,9,10,allow,1,0,Potential Threat
64784,53,44632,53,195,102,93,2,30,1,1,allow,0,0,Normal
61192,35440,0,0,146,146,0,1,0,1,0,deny,1,1,High Risk
63488,445,0,0,70,70,0,1,0,1,0,drop,0,1,Known Attack
50455,445,0,0,70,70,0,1,0,1,0,drop,0,1,Known Attack
25901,50265,0,0,62,62,0,1,0,1,0,deny,1,1,High Risk
22350,25174,0,0,62,62,0,1,0,1,0,deny,0,1,Known Attack
40583,80,60376,80,898,543,355,10,255,6,4,allow,1,0,Potential Threat
55072,53,59629,53,177,94,83,2,30,1,1,allow,0,0,Normal
56828,53156,57681,53156,70,70,0,2,8,2,0,allow,1,0,Potential Threat
54735,443,61550,443,12507,6114,6393,30,90,18,12,allow,1,0,Potential Threat
59611,56205,0,0,62,62,0,1,0,1,0,deny,1,1,High Risk
51077,80,9544,80,9133,1055,8078,17,151,8,9,allow,1,0,Potential Threat
59497,64097,0,0,66,66,0,1,0,1,0,deny,1,1,High Risk
1027,57866,0,0,146,146,0,1,0,1,0,deny,1,1,High Risk
65533,53,35566,53,277,134,143,2,30,1,1,allow,0,0,Normal
54835,443,59753,443,678,280,398,11,26,5,6,allow,1,0,Potential Threat
61897,445,0,0,70,70,0,1,0,1,0,drop,0,1,Known Attack
28085,36237,0,0,66,66,0,1,0,1,0,deny,0,1,Known Attack
61862,80,50297,80,9747,537,9210,14,16,6,8,allow,1,0,Potential Threat
27005,27016,51239,27016,888,126,762,2,30,1,1,allow,1,0,Potential Threat
64844,53,45693,53,733,86,647,2,29,1,1,allow,0,0,Normal
51207,445,0,0,70,70,0,1,0,1,0,drop,0,1,Known Attack
46112,53,33823,53,168,78,90,2,30,1,1,allow,0,0,Normal
54951,443,21945,443,69882,3520,66362,96,320,38,58,allow,1,0,Potential Threat
53827,443,32061,443,499,425,74,4,0,3,1,allow,0,0,Normal
65049,53,16377,53,210,110,100,2,30,1,1,allow,0,0,Normal
48266,80,46749,80,130,70,60,2,15,1,1,allow,0,0,Normal
64678,53,7690,53,758,93,665,2,31,1,1,allow,0,0,Normal
49247,53,7662,53,478,196,282,6,63,3,3,allow,0,0,Normal
53750,25174,0,0,66,66,0,1,0,1,0,deny,0,1,Known Attack
57459,51505,0,0,66,66,0,1,0,1,0,deny,0,1,Known Attack
36789,80,36658,80,129896,7448,122448,172,32,87,85,allow,1,0,Potential Threat
63649,445,0,0,66,66,0,1,0,1,0,drop,0,1,Known Attack
5588,5588,0,0,3562,1936,1626,48,195,24,24,allow,1,0,Potential Threat
2464,50584,0,0,62,62,0,1,0,1,0,deny,1,1,High Risk
58997,445,0,0,70,70,0,1,0,1,0,drop,0,1,Known Attack
51204,445,0,0,70,70,0,1,0,1,0,drop,0,1,Known Attack
51170,443,40281,443,9894856,232425,9662431,9829,90,3300,6529,allow,1,0,Potential Threat
53800,445,0,0,70,70,0,1,0,1,0,drop,0,1,Known Attack
64297,53,43105,53,364,94,270,4,49,2,2,allow,0,0,Normal
51701,445,0,0,66,66,0,1,0,1,0,drop,0,1,Known Attack
60439,53,58321,53,70,70,0,1,30,1,0,allow,0,0,Normal
58638,5900,0,0,62,62,0,1,0,1,0,deny,0,1,Known Attack
49304,443,13306,443,12436,7656,4780,41,17,23,18,allow,1,0,Potential Threat
65365,53,10909,53,196,102,94,2,29,1,1,allow,0,0,Normal
64159,445,0,0,70,70,0,1,0,1,0,drop,0,1,Known Attack
27046,51505,0,0,66,66,0,1,0,1,0,deny,1,1,High Risk
56010,53,24880,53,184,94,90,2,30,1,1,allow,0,0,Normal
54371,443,51699,443,6120,1305,4815,20,983,10,10,allow,1,0,Potential Threat
58207,51505,0,0,66,66,0,1,0,1,0,deny,0,1,Known Attack
61788,445,0,0,70,70,0,1,0,1,0,drop,0,1,Known Attack
19270,56448,0,0,78,78,0,1,0,1,0,deny,1,1,High Risk
58852,443,26155,443,3723,1793,1930,21,69,10,11,allow,1,0,Potential Threat
63846,445,0,0,70,70,0,1,0,1,0,drop,0,1,Known Attack
52205,445,0,0,70,70,0,1,0,1,0,drop,0,1,Known Attack
60229,443,63035,443,8297,1280,7017,15,135,7,8,allow,1,0,Potential Threat
50625,445,0,0,70,70,0,1,0,1,0,drop,0,1,Known Attack
56582,23718,0,0,62,62,0,1,0,1,0,deny,0,1,Known Attack
61430,80,6930,80,214,140,74,4,41,3,1,allow,0,0,Normal
48739,443,34033,443,7107,1636,5471,24,38,11,13,allow,1,0,Potential Threat
51033,443,39133,443,14697,3801,10896,52,120,24,28,allow,1,0,Potential Threat
59270,445,0,0,70,70,0,1,0,1,0,drop,0,1,Known Attack
56361,53,14867,53,193,102,91,2,30,1,1,allow,0,0,Normal
60550,50584,0,0,62,62,0,1,0,1,0,deny,1,1,High Risk
41815,5228,54746,5228,7701,2155,5546,30,611,17,13,allow,1,0,Potential Threat
63002,22114,0,0,66,66,0,1,0,1,0,deny,0,1,Known Attack
56602,53,29182,53,197,102,95,2,30,1,1,allow,0,0,Normal
62019,445,0,0,70,70,0,1,0,1,0,drop,0,1,Known Attack
56167,53,20756,53,461,94,367,2,30,1,1,allow,0,0,Normal
55220,53,9691,53,186,95,91,2,31,1,1,allow,0,0,Normal
65234,53,55204,53,248,110,138,2,29,1,1,allow,0,0,Normal
55828,53,56117,53,177,94,83,2,30,1,1,allow,0,0,Normal
58638,5900,0,0,62,62,0,1,0,1,0,deny,0,1,Known Attack
53579,42707,0,0,66,66,0,1,0,1,0,deny,0,1,Known Attack
65530,53,20818,53,166,85,81,2,30,1,1,allow,0,0,Normal
55966,443,29704,443,214312,69934,144378,612,671,303,309,allow,1,0,Potential Threat
56349,53,14775,53,184,102,82,2,29,1,1,allow,0,0,Normal
20057,44847,0,0,62,62,0,1,0,1,0,deny,1,1,High Risk
11907,57470,0,0,66,66,0,1,0,1,0,deny,1,1,High Risk
57923,443,34874,443,13736,1702,12034,26,15,12,14,allow,1,0,Potential Threat
50084,26672,0,0,62,62,0,1,0,1,0,deny,0,1,Known Attack
53969,13156,38324,13156,70,70,0,2,7,2,0,allow,1,0,Potential Threat
55191,445,0,0,70,70,0,1,0,1,0,drop,0,1,Known Attack
61681,443,50543,443,10714,3531,7183,26,120,12,14,allow,1,0,Potential Threat
58844,51505,0,0,66,66,0,1,0,1,0,deny,0,1,Known Attack
57701,445,0,0,70,70,0,1,0,1,0,drop,0,1,Known Attack
52229,54711,46262,54711,136,136,0,3,14,3,0,allow,1,0,Potential Threat
54314,445,0,0,66,66,0,1,0,1,0,drop,0,1,Known Attack
56660,443,63035,443,8006,1986,6020,20,15,11,9,allow,1,0,Potential Threat
50367,37965,0,0,66,66,0,1,0,1,0,deny,0,1,Known Attack
55951,30188,0,0,66,66,0,1,0,1,0,deny,0,1,Known Attack
55510,53,10819,53,578,286,292,9,15,5,4,allow,0,0,Normal
53735,58869,2598,58869,70,70,0,2,7,2,0,allow,1,0,Potential Threat
49954,443,61436,443,25995,13597,12398,53,186,28,25,allow,1,0,Potential Threat
37569,443,45273,443,11226,3029,8197,36,55,18,18,allow,1,0,Potential Threat
56281,53,50630,53,170,87,83,2,31,1,1,allow,0,0,Normal
64906,53,18657,53,209,110,99,2,30,1,1,allow,0,0,Normal
60894,443,14726,443,3507,900,2607,13,135,6,7,allow,1,0,Potential Threat
64251,53,65162,53,177,94,83,2,30,1,1,allow,1,0,Potential Threat
22784,9571,0,0,62,62,0,1,0,1,0,deny,0,1,Known Attack
61682,445,0,0,70,70,0,1,0,1,0,drop,0,1,Known Attack
53675,29970,54968,29970,612,426,186,10,22,7,3,allow,1,0,Potential Threat
55615,53,23565,53,772,100,672,2,31,1,1,allow,0,0,Normal
29577,64147,0,0,62,62,0,1,0,1,0,deny,1,1,High Risk
60701,445,0,0,70,70,0,1,0,1,0,drop,0,1,Known Attack
58638,5900,0,0,62,62,0,1,0,1,0,deny,0,1,Known Attack
50290,443,41228,443,6662,3336,3326,37,142,17,20,allow,1,0,Potential Threat
64261,53,48738,53,295,110,185,2,30,1,1,allow,0,0,Normal
64214,445,0,0,66,66,0,1,0,1,0,drop,0,1,Known Attack
58349,445,0,0,70,70,0,1,0,1,0,drop,0,1,Known Attack
39166,53,0,0,82,82,0,1,31,1,0,allow,0,0,Normal
50427,445,0,0,70,70,0,1,0,1,0,drop,0,1,Known Attack
55642,26872,53975,26872,70,70,0,2,8,2,0,allow,1,0,Potential Threat
53158,17234,38811,17234,70,70,0,1,4,1,0,allow,1,0,Potential Threat
6943,1970,0,0,100,100,0,1,0,1,0,deny,1,1,High Risk
1431,30041,0,0,62,62,0,1,0,1,0,deny,1,1,High Risk
54401,443,33851,443,11527127,373718,11153409,12286,144,4090,8196,allow,1,0,Potential Threat
61933,445,0,0,70,70,0,1,0,1,0,drop,0,1,Known Attack
53985,30188,0,0,62,62,0,1,0,1,0,deny,0,1,Known Attack
53609,38060,54791,38060,70,70,0,1,5,1,0,allow,1,0,Potential Threat
15732,53,15732,53,414,268,146,3,32,2,1,allow,1,0,Potential Threat
65224,53,46834,53,197,102,95,2,30,1,1,allow,0,0,Normal
40301,8696,0,0,60,60,0,1,0,1,0,deny,0,1,Known Attack
51921,443,16602,443,7970,4154,3816,39,102,23,16,allow,1,0,Potential Threat
58787,443,18932,443,5107,700,4407,15,15,7,8,allow,1,0,Potential Threat
61051,445,0,0,70,70,0,1,0,1,0,drop,0,1,Known Attack
56735,80,63370,80,194,128,66,4,25,3,1,allow,1,0,Potential Threat
47510,443,50202,443,5149,852,4297,16,15,9,7,allow,1,0,Potential Threat
52072,25595,16816,25595,66,66,0,1,5,1,0,allow,1,0,Potential Threat
49973,445,0,0,70,70,0,1,0,1,0,drop,0,1,Known Attack
53792,1,12742,1,70,70,0,2,7,2,0,allow,0,0,Normal
24616,48983,0,0,146,146,0,1,0,1,0,deny,1,1,High Risk
51880,445,0,0,70,70,0,1,0,1,0,drop,0,1,Known Attack
56612,53,23653,53,172,88,84,2,31,1,1,allow,0,0,Normal
61341,445,0,0,70,70,0,1,0,1,0,drop,0,1,Known Attack
65220,445,0,0,70,70,0,1,0,1,0,drop,0,1,Known Attack
58711,53,20725,53,277,78,199,2,30,1,1,allow,0,0,Normal
56799,443,31346,443,6496,1340,5156,31,506,10,21,allow,1,0,Potential Threat
58077,36653,53473,36653,204,64,140,4,11,2,2,allow,1,0,Potential Threat
63968,53,37221,53,200,102,98,2,30,1,1,allow,0,0,Normal
50418,53,14403,53,177,94,83,2,30,1,1,allow,0,0,Normal
57251,37965,0,0,62,62,0,1,0,1,0,deny,0,1,Known Attack
57186,445,0,0,70,70,0,1,0,1,0,drop,0,1,Known Attack
56403,51505,0,0,62,62,0,1,0,1,0,deny,0,1,Known Attack
49333,445,0,0,66,66,0,1,0,1,0,drop,0,1,Known Attack
53796,443,58960,443,499,425,74,4,0,3,1,allow,0,0,Normal
8999,57470,0,0,146,146,0,1,0,1,0,deny,1,1,High Risk
55828,53,62076,53,181,94,87,2,29,1,1,allow,0,0,Normal
58638,5900,0,0,62,62,0,1,0,1,0,deny,0,1,Known Attack
51236,445,0,0,66,66,0,1,0,1,0,drop,0,1,Known Attack
35615,443,10957,443,6179,1242,4937,22,42,11,11,allow,1,0,Potential Threat
65014,53,3896,53,186,95,91,2,31,1,1,allow,0,0,Normal
53722,443,10654,443,70,70,0,2,7,2,0,allow,0,0,Normal
49916,53,53241,53,118,118,0,1,30,1,0,allow,0,0,Normal
49773,53,20298,53,994,86,908,2,30,1,1,allow,0,0,Normal
64737,445,0,0,66,66,0,1,0,1,0,drop,0,1,Known Attack
54270,443,24840,443,6620,672,5948,17,128,8,9,allow,1,0,Potential Threat
56918,53,41255,53,778,103,675,2,30,1,1,allow,0,0,Normal
58747,445,0,0,70,70,0,1,0,1,0,drop,0,1,Known Attack
51951,65387,56923,65387,70,70,0,2,8,2,0,allow,1,0,Potential Threat
31602,53,0,0,327,102,225,2,30,1,1,allow,0,0,Normal
56420,443,5096,443,9876,5607,4269,66,122,35,31,allow,1,0,Potential Threat
57071,53,6792,53,166,86,80,2,30,1,1,allow,0,0,Normal
44538,50584,0,0,62,62,0,1,0,1,0,deny,0,1,Known Attack
50826,443,11870,443,6601,1120,5481,17,115,9,8,allow,1,0,Potential Threat
44922,57470,0,0,74,74,0,1,0,1,0,deny,1,1,High Risk
10072,25174,0,0,62,62,0,1,0,1,0,deny,0,1,Known Attack
63143,16884,9026,16884,618,318,300,10,16,5,5,allow,1,0,Potential Threat
58638,5900,0,0,62,62,0,1,0,1,0,deny,0,1,Known Attack
59278,53,0,0,86,86,0,1,30,1,0,allow,0,0,Normal
51242,80,19033,80,3506,2280,1226,24,50,13,11,allow,1,0,Potential Threat
59781,443,23445,443,546,180,366,10,28,4,6,allow,0,0,Normal
37604,443,27839,443,573,425,148,5,0,3,2,allow,1,0,Potential Threat
64566,53,24742,53,194,102,92,2,30,1,1,allow,0,0,Normal
17781,50265,0,0,62,62,0,1,0,1,0,deny,1,1,High Risk
49430,443,49430,443,4377,1470,2907,19,30,11,8,allow,1,0,Potential Threat
53571,445,0,0,70,70,0,1,0,1,0,drop,0,1,Known Attack
10165,80,10165,80,6714,929,5785,17,33,8,9,allow,1,0,Potential Threat
17750,12550,53024,12550,491,150,341,2,1200,1,1,allow,1,0,Potential Threat
55440,53,55440,53,220,90,130,2,30,1,1,allow,0,0,Normal
53010,443,23300,443,31660,3248,28412,58,93,23,35,allow,1,0,Potential Threat
57046,53,24095,53,234,94,140,2,29,1,1,allow,0,0,Normal
63057,445,0,0,66,66,0,1,0,1,0,drop,0,1,Known Attack
50561,445,0,0,70,70,0,1,0,1,0,drop,0,1,Known Attack
58829,64147,0,0,66,66,0,1,0,1,0,deny,1,1,High Risk
64480,53,30625,53,276,126,150,2,30,1,1,allow,0,0,Normal
58054,445,0,0,70,70,0,1,0,1,0,drop,0,1,Known Attack
53126,47035,16520,47035,70,70,0,2,8,2,0,allow,1,0,Potential Threat
50082,445,0,0,66,66,0,1,0,1,0,drop,0,1,Known Attack
55425,5222,24173,5222,9151,4417,4734,84,77,44,40,allow,1,0,Potential Threat
52148,445,0,0,66,66,0,1,0,1,0,drop,0,1,Known Attack
53907,445,0,0,66,66,0,1,0,1,0,drop,0,1,Known Attack
58638,5900,0,0,62,62,0,1,0,1,0,deny,0,1,Known Attack
59830,445,0,0,70,70,0,1,0,1,0,drop,0,1,Known Attack
63972,445,0,0,66,66,0,1,0,1,0,drop,0,1,Known Attack
53198,443,53198,443,4591,1684,2907,19,28,11,8,allow,1,0,Potential Threat
57675,445,0,0,70,70,0,1,0,1,0,drop,0,1,Known Attack
56656,53,54597,53,255,88,167,4,53,2,2,allow,0,0,Normal
52077,51638,8361,51638,70,70,0,1,4,1,0,allow,1,0,Potential Threat
736,23,0,0,60,60,0,1,0,1,0,deny,1,1,High Risk
55945,53,51093,53,733,86,647,2,30,1,1,allow,0,0,Normal
58638,5900,0,0,62,62,0,1,0,1,0,deny,0,1,Known Attack
65497,53,26978,53,197,102,95,2,30,1,1,allow,0,0,Normal
56900,445,0,0,66,66,0,1,0,1,0,drop,0,1,Known Attack
27005,27016,25389,27016,1006,252,754,4,32,3,1,allow,1,0,Potential Threat
59701,443,37154,443,6155,1819,4336,18,181,8,10,allow,1,0,Potential Threat
63981,34250,53768,34250,66,66,0,2,8,2,0,allow,1,0,Potential Threat
50658,80,54358,80,5018,4314,704,11,30,6,5,allow,1,0,Potential Threat
51164,443,40341,443,7569,2113,5456,26,361,14,12,allow,1,0,Potential Threat
63468,445,0,0,66,66,0,1,0,1,0,drop,0,1,Known Attack
35229,32468,0,0,62,62,0,1,0,1,0,deny,0,1,Known Attack
59500,445,0,0,70,70,0,1,0,1,0,drop,0,1,Known Attack
55902,53,9062,53,178,91,87,2,31,1,1,allow,0,0,Normal
54062,49813,0,0,62,62,0,1,0,1,0,deny,0,1,Known Attack
58278,445,0,0,70,70,0,1,0,1,0,drop,0,1,Known Attack
46779,5228,25730,5228,3775,2029,1746,30,3637,13,17,allow,1,0,Potential Threat
52071,80,35794,80,362,240,122,7,25,5,2,allow,0,0,Normal
16377,21247,0,0,62,62,0,1,0,1,0,deny,0,1,Known Attack
64421,53,34149,53,178,94,84,2,30,1,1,allow,0,0,Normal
53678,443,40421,443,6697,1606,5091,23,24,13,10,allow,1,0,Potential Threat
43628,443,48034,443,13974,3774,10200,29,120,12,17,allow,1,0,Potential Threat
49570,5900,0,0,60,60,0,1,0,1,0,deny,0,1,Known Attack
55635,53,13643,53,177,94,83,2,30,1,1,allow,0,0,Normal
57398,443,53104,443,1056,569,487,10,24,6,4,allow,0,0,Normal
45410,1,0,0,62,62,0,1,0,1,0,deny,0,1,Known Attack
64224,53,56405,53,280,94,186,2,30,1,1,allow,0,0,Normal
55545,445,0,0,66,66,0,1,0,1,0,drop,0,1,Known Attack
59795,443,6313,443,120014,7352,112662,155,37,64,91,allow,1,0,Potential Threat
44923,23,0,0,60,60,0,1,0,1,0,deny,0,1,Known Attack
51310,64147,0,0,66,66,0,1,0,1,0,deny,1,1,High Risk
53318,22114,0,0,66,66,0,1,0,1,0,deny,0,1,Known Attack
50367,445,0,0,70,70,0,1,0,1,0,drop,0,1,Known Attack
56422,53,41175,53,199,102,97,2,30,1,1,allow,0,0,Normal
53147,37965,0,0,62,62,0,1,0,1,0,deny,0,1,Known Attack
60150,445,0,0,70,70,0,1,0,1,0,drop,0,1,Known Attack
49300,445,0,0,70,70,0,1,0,1,0,drop,0,1,Known Attack
515,10214,0,0,66,66,0,1,0,1,0,deny,1,1,High Risk
21365,23718,0,0,62,62,0,1,0,1,0,deny,0,1,Known Attack
65445,53,5000,53,718,94,624,2,30,1,1,allow,0,0,Normal
60387,445,0,0,66,66,0,1,0,1,0,drop,0,1,Known Attack
63589,445,0,0,70,70,0,1,0,1,0,drop,0,1,Known Attack
49485,7080,49485,7080,2960,432,2528,11,15,6,5,allow,1,0,Potential Threat
56832,53,34537,53,214,102,112,2,29,1,1,allow,0,0,Normal
8999,15503,0,0,146,146,0,1,0,1,0,deny,1,1,High Risk
43675,80,34710,80,1676620,41953,1634667,1725,25,636,1089,allow,1,0,Potential Threat
54962,53,32571,53,188,96,92,2,30,1,1,allow,0,0,Normal
56480,53,53765,53,755,94,661,2,31,1,1,allow,0,0,Normal
57914,80,49885,80,6527,1210,5317,15,18,8,7,allow,1,0,Potential Threat
41073,53,41073,53,197,90,107,2,30,1,1,allow,0,0,Normal
6881,35045,1586,35045,475,150,325,2,1200,1,1,allow,1,0,Potential Threat
64037,18592,48496,18592,70,70,0,1,5,1,0,allow,1,0,Potential Threat
50483,445,0,0,70,70,0,1,0,1,0,drop,0,1,Known Attack
54612,445,0,0,66,66,0,1,0,1,0,drop,0,1,Known Attack
50643,443,60929,443,1512,844,668,16,64,9,7,allow,1,0,Potential Threat
56470,53,21021,53,196,100,96,2,31,1,1,allow,0,0,Normal
9324,443,33759,443,3255,430,2825,11,15,6,5,allow,1,0,Potential Threat
64714,445,0,0,70,70,0,1,0,1,0,drop,0,1,Known Attack
49393,30188,0,0,66,66,0,1,0,1,0,deny,0,1,Known Attack
64343,6004,0,0,66,66,0,1,0,1,0,deny,0,1,Known Attack
49989,53,42243,53,677,217,460,6,74,3,3,allow,0,0,Normal
51419,443,59979,443,13049,4849,8200,31,31,15,16,allow,1,0,Potential Threat
65199,53,63329,53,793,207,586,6,59,3,3,allow,1,0,Potential Threat
51783,445,0,0,70,70,0,1,0,1,0,drop,0,1,Known Attack
53782,42855,3816,42855,70,70,0,1,5,1,0,allow,1,0,Potential Threat
55646,445,0,0,70,70,0,1,0,1,0,drop,0,1,Known Attack
28122,443,63914,443,7808,2487,5321,34,446,16,18,allow,1,0,Potential Threat
34767,443,6327,443,6313,1368,4945,21,846,11,10,allow,1,0,Potential Threat
51443,53,51443,53,217,87,130,2,31,1,1,allow,0,0,Normal
57284,53,21102,53,214,110,104,2,31,1,1,allow,0,0,Normal
57218,445,0,0,70,70,0,1,0,1,0,drop,0,1,Known Attack
20961,35440,0,0,62,62,0,1,0,1,0,deny,1,1,High Risk
50095,53,10662,53,168,86,82,2,30,1,1,allow,0,0,Normal
56934,80,1586,80,486,280,206,8,26,5,3,allow,1,0,Potential Threat
55013,53,63318,53,728,102,626,2,29,1,1,allow,1,0,Potential Threat
62859,35440,0,0,66,66,0,1,0,1,0,deny,0,1,Known Attack
56131,37807,0,0,66,66,0,1,0,1,0,deny,0,1,Known Attack
53487,445,0,0,70,70,0,1,0,1,0,drop,0,1,Known Attack
34527,443,29221,443,480624,56231,424393,860,196,427,433,allow,1,0,Potential Threat
5588,5588,0,0,3354,1792,1562,46,194,23,23,allow,1,0,Potential Threat
56652,53,23903,53,821,102,719,2,30,1,1,allow,0,0,Normal
56991,53,36997,53,748,106,642,2,30,1,1,allow,0,0,Normal
56960,80,32758,80,6363,3790,2573,16,30,10,6,allow,1,0,Potential Threat
57779,22114,0,0,146,146,0,1,0,1,0,deny,1,1,High Risk
42557,443,48761,443,123082,8734,114348,200,84,101,99,allow,1,0,Potential Threat
37271,443,4038,443,51402,5964,45438,86,153,32,54,allow,1,0,Potential Threat
64767,443,64767,443,4507,1600,2907,19,31,11,8,allow,1,0,Potential Threat
51590,445,0,0,70,70,0,1,0,1,0,drop,0,1,Known Attack
27176,53,64798,53,396,257,139,3,30,2,1,allow,1,0,Potential Threat
50422,50584,0,0,66,66,0,1,0,1,0,deny,0,1,Known Attack
60448,443,25494,443,17060,10614,6446,52,132,25,27,allow,1,0,Potential Threat
57325,37965,0,0,62,62,0,1,0,1,0,deny,0,1,Known Attack
50609,53,13488,53,766,102,664,2,30,1,1,allow,0,0,Normal
56602,443,27563,443,7942,1953,5989,20,15,11,9,allow,1,0,Potential Threat
62060,445,0,0,70,70,0,1,0,1,0,drop,0,1,Known Attack
54109,36829,0,0,62,62,0,1,0,1,0,deny,0,1,Known Attack
64172,53,61363,53,361,99,262,4,54,2,2,allow,1,0,Potential Threat
65448,445,0,0,66,66,0,1,0,1,0,drop,0,1,Known Attack
59889,443,40054,443,8305,2325,5980,24,46,13,11,allow,1,0,Potential Threat
46280,5900,0,0,60,60,0,1,0,1,0,deny,0,1,Known Attack
55199,443,36951,443,4086,1248,2838,24,140,11,13,allow,1,0,Potential Threat
52267,55982,31620,55982,70,70,0,2,6,2,0,allow,1,0,Potential Threat
56674,53,43592,53,182,93,89,2,31,1,1,allow,0,0,Normal
63139,53,41966,53,78,78,0,1,30,1,0,allow,0,0,Normal
57410,37965,0,0,66,66,0,1,0,1,0,deny,0,1,Known Attack
33971,443,52032,443,244193,7090,237103,260,136,87,173,allow,1,0,Potential Threat
51018,445,0,0,70,70,0,1,0,1,0,drop,0,1,Known Attack
45472,8168,0,0,62,62,0,1,0,1,0,deny,0,1,Known Attack
51988,32239,13198,32239,66,66,0,1,5,1,0,allow,1,0,Potential Threat
55584,34914,32488,34914,504,318,186,8,15,5,3,allow,1,0,Potential Threat
123,123,23599,123,184,94,90,2,30,1,1,allow,1,0,Potential Threat
62830,445,0,0,66,66,0,1,0,1,0,drop,0,1,Known Attack
59878,443,30562,443,3864,2812,1052,17,112,8,9,allow,1,0,Potential Threat
54720,445,0,0,70,70,0,1,0,1,0,drop,0,1,Known Attack
7100,53,7100,53,644,90,554,2,30,1,1,allow,1,0,Potential Threat
62501,445,0,0,70,70,0,1,0,1,0,drop,0,1,Known Attack
20741,64147,0,0,62,62,0,1,0,1,0,deny,1,1,High Risk
59792,443,33674,443,12836,2016,10820,48,361,20,28,allow,1,0,Potential Threat
65239,445,0,0,70,70,0,1,0,1,0,drop,0,1,Known Attack
56523,53,49008,53,184,102,82,2,30,1,1,allow,0,0,Normal
65515,445,0,0,66,66,0,1,0,1,0,drop,0,1,Known Attack
56728,53,40582,53,744,95,649,2,31,1,1,allow,0,0,Normal
59366,443,63784,443,59122,7352,51770,85,322,41,44,allow,1,0,Potential Threat
64016,53,54219,53,184,94,90,2,31,1,1,allow,0,0,Normal
55641,445,0,0,70,70,0,1,0,1,0,drop,0,1,Known Attack
3478,61463,0,0,68,68,0,1,0,1,0,deny,1,1,High Risk
60621,445,0,0,66,66,0,1,0,1,0,drop,0,1,Known Attack
58757,5222,20717,5222,3815,2065,1750,37,309,19,18,allow,1,0,Potential Threat
18655,50584,0,0,62,62,0,1,0,1,0,deny,1,1,High Risk
52003,18150,42315,18150,70,70,0,2,7,2,0,allow,1,0,Potential Threat
43323,1,0,0,62,62,0,1,0,1,0,deny,0,1,Known Attack
49623,443,29272,443,36302,2869,33433,67,180,32,35,allow,1,0,Potential Threat
13445,44847,0,0,66,66,0,1,0,1,0,deny,1,1,High Risk
65429,80,58851,80,366,180,186,7,29,4,3,allow,1,0,Potential Threat
65404,36237,0,0,62,62,0,1,0,1,0,deny,1,1,High Risk
53490,62413,0,0,62,62,0,1,0,1,0,deny,1,1,High Risk
45766,35440,0,0,62,62,0,1,0,1,0,deny,0,1,Known Attack
51698,80,35267,80,15609,1298,14311,26,75,14,12,allow,1,0,Potential Threat
45547,53,15973,53,199,94,105,2,30,1,1,allow,0,0,Normal
54521,445,0,0,70,70,0,1,0,1,0,drop,0,1,Known Attack
51499,445,0,0,70,70,0,1,0,1,0,drop,0,1,Known Attack
58638,5900,0,0,62,62,0,1,0,1,0,deny,0,1,Known Attack
51563,445,0,0,70,70,0,1,0,1,0,drop,0,1,Known Attack
45742,443,8175,443,8471,3275,5196,21,120,11,10,allow,1,0,Potential Threat
48755,53,17288,53,168,78,90,2,30,1,1,allow,0,0,Normal
49861,53,46345,53,261,94,167,2,30,1,1,allow,0,0,Normal
58799,30188,0,0,66,66,0,1,0,1,0,deny,0,1,Known Attack
51046,25174,0,0,66,66,0,1,0,1,0,deny,0,1,Known Attack
22029,50584,0,0,66,66,0,1,0,1,0,deny,1,1,High Risk
38011,443,43234,443,6900,4387,2513,37,98,19,18,allow,1,0,Potential Threat
8486,56205,0,0,66,66,0,1,0,1,0,deny,1,1,High Risk
58079,445,0,0,66,66,0,1,0,1,0,drop,0,1,Known Attack
50036,80,50018,80,1665,923,742,7,32,4,3,allow,0,0,Normal
54172,445,0,0,70,70,0,1,0,1,0,drop,0,1,Known Attack
53194,443,63620,443,1462,965,497,13,18,7,6,allow,1,0,Potential Threat
50098,445,0,0,70,70,0,1,0,1,0,drop,0,1,Known Attack
64719,53,44200,53,196,102,94,2,31,1,1,allow,0,0,Normal
51393,445,0,0,66,66,0,1,0,1,0,drop,0,1,Known Attack
50007,53,39028,53,216,110,106,2,30,1,1,allow,0,0,Normal
51501,443,62787,443,10861,5281,5580,65,49,33,32,allow,1,0,Potential Threat
34464,443,64076,443,1402,910,492,11,360,6,5,allow,1,0,Potential Threat
30303,30303,0,0,181,181,0,1,0,1,0,deny,1,1,High Risk
57194,53,31354,53,2198,193,2005,6,90,3,3,allow,0,0,Normal
51383,445,0,0,66,66,0,1,0,1,0,drop,0,1,Known Attack
50603,443,37566,443,2928,1448,1480,17,20,10,7,allow,1,0,Potential Threat
3478,61463,0,0,451,451,0,1,0,1,0,deny,1,1,High Risk
35338,443,31577,443,571121,38361,532760,718,69,342,376,allow,1,0,Potential Threat
53888,443,42576,443,8935,4627,4308,22,121,12,10,allow,1,0,Potential Threat
61563,37807,0,0,66,66,0,1,0,1,0,deny,0,1,Known Attack
25523,35974,0,0,62,62,0,1,0,1,0,deny,1,1,High Risk
57421,445,0,0,70,70,0,1,0,1,0,drop,0,1,Known Attack
60232,445,0,0,70,70,0,1,0,1,0,drop,0,1,Known Attack
53493,445,0,0,70,70,0,1,0,1,0,drop,0,1,Known Attack
50411,80,65137,80,1657,1246,411,8,15,5,3,allow,1,0,Potential Threat
49465,443,48053,443,2894,725,2169,10,121,5,5,allow,1,0,Potential Threat
13281,51050,0,0,66,66,0,1,0,1,0,deny,1,1,High Risk
57892,80,46739,80,6519,1210,5309,15,17,8,7,allow,1,0,Potential Threat
45064,25174,0,0,62,62,0,1,0,1,0,deny,0,1,Known Attack
50164,443,9375,443,3312,1098,2214,19,137,10,9,allow,1,0,Potential Threat
2422,50584,0,0,66,66,0,1,0,1,0,deny,1,1,High Risk
13508,15503,0,0,66,66,0,1,0,1,0,deny,0,1,Known Attack
53374,443,16272,443,4317,1134,3183,16,26,9,7,allow,1,0,Potential Threat
57208,53,46583,53,183,94,89,2,31,1,1,allow,0,0,Normal
52092,443,50536,443,4642,3496,1146,18,16,10,8,allow,1,0,Potential Threat
51827,56205,0,0,66,66,0,1,0,1,0,deny,0,1,Known Attack
56440,80,38855,80,17008,1379,15629,22,25,7,15,allow,1,0,Potential Threat
54054,5228,24551,5228,8767,2486,6281,45,6062,24,21,allow,1,0,Potential Threat
63964,53,35341,53,195,102,93,2,30,1,1,allow,0,0,Normal
49982,53,19488,53,211,110,101,2,30,1,1,allow,0,0,Normal
55745,53,2082,53,198,101,97,2,30,1,1,allow,0,0,Normal
34746,443,4348,443,284320,14149,270171,398,244,203,195,allow,1,0,Potential Threat
62486,445,0,0,66,66,0,1,0,1,0,drop,0,1,Known Attack
51683,5228,43500,5228,9476,2759,6717,27,3601,15,12,allow,1,0,Potential Threat
44849,443,64447,443,13791,7866,5925,35,46,20,15,allow,1,0,Potential Threat
51841,21960,6708,21960,136,136,0,3,14,3,0,allow,1,0,Potential Threat
54386,445,0,0,70,70,0,1,0,1,0,drop,0,1,Known Attack
50597,443,31048,443,8031,1915,6116,24,17,12,12,allow,1,0,Potential Threat
65489,445,0,0,70,70,0,1,0,1,0,drop,0,1,Known Attack
1733,65448,0,0,66,66,0,1,0,1,0,deny,1,1,High Risk
56420,80,57757,80,34636,928,33708,37,104,11,26,allow,1,0,Potential Threat
42030,25,0,0,74,74,0,1,0,1,0,deny,0,1,Known Attack
56330,445,0,0,70,70,0,1,0,1,0,drop,0,1,Known Attack
56330,53,48273,53,199,102,97,2,30,1,1,allow,0,0,Normal
60909,445,0,0,70,70,0,1,0,1,0,drop,0,1,Known Attack
52090,64823,30736,64823,634,568,66,8,29,7,1,allow,1,0,Potential Threat
56115,53,60323,53,167,86,81,2,30,1,1,allow,0,0,Normal
65387,53,9016,53,221,94,127,2,30,1,1,allow,0,0,Normal
55929,80,55929,80,450,246,204,8,29,5,3,allow,0,0,Normal
64167,53,3978,53,211,102,109,2,29,1,1,allow,0,0,Normal
55202,445,0,0,70,70,0,1,0,1,0,drop,0,1,Known Attack
50162,445,0,0,70,70,0,1,0,1,0,drop,0,1,Known Attack
24606,55783,0,0,72,72,0,1,0,1,0,deny,1,1,High Risk
51943,445,0,0,66,66,0,1,0,1,0,drop,0,1,Known Attack
52006,49849,60139,49849,70,70,0,1,5,1,0,allow,1,0,Potential Threat
60794,445,0,0,66,66,0,1,0,1,0,drop,0,1,Known Attack
56676,53,50057,53,178,94,84,2,30,1,1,allow,0,0,Normal
56677,53,61027,53,200,102,98,2,30,1,1,allow,0,0,Normal
56704,53,33003,53,711,87,624,2,30,1,1,allow,0,0,Normal
56569,53,53689,53,183,94,89,2,30,1,1,allow,0,0,Normal
55125,53,57865,53,177,94,83,2,29,1,1,allow,0,0,Normal
61702,80,48411,80,1553,953,600,14,47,8,6,allow,1,0,Potential Threat
50531,80,18243,80,1704,799,905,11,83,6,5,allow,0,0,Normal
57904,443,64826,443,7912,3215,4697,23,20,12,11,allow,1,0,Potential Threat
46557,57866,0,0,66,66,0,1,0,1,0,deny,1,1,High Risk
55159,53,57486,53,168,86,82,2,30,1,1,allow,0,0,Normal
49717,53,48239,53,444,96,348,4,44,2,2,allow,0,0,Normal
64602,53,18957,53,185,102,83,2,30,1,1,allow,0,0,Normal
65189,28125,44608,28125,78,78,0,1,29,1,0,allow,1,0,Potential Threat
33982,80,37305,80,1152,712,440,10,15,5,5,allow,1,0,Potential Threat
64831,53,30238,53,216,110,106,2,31,1,1,allow,0,0,Normal
58702,80,13752,80,2424,529,1895,11,75,6,5,allow,1,0,Potential Threat
49659,80,54132,80,1937,885,1052,13,42,7,6,allow,0,0,Normal
19204,56448,0,0,78,78,0,1,0,1,0,deny,1,1,High Risk
55010,53,1751,53,245,94,151,2,29,1,1,allow,0,0,Normal
61445,443,34767,443,97211,3043,94168,109,121,37,72,allow,1,0,Potential Threat
56451,445,0,0,66,66,0,1,0,1,0,drop,0,1,Known Attack
50713,57470,0,0,66,66,0,1,0,1,0,deny,0,1,Known Attack
2267,53,21811,53,204,118,86,2,30,1,1,allow,1,0,Potential Threat
50277,80,19151,80,12764,7749,5015,28,84,14,14,allow,1,0,Potential Threat
51730,445,0,0,66,66,0,1,0,1,0,drop,0,1,Known Attack
6666,8530,0,0,60,60,0,1,0,1,0,deny,0,1,Known Attack
61335,443,41509,443,42437,8035,34402,79,247,30,49,allow,1,0,Potential Threat
50125,445,0,0,66,66,0,1,0,1,0,drop,0,1,Known Attack
56041,53,39211,53,185,102,83,2,31,1,1,allow,0,0,Normal
63364,445,0,0,70,70,0,1,0,1,0,drop,0,1,Known Attack
64940,53,17775,53,758,102,656,2,30,1,1,allow,0,0,Normal
56078,22,0,0,60,60,0,1,0,1,0,deny,0,1,Known Attack
55533,53,40009,53,183,94,89,2,30,1,1,allow,0,0,Normal
55617,53,30754,53,212,108,104,2,31,1,1,allow,0,0,Normal
63935,51413,5308,51413,312,132,180,6,7,3,3,allow,1,0,Potential Threat
52831,445,0,0,70,70,0,1,0,1,0,drop,0,1,Known Attack
64752,53,22741,53,178,94,84,2,29,1,1,allow,0,0,Normal
56784,23140,27615,23140,70,70,0,1,5,1,0,allow,1,0,Potential Threat
65218,53,11039,53,188,96,92,2,30,1,1,allow,0,0,Normal
56245,53,35606,53,200,102,98,2,30,1,1,allow,0,0,Normal
64473,7000,64473,7000,3434,1595,1839,17,15,9,8,allow,1,0,Potential Threat
54539,26467,0,0,62,62,0,1,0,1,0,deny,0,1,Known Attack
55469,53,31769,53,193,102,91,2,30,1,1,allow,0,0,Normal
37961,443,30943,443,10229,2777,7452,30,361,15,15,allow,1,0,Potential Threat
50634,443,27378,443,8220,1670,6550,26,71,13,13,allow,1,0,Potential Threat
65179,53,5745,53,184,94,90,2,31,1,1,allow,0,0,Normal
59077,445,0,0,70,70,0,1,0,1,0,drop,0,1,Known Attack
61911,445,0,0,66,66,0,1,0,1,0,drop,0,1,Known Attack
49971,53,55758,53,198,102,96,2,30,1,1,allow,0,0,Normal
53838,36829,0,0,66,66,0,1,0,1,0,deny,0,1,Known Attack
36241,443,45879,443,7768,3776,3992,21,132,11,10,allow,1,0,Potential Threat
47747,443,43132,443,4187,1350,2837,18,321,8,10,allow,1,0,Potential Threat
53392,53,29793,53,164,78,86,2,31,1,1,allow,0,0,Normal
21733,56205,0,0,66,66,0,1,0,1,0,deny,1,1,High Risk
53165,445,0,0,70,70,0,1,0,1,0,drop,0,1,Known Attack
48676,53399,0,0,60,60,0,1,0,1,0,deny,0,1,Known Attack
49511,57470,0,0,66,66,0,1,0,1,0,deny,0,1,Known Attack
52166,26467,0,0,66,66,0,1,0,1,0,deny,0,1,Known Attack
63272,445,0,0,66,66,0,1,0,1,0,drop,0,1,Known Attack
33968,443,15691,443,10073,4379,5694,33,42,17,16,allow,1,0,Potential Threat
43308,443,4843,443,120,120,0,2,5,2,0,allow,0,0,Normal
64927,445,0,0,70,70,0,1,0,1,0,drop,0,1,Known Attack
27005,32028,64745,32028,900,126,774,2,31,1,1,allow,1,0,Potential Threat
11491,53,11491,53,247,98,149,2,32,1,1,allow,1,0,Potential Threat
34924,443,1749,443,2401,1149,1252,14,982,7,7,allow,1,0,Potential Threat
6881,7999,34044,7999,238,118,120,2,1199,1,1,allow,1,0,Potential Threat
1024,57470,0,0,62,62,0,1,0,1,0,deny,1,1,High Risk
50562,80,50562,80,1696,996,700,11,22,6,5,allow,0,0,Normal
57881,443,48213,443,3486,2064,1422,26,177,14,12,allow,1,0,Potential Threat
52108,20175,5769,20175,70,70,0,2,8,2,0,allow,1,0,Potential Threat
55058,80,17892,80,48751,3044,45707,57,60,23,34,allow,1,0,Potential Threat
58593,57470,0,0,62,62,0,1,0,1,0,deny,1,1,High Risk
55893,53,33227,53,267,94,173,4,56,2,2,allow,0,0,Normal
65127,53,25987,53,780,104,676,2,31,1,1,allow,0,0,Normal
33228,443,46001,443,2567,1173,1394,19,179,8,11,allow,1,0,Potential Threat
56219,22114,0,0,62,62,0,1,0,1,0,deny,0,1,Known Attack
51596,445,0,0,70,70,0,1,0,1,0,drop,0,1,Known Attack
13462,35440,0,0,62,62,0,1,0,1,0,deny,1,1,High Risk
58373,445,0,0,66,66,0,1,0,1,0,drop,0,1,Known Attack
59944,80,15920,80,1052,612,440,10,15,5,5,allow,1,0,Potential Threat
26566,44847,0,0,66,66,0,1,0,1,0,deny,1,1,High Risk
47665,443,4370,443,214,140,74,4,15,3,1,allow,0,0,Normal
56581,80,13177,80,1630,918,712,12,17,7,5,allow,0,0,Normal
63517,445,0,0,66,66,0,1,0,1,0,drop,0,1,Known Attack
17750,1024,34469,1024,323,150,173,2,1200,1,1,allow,1,0,Potential Threat
63963,53,56258,53,262,86,176,4,46,2,2,allow,0,0,Normal
64422,53,60156,53,180,94,86,2,29,1,1,allow,0,0,Normal
27005,27015,18205,27015,888,126,762,3,32,2,1,allow,1,0,Potential Threat
58477,445,0,0,70,70,0,1,0,1,0,drop,0,1,Known Attack
58453,443,9103,443,9972,2138,7834,39,130,19,20,allow,1,0,Potential Threat
12530,35440,0,0,62,62,0,1,0,1,0,deny,1,1,High Risk
49198,53,53619,53,308,118,190,2,30,1,1,allow,0,0,Normal
26351,22114,0,0,62,62,0,1,0,1,0,deny,0,1,Known Attack
64324,53,12173,53,174,89,85,2,30,1,1,allow,0,0,Normal
50455,443,11561,443,107749,6262,101487,142,138,58,84,allow,1,0,Potential Threat
33970,443,28633,443,2586,832,1754,14,15,7,7,allow,1,0,Potential Threat
49196,445,0,0,66,66,0,1,0,1,0,drop,0,1,Known Attack
49620,53,16282,53,198,110,88,2,29,1,1,allow,0,0,Normal
33539,443,27903,443,3244,2042,1202,17,16,9,8,allow,1,0,Potential Threat
13907,57470,0,0,66,66,0,1,0,1,0,deny,1,1,High Risk
56926,80,46037,80,214,140,74,4,25,3,1,allow,0,0,Normal
49951,53,52674,53,525,110,415,2,30,1,1,allow,0,0,Normal
54502,34729,0,0,66,66,0,1,0,1,0,deny,0,1,Known Attack
50489,443,45489,443,1268,638,630,12,17,7,5,allow,1,0,Potential Threat
9311,443,26204,443,4082,958,3124,14,26,8,6,allow,1,0,Potential Threat
59982,80,63868,80,207418,4580,202838,194,143,50,144,allow,1,0,Potential Threat
59381,53,57847,53,189,78,111,2,30,1,1,allow,0,0,Normal
63854,16437,6082,16437,70,70,0,1,4,1,0,allow,1,0,Potential Threat
65196,53,54719,53,392,90,302,4,55,2,2,allow,0,0,Normal
50415,443,63011,443,2542,1504,1038,16,20,9,7,allow,1,0,Potential Threat
56344,53,6437,53,199,102,97,2,31,1,1,allow,0,0,Normal
56624,53,64033,53,199,102,97,2,30,1,1,allow,1,0,Potential Threat
60308,37965,0,0,66,66,0,1,0,1,0,deny,0,1,Known Attack
55351,445,0,0,66,66,0,1,0,1,0,drop,0,1,Known Attack
60424,443,16988,443,1477,940,537,13,26,7,6,allow,1,0,Potential Threat
1923,53,53314,53,260,86,174,2,30,1,1,allow,1,0,Potential Threat
53762,9587,5160,9587,70,70,0,1,4,1,0,allow,1,0,Potential Threat
54684,37965,0,0,62,62,0,1,0,1,0,deny,0,1,Known Attack
27005,27017,41161,27017,883,126,757,2,30,1,1,allow,1,0,Potential Threat
55551,53,54639,53,788,108,680,2,30,1,1,allow,0,0,Normal
56268,44847,0,0,66,66,0,1,0,1,0,deny,0,1,Known Attack
34661,53,34661,53,414,268,146,3,33,2,1,allow,0,0,Normal
50156,53,35377,53,178,94,84,2,29,1,1,allow,0,0,Normal
14692,443,14692,443,95958,6670,89288,139,80,68,71,allow,1,0,Potential Threat
2437,53,2437,53,229,90,139,2,30,1,1,allow,1,0,Potential Threat
44846,53,44846,53,653,349,304,5,30,3,2,allow,0,0,Normal
44417,53,0,0,82,82,0,2,40,2,0,allow,0,0,Normal
53454,443,37572,443,10416,3195,7221,32,46,18,14,allow,1,0,Potential Threat
57008,123,60959,123,184,94,90,2,30,1,1,allow,0,0,Normal
64332,53,40499,53,167,86,81,2,30,1,1,allow,0,0,Normal
53705,30600,18470,30600,492,306,186,8,15,5,3,allow,1,0,Potential Threat
56375,53,32161,53,216,110,106,2,31,1,1,allow,0,0,Normal
50143,35253,0,0,66,66,0,1,0,1,0,deny,0,1,Known Attack
5223,1210,0,0,66,66,0,1,0,1,0,deny,0,1,Known Attack
61850,34021,0,0,66,66,0,1,91,1,0,allow,1,0,Potential Threat
56682,53,37640,53,168,86,82,2,30,1,1,allow,0,0,Normal
4138,55777,0,0,66,66,0,1,0,1,0,deny,1,1,High Risk
57396,445,0,0,66,66,0,1,0,1,0,drop,0,1,Known Attack
65291,53,24701,53,195,102,93,2,30,1,1,allow,0,0,Normal
123,123,40397,123,184,94,90,2,30,1,1,allow,1,0,Potential Threat
55548,445,0,0,66,66,0,1,0,1,0,drop,0,1,Known Attack
38484,48637,0,0,60,60,0,1,0,1,0,deny,0,1,Known Attack
57434,445,0,0,70,70,0,1,0,1,0,drop,0,1,Known Attack
44912,443,31289,443,414,140,274,7,26,3,4,allow,0,0,Normal
51659,80,25484,80,318,192,126,6,37,4,2,allow,0,0,Normal
56604,443,5643,443,7915,1926,5989,20,15,11,9,allow,1,0,Potential Threat
64471,53,53728,53,264,110,154,2,30,1,1,allow,0,0,Normal
58016,80,61881,80,378,192,186,7,21,4,3,allow,1,0,Potential Threat
58178,53,58178,53,237,93,144,2,31,1,1,allow,0,0,Normal
64557,445,0,0,70,70,0,1,0,1,0,drop,0,1,Known Attack
2707,37,0,0,60,60,0,1,0,1,0,deny,1,1,High Risk
60209,443,58823,443,26423,2338,24085,50,152,24,26,allow,1,0,Potential Threat
59015,445,0,0,66,66,0,1,0,1,0,drop,0,1,Known Attack
52041,48103,59658,48103,70,70,0,1,5,1,0,allow,1,0,Potential Threat
50064,445,0,0,70,70,0,1,0,1,0,drop,0,1,Known Attack
64609,53,8196,53,404,95,309,4,43,2,2,allow,0,0,Normal
49847,80,28928,80,4135,2587,1548,10,89,7,3,allow,1,0,Potential Threat
57833,443,7309,443,215996,13055,202941,265,127,96,169,allow,1,0,Potential Threat
49686,53,23134,53,183,94,89,2,30,1,1,allow,0,0,Normal
57402,2258,57402,2258,156,156,0,3,8,3,0,allow,1,0,Potential Threat
49418,27015,20028,27015,264,78,186,2,29,1,1,allow,1,0,Potential Threat
58762,443,39294,443,318,192,126,6,25,4,2,allow,0,0,Normal
58907,443,50091,443,2976,1572,1404,17,17,9,8,allow,1,0,Potential Threat
57106,53,8204,53,760,97,663,2,31,1,1,allow,0,0,Normal
1114,37965,0,0,62,62,0,1,0,1,0,deny,1,1,High Risk
40919,443,40161,443,12243,6818,5425,30,314,16,14,allow,1,0,Potential Threat
51481,53,20508,53,168,78,90,2,30,1,1,allow,0,0,Normal
14993,50584,0,0,62,62,0,1,0,1,0,deny,1,1,High Risk
64215,445,0,0,70,70,0,1,0,1,0,drop,0,1,Known Attack
51540,3389,51540,3389,4425,2641,1784,21,33,12,9,allow,1,0,Potential Threat
56871,53,27631,53,198,86,112,2,30,1,1,allow,0,0,Normal
50661,80,9944,80,2693,461,2232,14,17,6,8,allow,1,0,Potential Threat
56102,445,0,0,66,66,0,1,0,1,0,drop,0,1,Known Attack
56726,443,29318,443,7941,1952,5989,20,15,11,9,allow,1,0,Potential Threat
59141,445,0,0,70,70,0,1,0,1,0,drop,0,1,Known Attack
55777,445,0,0,70,70,0,1,0,1,0,drop,0,1,Known Attack
53935,42874,31408,42874,1973,1021,952,10,15,6,4,allow,1,0,Potential Threat
63982,25174,0,0,62,62,0,1,0,1,0,deny,0,1,Known Attack
23594,48983,0,0,159,159,0,1,0,1,0,deny,1,1,High Risk
2267,53,48892,53,204,118,86,2,30,1,1,allow,1,0,Potential Threat
56623,80,56144,80,234,234,0,4,12,4,0,allow,0,0,Normal
6355,25174,0,0,62,62,0,1,0,1,0,deny,1,1,High Risk
56678,445,0,0,70,70,0,1,0,1,0,drop,0,1,Known Attack
52133,445,0,0,70,70,0,1,0,1,0,drop,0,1,Known Attack
56423,53,27855,53,184,102,82,2,30,1,1,allow,0,0,Normal
25739,64147,0,0,62,62,0,1,0,1,0,deny,1,1,High Risk
51798,37020,7892,37020,70,70,0,1,5,1,0,allow,1,0,Potential Threat
55979,53,16779,53,184,102,82,2,29,1,1,allow,0,0,Normal
53194,35440,0,0,66,66,0,1,0,1,0,deny,0,1,Known Attack
52768,445,0,0,70,70,0,1,0,1,0,drop,0,1,Known Attack
16979,56205,0,0,66,66,0,1,0,1,0,deny,1,1,High Risk
36403,443,54491,443,1149,709,440,13,39,8,5,allow,1,0,Potential Threat
64294,53,36421,53,329,118,211,2,30,1,1,allow,0,0,Normal
49380,443,11402,443,2382775,72482,2310293,2485,252,843,1642,allow,1,0,Potential Threat
56242,53,30808,53,231,86,145,2,30,1,1,allow,0,0,Normal
41793,53,3227,53,168,78,90,2,30,1,1,allow,0,0,Normal
62386,37965,0,0,66,66,0,1,0,1,0,deny,0,1,Known Attack
24311,22617,0,0,60,60,0,1,0,1,0,deny,0,1,Known Attack
64815,445,0,0,70,70,0,1,0,1,0,drop,0,1,Known Attack
51617,21247,0,0,66,66,0,1,0,1,0,deny,0,1,Known Attack
59356,445,0,0,70,70,0,1,0,1,0,drop,0,1,Known Attack
49622,53,58073,53,244,94,150,2,30,1,1,allow,0,0,Normal
55682,32765,50295,32765,3529,1769,1760,11,15,6,5,allow,1,0,Potential Threat
61340,445,0,0,66,66,0,1,0,1,0,drop,0,1,Known Attack
33042,443,44384,443,10328,5341,4987,26,35,13,13,allow,1,0,Potential Threat
58835,17372,0,0,66,66,0,1,0,1,0,deny,0,1,Known Attack
56502,443,5913,443,5414,1010,4404,17,33,9,8,allow,1,0,Potential Threat
57001,53,51576,53,177,94,83,2,31,1,1,allow,0,0,Normal
49840,443,49840,443,4645,1738,2907,19,30,11,8,allow,1,0,Potential Threat
16387,7205,0,0,60,60,0,1,0,1,0,deny,0,1,Known Attack
65384,53,41711,53,197,102,95,2,30,1,1,allow,0,0,Normal
65427,53,2149,53,238,94,144,2,30,1,1,allow,0,0,Normal
35120,26467,0,0,62,62,0,1,0,1,0,deny,0,1,Known Attack
65125,445,0,0,70,70,0,1,0,1,0,drop,0,1,Known Attack
57969,42873,0,0,66,66,0,1,0,1,0,deny,0,1,Known Attack
56800,443,33972,443,7518,2862,4656,18,75,10,8,allow,1,0,Potential Threat
55193,53,45543,53,200,102,98,2,30,1,1,allow,0,0,Normal
38579,80,3885,80,996,507,489,10,200,5,5,allow,1,0,Potential Threat
51613,7000,51613,7000,2163,676,1487,14,15,7,7,allow,1,0,Potential Threat
55702,80,29070,80,70,70,0,1,5,1,0,allow,0,0,Normal
59834,445,0,0,70,70,0,1,0,1,0,drop,0,1,Known Attack
3478,61463,0,0,1305,1305,0,1,0,1,0,deny,1,1,High Risk
56742,53,0,0,82,82,0,2,40,2,0,allow,0,0,Normal
16716,57470,0,0,145,145,0,1,0,1,0,deny,1,1,High Risk
57287,53,47799,53,305,102,203,2,29,1,1,allow,0,0,Normal
64666,445,0,0,70,70,0,1,0,1,0,drop,0,1,Known Attack
53852,14099,17770,14099,320,140,180,6,6,3,3,allow,1,0,Potential Threat
62469,445,0,0,70,70,0,1,0,1,0,drop,0,1,Known Attack
55548,443,42567,443,12205,2036,10169,33,138,18,15,allow,1,0,Potential Threat
6881,35766,64668,35766,221,111,110,2,1200,1,1,allow,1,0,Potential Threat
10797,50584,0,0,62,62,0,1,0,1,0,deny,1,1,High Risk
50985,80,61422,80,613,539,74,7,15,6,1,allow,1,0,Potential Threat
56260,53,6502,53,177,94,83,2,30,1,1,allow,0,0,Normal
50052,65010,0,0,60,60,0,1,0,1,0,deny,1,1,High Risk
42298,40002,11642,40002,724,550,174,4,30,2,2,allow,1,0,Potential Threat
51505,17372,0,0,66,66,0,1,0,1,0,deny,0,1,Known Attack
52011,80,26180,80,23580,10536,13044,36,39,18,18,allow,1,0,Potential Threat
51732,50584,0,0,146,146,0,1,0,1,0,deny,1,1,High Risk
64489,53,3033,53,320,97,223,4,50,2,2,allow,1,0,Potential Threat
61522,445,0,0,70,70,0,1,0,1,0,drop,0,1,Known Attack
56794,1,30345,1,70,70,0,1,5,1,0,allow,0,0,Normal
63861,37832,6242,37832,66,66,0,2,7,2,0,allow,1,0,Potential Threat
10963,53,10963,53,216,90,126,2,30,1,1,allow,0,0,Normal
27005,1201,20493,1201,867,126,741,2,30,1,1,allow,1,0,Potential Threat
23997,53,23997,53,230,90,140,2,30,1,1,allow,0,0,Normal
50946,80,36199,80,5870176,83236,5786940,5053,78,1161,3892,allow,1,0,Potential Threat
26900,27017,21825,27017,422,164,258,6,31,3,3,allow,1,0,Potential Threat
50910,445,0,0,70,70,0,1,0,1,0,drop,0,1,Known Attack
55627,26192,18323,26192,70,70,0,1,5,1,0,allow,1,0,Potential Threat
62591,445,0,0,70,70,0,1,0,1,0,drop,0,1,Known Attack
33801,62413,0,0,66,66,0,1,0,1,0,deny,1,1,High Risk
49994,80,9515,80,2618,591,2027,11,16,6,5,allow,1,0,Potential Threat
50349,80,24554,80,3909,888,3021,12,15,6,6,allow,1,0,Potential Threat
51468,445,0,0,70,70,0,1,0,1,0,drop,0,1,Known Attack
27005,27015,56758,27015,869,126,743,2,30,1,1,allow,1,0,Potential Threat
2362,53,2362,53,225,90,135,2,30,1,1,allow,1,0,Potential Threat
38598,80,50146,80,1114,534,580,12,16,7,5,allow,1,0,Potential Threat
57354,53,64428,53,198,94,104,2,29,1,1,allow,1,0,Potential Threat
53640,25174,0,0,66,66,0,1,0,1,0,deny,0,1,Known Attack
64744,445,0,0,66,66,0,1,0,1,0,drop,0,1,Known Attack
5416,53,5416,53,213,79,134,2,33,1,1,allow,1,0,Potential Threat
59762,443,29034,443,382,164,218,2,31,1,1,allow,0,0,Normal
57007,445,0,0,70,70,0,1,0,1,0,drop,0,1,Known Attack
51729,63553,6792,63553,70,70,0,1,5,1,0,allow,1,0,Potential Threat
63433,443,29608,443,1950,1231,719,20,15,12,8,allow,1,0,Potential Threat
45941,23386,0,0,60,60,0,1,0,1,0,deny,0,1,Known Attack
11404,64147,0,0,62,62,0,1,0,1,0,deny,1,1,High Risk
56864,53,8861,53,200,102,98,2,30,1,1,allow,0,0,Normal
56164,53,3250,53,226,110,116,2,30,1,1,allow,0,0,Normal
36394,443,29956,443,8714,1606,7108,24,34,12,12,allow,1,0,Potential Threat
34814,80,10830,80,9105,1930,7175,18,16,9,9,allow,1,0,Potential Threat
65480,445,0,0,66,66,0,1,0,1,0,drop,0,1,Known Attack
64299,53,64359,53,166,86,80,2,30,1,1,allow,1,0,Potential Threat
56643,53,21130,53,195,102,93,2,31,1,1,allow,0,0,Normal
43227,443,35933,443,1139403,49178,1090225,1155,108,353,802,allow,1,0,Potential Threat
11056,6881,0,0,62,62,0,1,0,1,0,deny,0,1,Known Attack
50089,53,56216,53,718,94,624,2,30,1,1,allow,0,0,Normal
60560,445,0,0,70,70,0,1,0,1,0,drop,0,1,Known Attack
51811,443,43399,443,4007,2063,1944,12,122,6,6,allow,1,0,Potential Threat
55942,53,15569,53,197,102,95,2,30,1,1,allow,0,0,Normal
55464,53,8236,53,214,110,104,2,30,1,1,allow,0,0,Normal
49255,44847,0,0,66,66,0,1,0,1,0,deny,0,1,Known Attack
52098,5228,3628,5228,3117,1602,1515,31,66,16,15,allow,1,0,Potential Threat
56596,53,26887,53,198,101,97,2,30,1,1,allow,0,0,Normal
35422,443,43455,443,154,94,60,2,5,1,1,allow,0,0,Normal
16387,8455,0,0,60,60,0,1,0,1,0,deny,0,1,Known Attack
63062,53,6744,53,303,85,218,2,30,1,1,allow,0,0,Normal
1038,37965,0,0,62,62,0,1,0,1,0,deny,1,1,High Risk
38119,443,46487,443,1820,1101,719,18,16,10,8,allow,1,0,Potential Threat
51955,39871,23023,39871,70,70,0,2,8,2,0,allow,1,0,Potential Threat
51973,80,57539,80,426,240,186,8,26,5,3,allow,0,0,Normal
56185,443,34268,443,5415,1730,3685,20,120,9,11,allow,1,0,Potential Threat
24301,6881,0,0,146,146,0,1,0,1,0,deny,0,1,Known Attack
54979,53,30018,53,207,97,110,3,64,2,1,allow,0,0,Normal
57668,445,0,0,66,66,0,1,0,1,0,drop,0,1,Known Attack
56346,53,56346,53,262,106,156,2,32,1,1,allow,0,0,Normal
56956,53,61460,53,183,94,89,2,30,1,1,allow,0,0,Normal
13035,25174,0,0,146,146,0,1,0,1,0,deny,1,1,High Risk
57632,445,0,0,70,70,0,1,0,1,0,drop,0,1,Known Attack
49364,443,26461,443,8376,2198,6178,25,81,14,11,allow,1,0,Potential Threat
63588,443,6782,443,11301,2292,9009,37,165,20,17,allow,1,0,Potential Threat
59803,445,0,0,66,66,0,1,0,1,0,drop,0,1,Known Attack
51751,80,4770,80,1854,1360,494,12,15,7,5,allow,1,0,Potential Threat
51938,80,6039,80,82321,4061,78260,109,61,50,59,allow,1,0,Potential Threat
54148,443,30287,443,272587,11910,260677,336,76,140,196,allow,1,0,Potential Threat
49700,443,6522,443,39240,3804,35436,72,133,38,34,allow,1,0,Potential Threat
63978,53,35344,53,214,110,104,2,30,1,1,allow,0,0,Normal
64212,53,41326,53,215,102,113,2,30,1,1,allow,0,0,Normal
63899,62015,4677,62015,66,66,0,2,8,2,0,allow,1,0,Potential Threat
49622,80,33304,80,454,262,192,8,42,5,3,allow,0,0,Normal
3478,45401,0,0,109,109,0,1,0,1,0,deny,1,1,High Risk
57996,53,57996,53,265,114,151,2,30,1,1,allow,0,0,Normal
27005,27015,63024,27015,897,126,771,2,31,1,1,allow,1,0,Potential Threat
53185,443,52524,443,4442408,142153,4300255,4731,235,1574,3157,allow,1,0,Potential Threat
64540,53,24153,53,179,94,85,2,30,1,1,allow,0,0,Normal
50700,80,4259,80,417,417,0,4,9,4,0,allow,0,0,Normal
58871,443,24134,443,5106,700,4406,15,15,7,8,allow,1,0,Potential Threat
57442,445,0,0,70,70,0,1,0,1,0,drop,0,1,Known Attack
50279,443,26201,443,1128,654,474,17,18,10,7,allow,0,0,Normal
24534,50584,0,0,62,62,0,1,0,1,0,deny,1,1,High Risk
56490,445,0,0,70,70,0,1,0,1,0,drop,0,1,Known Attack
57470,58210,46855,58210,2118,858,1260,28,1261,14,14,allow,1,0,Potential Threat
44792,80,52125,80,1295,781,514,12,16,6,6,allow,1,0,Potential Threat
57429,443,7406,443,15017,8283,6734,47,18,24,23,allow,1,0,Potential Threat
57263,445,0,0,70,70,0,1,0,1,0,drop,0,1,Known Attack
16387,56995,0,0,60,60,0,1,0,1,0,deny,1,1,High Risk
62219,25174,0,0,146,146,0,1,0,1,0,deny,1,1,High Risk
45964,2228,0,0,60,60,0,1,0,1,0,deny,0,1,Known Attack
49785,53,52317,53,211,110,101,2,30,1,1,allow,0,0,Normal
24301,6881,0,0,62,62,0,1,0,1,0,deny,0,1,Known Attack
63261,445,0,0,66,66,0,1,0,1,0,drop,0,1,Known Attack
41458,443,29775,443,13059,5161,7898,34,84,19,15,allow,1,0,Potential Threat
59315,35440,0,0,62,62,0,1,0,1,0,deny,0,1,Known Attack
52406,443,12118,443,11463,850,10613,23,25,7,16,allow,1,0,Potential Threat
55723,80,12672,80,70,70,0,2,8,2,0,allow,0,0,Normal
46461,53,27823,53,199,94,105,2,30,1,1,allow,0,0,Normal
62197,445,0,0,70,70,0,1,0,1,0,drop,0,1,Known Attack
52149,52188,10170,52188,70,70,0,1,5,1,0,allow,1,0,Potential Threat
42925,443,37247,443,5617,1559,4058,22,138,13,9,allow,1,0,Potential Threat
64792,53,60591,53,166,86,80,2,30,1,1,allow,0,0,Normal
45374,443,48527,443,88469,3492,84977,104,396,35,69,allow,1,0,Potential Threat
60897,443,29377,443,10706,1679,9027,27,46,15,12,allow,1,0,Potential Threat
6666,21,0,0,60,60,0,1,0,1,0,deny,0,1,Known Attack
57762,445,0,0,66,66,0,1,0,1,0,drop,0,1,Known Attack
50459,62413,0,0,62,62,0,1,0,1,0,deny,1,1,High Risk
62051,11392,0,0,66,66,0,1,0,1,0,deny,0,1,Known Attack
51847,80,28250,80,366,240,126,7,31,5,2,allow,0,0,Normal
48040,53,11212,53,168,78,90,2,30,1,1,allow,0,0,Normal
54004,445,0,0,70,70,0,1,0,1,0,drop,0,1,Known Attack
34856,443,47870,443,7524,1903,5621,31,22,18,13,allow,1,0,Potential Threat
58102,443,20475,443,14197,9283,4914,28,122,15,13,allow,1,0,Potential Threat
123,123,44322,123,184,94,90,2,29,1,1,allow,1,0,Potential Threat
58751,9571,0,0,62,62,0,1,0,1,0,deny,0,1,Known Attack
57987,3478,8652,3478,312,140,172,4,30,2,2,allow,0,0,Normal
53676,3678,29317,3678,70,70,0,2,7,2,0,allow,1,0,Potential Threat
40418,25174,0,0,62,62,0,1,0,1,0,deny,0,1,Known Attack
64327,53,41700,53,210,110,100,2,30,1,1,allow,0,0,Normal
64382,44847,0,0,62,62,0,1,0,1,0,deny,1,1,High Risk
58390,53,44510,53,240,76,164,2,31,1,1,allow,0,0,Normal
56497,53,2084,53,170,87,83,2,31,1,1,allow,0,0,Normal
55976,445,0,0,70,70,0,1,0,1,0,drop,0,1,Known Attack
41270,443,43404,443,14659,5023,9636,46,400,14,32,allow,1,0,Potential Threat
53289,445,0,0,70,70,0,1,0,1,0,drop,0,1,Known Attack
63902,445,0,0,70,70,0,1,0,1,0,drop,0,1,Known Attack
56062,53,2393,53,192,98,94,2,31,1,1,allow,0,0,Normal
52533,53,8262,53,242,78,164,2,30,1,1,allow,0,0,Normal
35584,80,52820,80,1507,454,1053,10,15,5,5,allow,1,0,Potential Threat
29706,50584,0,0,62,62,0,1,0,1,0,deny,1,1,High Risk
53619,443,9096,443,24190,18242,5948,43,330,25,18,allow,1,0,Potential Threat
65092,53,51583,53,263,94,169,2,30,1,1,allow,0,0,Normal
9315,443,40509,443,3649,424,3225,12,15,6,6,allow,1,0,Potential Threat
34952,53,65291,53,177,94,83,2,30,1,1,allow,1,0,Potential Threat
53805,34155,22730,34155,70,70,0,1,4,1,0,allow,1,0,Potential Threat
6881,6881,0,0,62,62,0,1,0,1,0,deny,0,1,Known Attack
31675,19473,0,0,145,145,0,1,0,1,0,deny,1,1,High Risk
50910,445,0,0,66,66,0,1,0,1,0,drop,0,1,Known Attack
1043,30170,0,0,159,159,0,1,0,1,0,deny,1,1,High Risk
57470,1,27948,1,132,132,0,3,1199,3,0,allow,1,0,Potential Threat
55921,43890,0,0,62,62,0,1,0,1,0,deny,0,1,Known Attack
58430,445,0,0,66,66,0,1,0,1,0,drop,0,1,Known Attack
52925,3389,0,0,60,60,0,1,0,1,0,deny,0,1,Known Attack
56191,53,27279,53,177,94,83,2,30,1,1,allow,0,0,Normal
1027,57866,0,0,62,62,0,1,0,1,0,deny,1,1,High Risk
63996,53,49603,53,252,102,150,2,30,1,1,allow,0,0,Normal
64841,6881,0,0,62,62,0,1,0,1,0,deny,0,1,Known Attack
58795,443,24808,443,10273,2573,7700,24,305,8,16,allow,1,0,Potential Threat
51876,35624,28526,35624,70,70,0,2,8,2,0,allow,1,0,Potential Threat
62303,445,0,0,70,70,0,1,0,1,0,drop,0,1,Known Attack
22530,25174,0,0,62,62,0,1,0,1,0,deny,0,1,Known Attack
53858,443,59816,443,499,425,74,4,1,3,1,allow,0,0,Normal
49326,445,0,0,70,70,0,1,0,1,0,drop,0,1,Known Attack
47091,443,62680,443,3543,1570,1973,18,120,9,9,allow,1,0,Potential Threat
62192,445,0,0,70,70,0,1,0,1,0,drop,0,1,Known Attack
49744,53,33458,53,193,102,91,2,30,1,1,allow,0,0,Normal
52472,445,0,0,66,66,0,1,0,1,0,drop,0,1,Known Attack
58242,445,0,0,66,66,0,1,0,1,0,drop,0,1,Known Attack
64674,445,0,0,70,70,0,1,0,1,0,drop,0,1,Known Attack
61762,44847,0,0,62,62,0,1,0,1,0,deny,1,1,High Risk
57352,53,7772,53,196,102,94,2,29,1,1,allow,0,0,Normal
60854,42873,0,0,66,66,0,1,0,1,0,deny,0,1,Known Attack
57349,445,0,0,70,70,0,1,0,1,0,drop,0,1,Known Attack
58638,5900,0,0,62,62,0,1,0,1,0,deny,0,1,Known Attack
51512,443,52808,443,626132,21332,604800,730,33,294,436,allow,1,0,Potential Threat
63340,53,0,0,84,84,0,1,0,1,0,deny,0,1,Known Attack
55201,22114,0,0,66,66,0,1,0,1,0,deny,0,1,Known Attack
34616,443,64459,443,9265,4429,4836,23,18,14,9,allow,1,0,Potential Threat
37558,16386,20045,16386,432,192,240,8,30,4,4,allow,1,0,Potential Threat
58638,5900,0,0,62,62,0,1,0,1,0,deny,0,1,Known Attack
11988,48817,0,0,66,66,0,1,0,1,0,deny,1,1,High Risk
50888,445,0,0,70,70,0,1,0,1,0,drop,0,1,Known Attack
39402,443,48958,443,6417,1255,5162,24,360,12,12,allow,1,0,Potential Threat
57678,445,0,0,70,70,0,1,0,1,0,drop,0,1,Known Attack
64525,443,3519,443,5981,1902,4079,14,120,7,7,allow,1,0,Potential Threat
54827,50432,0,0,109,109,0,1,0,1,0,deny,1,1,High Risk
515,10214,0,0,66,66,0,1,0,1,0,deny,1,1,High Risk
59967,445,0,0,70,70,0,1,0,1,0,drop,0,1,Known Attack
56753,44847,0,0,62,62,0,1,0,1,0,deny,0,1,Known Attack
65118,445,0,0,70,70,0,1,0,1,0,drop,0,1,Known Attack
43584,24748,0,0,156,156,0,1,0,1,0,deny,1,1,High Risk
50584,30773,22058,30773,1356,300,1056,6,1200,3,3,allow,1,0,Potential Threat
65216,35440,0,0,66,66,0,1,0,1,0,deny,0,1,Known Attack
55134,53,55134,53,825,99,726,2,31,1,1,allow,0,0,Normal
53829,445,0,0,66,66,0,1,0,1,0,drop,0,1,Known Attack
55251,53,49536,53,212,110,102,2,30,1,1,allow,0,0,Normal
56784,443,32848,443,7957,1968,5989,20,15,11,9,allow,1,0,Potential Threat
12530,35440,0,0,66,66,0,1,0,1,0,deny,1,1,High Risk
56236,443,26673,443,9597,2488,7109,32,287,16,16,allow,1,0,Potential Threat
55727,53,51328,53,190,97,93,2,30,1,1,allow,0,0,Normal
63960,53,27823,53,178,94,84,2,30,1,1,allow,0,0,Normal
61332,445,0,0,70,70,0,1,0,1,0,drop,0,1,Known Attack
8999,43109,0,0,146,146,0,1,0,1,0,deny,1,1,High Risk
55478,443,16411,443,23029908,732047,22297861,24550,183,8143,16407,allow,1,0,Potential Threat
59741,443,12538,443,384,166,218,2,30,1,1,allow,0,0,Normal
64216,445,0,0,66,66,0,1,0,1,0,drop,0,1,Known Attack
59399,445,0,0,66,66,0,1,0,1,0,drop,0,1,Known Attack
62341,445,0,0,70,70,0,1,0,1,0,drop,0,1,Known Attack
57667,445,0,0,66,66,0,1,0,1,0,drop,0,1,Known Attack
37965,7765,33226,7765,460,150,310,2,1199,1,1,allow,1,0,Potential Threat
55100,53,34612,53,182,102,80,2,30,1,1,allow,0,0,Normal
50809,445,0,0,66,66,0,1,0,1,0,drop,0,1,Known Attack
55725,14704,64431,14704,70,70,0,1,5,1,0,allow,1,0,Potential Threat
51930,80,17993,80,1669,865,804,13,76,8,5,allow,0,0,Normal
51696,14370,13279,14370,70,70,0,1,5,1,0,allow,1,0,Potential Threat
50197,445,0,0,70,70,0,1,0,1,0,drop,0,1,Known Attack
50784,50584,0,0,62,62,0,1,0,1,0,deny,0,1,Known Attack
65270,3855,0,0,78,78,0,1,0,1,0,deny,0,1,Known Attack
63954,53,25119,53,352,102,250,2,29,1,1,allow,0,0,Normal
59950,53,51206,53,395,115,280,2,30,1,1,allow,0,0,Normal
34572,443,63392,443,52330,13948,38382,131,129,71,60,allow,1,0,Potential Threat
56676,37965,0,0,62,62,0,1,0,1,0,deny,0,1,Known Attack
55216,53,0,0,192,86,106,2,30,1,1,allow,0,0,Normal
51413,48637,0,0,72,72,0,1,0,1,0,deny,0,1,Known Attack
56931,445,0,0,70,70,0,1,0,1,0,drop,0,1,Known Attack
47661,443,40195,443,3718,420,3298,13,120,6,7,allow,1,0,Potential Threat
51244,445,0,0,66,66,0,1,0,1,0,drop,0,1,Known Attack
64094,443,64094,443,5647,2402,3245,26,159,14,12,allow,1,0,Potential Threat
55644,53,55094,53,184,94,90,2,30,1,1,allow,0,0,Normal
57340,3333,57340,3333,24544,10921,13623,171,1095,89,82,allow,1,0,Potential Threat
50499,80,43182,80,318,192,126,6,25,4,2,allow,0,0,Normal
46734,53,46734,53,314,98,216,2,29,1,1,allow,0,0,Normal
51490,1,0,0,100,100,0,1,0,1,0,deny,0,1,Known Attack
49216,53,15355,53,181,94,87,2,30,1,1,allow,0,0,Normal
54385,445,0,0,70,70,0,1,0,1,0,drop,0,1,Known Attack
50218,53,12883,53,165,86,79,2,29,1,1,allow,0,0,Normal
48422,53,48422,53,229,89,140,2,30,1,1,allow,0,0,Normal
60118,445,0,0,70,70,0,1,0,1,0,drop,0,1,Known Attack
49876,53,54830,53,199,102,97,2,30,1,1,allow,0,0,Normal
54327,445,0,0,70,70,0,1,0,1,0,drop,0,1,Known Attack
64665,53,63171,53,91,91,0,1,30,1,0,allow,1,0,Potential Threat
37096,443,16174,443,130,70,60,2,15,1,1,allow,0,0,Normal
65359,53,51803,53,731,91,640,2,30,1,1,allow,0,0,Normal
64569,53,17459,53,183,94,89,2,30,1,1,allow,0,0,Normal
57394,53,16872,53,186,95,91,2,31,1,1,allow,0,0,Normal
55959,53,27240,53,216,102,114,2,29,1,1,allow,0,0,Normal
57148,445,0,0,70,70,0,1,0,1,0,drop,0,1,Known Attack
49585,53,39603,53,732,86,646,2,30,1,1,allow,0,0,Normal
52239,1172,16970,1172,256,136,120,5,5,3,2,allow,0,0,Normal
49224,53,4375,53,199,102,97,2,32,1,1,allow,0,0,Normal
55216,53,52646,53,179,94,85,2,30,1,1,allow,0,0,Normal
49444,53,22362,53,212,102,110,2,30,1,1,allow,0,0,Normal
13996,56205,0,0,62,62,0,1,0,1,0,deny,1,1,High Risk
1523,22,0,0,60,60,0,1,0,1,0,deny,1,1,High Risk
64766,53,54775,53,195,102,93,2,30,1,1,allow,0,0,Normal
64344,53,51510,53,286,102,184,4,45,2,2,allow,0,0,Normal
57706,64147,0,0,66,66,0,1,0,1,0,deny,1,1,High Risk
51747,54301,33615,54301,136,136,0,3,14,3,0,allow,1,0,Potential Threat
51502,445,0,0,66,66,0,1,0,1,0,drop,0,1,Known Attack
65286,445,0,0,70,70,0,1,0,1,0,drop,0,1,Known Attack
26937,23,0,0,60,60,0,1,0,1,0,deny,0,1,Known Attack
56625,53,55820,53,193,102,91,2,30,1,1,allow,0,0,Normal
40893,123,36091,123,184,94,90,2,31,1,1,allow,0,0,Normal
53640,28937,48559,28937,70,70,0,2,8,2,0,allow,1,0,Potential Threat
17315,11392,0,0,66,66,0,1,0,1,0,deny,0,1,Known Attack
56183,445,0,0,70,70,0,1,0,1,0,drop,0,1,Known Attack
55688,33958,16437,33958,70,70,0,1,5,1,0,allow,1,0,Potential Threat
56737,445,0,0,70,70,0,1,0,1,0,drop,0,1,Known Attack
46440,443,14076,443,8465,3202,5263,23,120,10,13,allow,1,0,Potential Threat
64567,443,24686,443,24984,2042,22942,41,32,19,22,allow,1,0,Potential Threat
49589,443,40471,443,327575,8400,319175,334,316,113,221,allow,1,0,Potential Threat
48817,51417,48817,51417,485,158,327,2,1200,1,1,allow,1,0,Potential Threat
56990,80,57120,80,214,140,74,4,35,3,1,allow,0,0,Normal
36628,80,34664,80,78,78,0,1,4,1,0,allow,0,0,Normal
40512,57470,0,0,74,74,0,1,0,1,0,deny,1,1,High Risk
49984,53,41486,53,172,88,84,2,30,1,1,allow,0,0,Normal
65070,445,0,0,66,66,0,1,0,1,0,drop,0,1,Known Attack
53730,37965,0,0,66,66,0,1,0,1,0,deny,0,1,Known Attack
38795,40032,51125,40032,243,180,63,2,31,1,1,allow,1,0,Potential Threat
56421,53,8309,53,177,94,83,2,30,1,1,allow,0,0,Normal
3478,61463,0,0,1004,1004,0,1,0,1,0,deny,1,1,High Risk
50584,6889,7914,6889,1326,300,1026,6,1200,3,3,allow,1,0,Potential Threat
56694,53,47429,53,196,102,94,2,29,1,1,allow,0,0,Normal
31675,23,0,0,60,60,0,1,0,1,0,deny,0,1,Known Attack
56156,445,0,0,70,70,0,1,0,1,0,drop,0,1,Known Attack
61424,80,26157,80,214,140,74,4,41,3,1,allow,0,0,Normal
51829,445,0,0,66,66,0,1,0,1,0,drop,0,1,Known Attack
50741,445,0,0,66,66,0,1,0,1,0,drop,0,1,Known Attack
40217,443,61607,443,5377,857,4520,21,88,8,13,allow,1,0,Potential Threat
45816,443,14384,443,21950,3632,18318,46,140,20,26,allow,1,0,Potential Threat
63641,445,0,0,66,66,0,1,0,1,0,drop,0,1,Known Attack
57524,445,0,0,70,70,0,1,0,1,0,drop,0,1,Known Attack
56812,445,0,0,70,70,0,1,0,1,0,drop,0,1,Known Attack
56052,445,0,0,70,70,0,1,0,1,0,drop,0,1,Known Attack
57034,443,8240,443,30645,2719,27926,60,153,25,35,allow,1,0,Potential Threat
50368,443,46131,443,8048,1189,6859,19,25,10,9,allow,1,0,Potential Threat
58583,443,61583,443,8605,3169,5436,19,17,12,7,allow,1,0,Potential Threat
34936,30188,0,0,66,66,0,1,0,1,0,deny,0,1,Known Attack
58638,5900,0,0,62,62,0,1,0,1,0,deny,0,1,Known Attack
50877,30041,0,0,66,66,0,1,0,1,0,deny,0,1,Known Attack
32491,15503,0,0,66,66,0,1,0,1,0,deny,0,1,Known Attack
58638,5900,0,0,62,62,0,1,0,1,0,deny,0,1,Known Attack
53798,53,26638,53,224,86,138,2,30,1,1,allow,0,0,Normal
38714,443,54689,443,90043,3609,86434,97,15,33,64,allow,1,0,Potential Threat
65377,53,44573,53,193,102,91,2,31,1,1,allow,0,0,Normal
1165,53,1165,53,196,88,108,2,30,1,1,allow,1,0,Potential Threat
58944,445,0,0,70,70,0,1,0,1,0,drop,0,1,Known Attack
33733,443,7805,443,6998,2361,4637,20,17,10,10,allow,1,0,Potential Threat
50095,30188,0,0,66,66,0,1,0,1,0,deny,0,1,Known Attack
36881,443,36881,443,4652,1745,2907,19,28,11,8,allow,1,0,Potential Threat
57018,53,10253,53,177,94,83,2,30,1,1,allow,0,0,Normal
52450,443,52450,443,4750,1843,2907,19,26,11,8,allow,1,0,Potential Threat
51502,443,28500,443,10204,5034,5170,45,16,25,20,allow,1,0,Potential Threat
55598,41565,5694,41565,70,70,0,1,5,1,0,allow,1,0,Potential Threat
58638,5900,0,0,62,62,0,1,0,1,0,deny,0,1,Known Attack
61349,445,0,0,66,66,0,1,0,1,0,drop,0,1,Known Attack
60248,30188,0,0,66,66,0,1,0,1,0,deny,0,1,Known Attack
54339,23117,0,0,66,66,0,1,0,1,0,deny,0,1,Known Attack
49001,65473,0,0,174,174,0,1,0,1,0,deny,1,1,High Risk
49640,445,0,0,66,66,0,1,0,1,0,drop,0,1,Known Attack
52418,46314,0,0,66,66,0,1,0,1,0,deny,0,1,Known Attack
64605,53,37496,53,183,94,89,2,30,1,1,allow,0,0,Normal
56243,53,64458,53,762,101,661,2,30,1,1,allow,1,0,Potential Threat
53764,6881,51389,6881,1463,821,642,15,15,8,7,allow,1,0,Potential Threat
55697,53,14156,53,193,102,91,2,31,1,1,allow,0,0,Normal
59032,25174,0,0,66,66,0,1,0,1,0,deny,0,1,Known Attack
56352,80,27612,80,1258,752,506,13,16,7,6,allow,0,0,Normal
50227,57470,0,0,66,66,0,1,0,1,0,deny,0,1,Known Attack
65107,53,32581,53,266,110,156,2,30,1,1,allow,0,0,Normal
64649,53,33149,53,225,102,123,2,30,1,1,allow,0,0,Normal
61442,443,19223,443,3403,1891,1512,24,42,13,11,allow,1,0,Potential Threat
58834,445,0,0,70,70,0,1,0,1,0,drop,0,1,Known Attack
61085,37965,0,0,62,62,0,1,0,1,0,deny,0,1,Known Attack
60715,443,1663,443,1716,1136,580,15,30,9,6,allow,1,0,Potential Threat
63342,53,0,0,72,72,0,1,0,1,0,deny,0,1,Known Attack
57275,53,65357,53,170,87,83,2,31,1,1,allow,1,0,Potential Threat
65321,53,29738,53,166,85,81,2,30,1,1,allow,0,0,Normal
60539,80,60539,80,318,120,198,6,26,3,3,allow,0,0,Normal
8486,56205,0,0,66,66,0,1,0,1,0,deny,1,1,High Risk
27005,27015,22209,27015,1654,126,1528,4,30,2,2,allow,1,0,Potential Threat
57282,443,46130,443,11721,2230,9491,39,31,22,17,allow,1,0,Potential Threat
60180,53,36445,53,225,110,115,2,30,1,1,allow,0,0,Normal
48488,50584,0,0,62,62,0,1,0,1,0,deny,0,1,Known Attack
54730,445,0,0,66,66,0,1,0,1,0,drop,0,1,Known Attack
59458,445,0,0,66,66,0,1,0,1,0,drop,0,1,Known Attack
38774,80,38774,80,369073,4523,364550,316,142,59,257,allow,1,0,Potential Threat
62464,443,10700,443,4595,3120,1475,18,33,10,8,allow,1,0,Potential Threat
48269,443,55381,443,4800,3396,1404,19,60,10,9,allow,1,0,Potential Threat
62521,445,0,0,70,70,0,1,0,1,0,drop,0,1,Known Attack
5588,5588,0,0,3498,1872,1626,48,200,24,24,allow,1,0,Potential Threat
64907,53,25739,53,168,86,82,2,30,1,1,allow,0,0,Normal
61127,445,0,0,70,70,0,1,0,1,0,drop,0,1,Known Attack
59617,445,0,0,70,70,0,1,0,1,0,drop,0,1,Known Attack
62888,445,0,0,70,70,0,1,0,1,0,drop,0,1,Known Attack
57736,443,25293,443,3345,823,2522,12,120,6,6,allow,1,0,Potential Threat
49185,53,26156,53,307,94,213,2,29,1,1,allow,0,0,Normal
57625,445,0,0,70,70,0,1,0,1,0,drop,0,1,Known Attack
57601,445,0,0,66,66,0,1,0,1,0,drop,0,1,Known Attack
64787,53,24820,53,740,93,647,2,31,1,1,allow,0,0,Normal
65498,443,2400,443,92290,4799,87491,107,16,43,64,allow,1,0,Potential Threat
35430,443,18104,443,6267,1810,4457,25,18,14,11,allow,1,0,Potential Threat
64297,445,0,0,70,70,0,1,0,1,0,drop,0,1,Known Attack
50265,445,0,0,70,70,0,1,0,1,0,drop,0,1,Known Attack
42066,443,21363,443,377544,10569,366975,414,221,152,262,allow,1,0,Potential Threat
20939,60461,0,0,60,60,0,1,0,1,0,deny,1,1,High Risk
22948,26467,0,0,62,62,0,1,0,1,0,deny,0,1,Known Attack
53158,17234,26675,17234,70,70,0,2,8,2,0,allow,1,0,Potential Threat
62995,445,0,0,70,70,0,1,0,1,0,drop,0,1,Known Attack
60369,443,60379,443,7939,955,6984,22,107,11,11,allow,1,0,Potential Threat
55972,445,0,0,70,70,0,1,0,1,0,drop,0,1,Known Attack
55934,53,48489,53,196,102,94,2,30,1,1,allow,0,0,Normal
56403,51505,0,0,66,66,0,1,0,1,0,deny,0,1,Known Attack
48755,80,48755,80,630,264,366,10,44,5,5,allow,0,0,Normal
40207,80,3053,80,1364,860,504,13,32,8,5,allow,1,0,Potential Threat
49160,61365,56372,61365,502,150,352,3,1200,2,1,allow,1,0,Potential Threat
49209,52030,14863,52030,66,66,0,1,5,1,0,allow,1,0,Potential Threat
56198,53,15932,53,789,110,679,2,31,1,1,allow,0,0,Normal
49512,445,0,0,70,70,0,1,0,1,0,drop,0,1,Known Attack
59319,53,47365,53,285,106,179,2,31,1,1,allow,0,0,Normal
57321,53,25115,53,498,204,294,6,29,3,3,allow,0,0,Normal
58638,5900,0,0,62,62,0,1,0,1,0,deny,0,1,Known Attack
3478,61463,0,0,1188,1188,0,1,0,1,0,deny,1,1,High Risk
58305,51180,0,0,66,66,0,1,0,1,0,deny,0,1,Known Attack
6666,50070,0,0,60,60,0,1,0,1,0,deny,1,1,High Risk
53784,16671,49140,16671,70,70,0,2,7,2,0,allow,1,0,Potential Threat
60000,80,0,0,60,60,0,1,0,1,0,deny,0,1,Known Attack
33246,443,57032,443,8340,2896,5444,28,16,16,12,allow,1,0,Potential Threat
50056,27018,50062,27018,546,390,156,6,30,4,2,allow,1,0,Potential Threat
64540,53,44077,53,352,107,245,4,37,2,2,allow,0,0,Normal
64539,53,38642,53,276,126,150,2,30,1,1,allow,0,0,Normal
49523,445,0,0,70,70,0,1,0,1,0,drop,0,1,Known Attack
63032,445,0,0,70,70,0,1,0,1,0,drop,0,1,Known Attack
51049,445,0,0,70,70,0,1,0,1,0,drop,0,1,Known Attack
54262,53,54262,53,198,90,108,2,30,1,1,allow,0,0,Normal
63545,25174,0,0,66,66,0,1,0,1,0,deny,0,1,Known Attack
50235,445,0,0,70,70,0,1,0,1,0,drop,0,1,Known Attack
44661,443,11205,443,9468,2242,7226,23,15,12,11,allow,1,0,Potential Threat
53985,445,0,0,70,70,0,1,0,1,0,drop,0,1,Known Attack
48019,22114,0,0,66,66,0,1,0,1,0,deny,0,1,Known Attack
23873,30188,0,0,66,66,0,1,0,1,0,deny,0,1,Known Attack
11967,57470,0,0,62,62,0,1,0,1,0,deny,1,1,High Risk
8414,8414,6179,8414,66,66,0,1,30,1,0,allow,1,0,Potential Threat
61766,44847,0,0,66,66,0,1,0,1,0,deny,0,1,Known Attack
49550,80,26667,80,3531,1965,1566,14,29,8,6,allow,0,0,Normal
60811,443,53507,443,740,222,518,11,3631,4,7,allow,1,0,Potential Threat
61412,443,58094,443,4934,771,4163,18,28,8,10,allow,1,0,Potential Threat
26762,22114,0,0,62,62,0,1,0,1,0,deny,0,1,Known Attack
50172,443,51694,443,3756,1914,1842,19,361,9,10,allow,1,0,Potential Threat
54651,445,0,0,66,66,0,1,0,1,0,drop,0,1,Known Attack
50712,445,0,0,70,70,0,1,0,1,0,drop,0,1,Known Attack
33710,22114,0,0,146,146,0,1,0,1,0,deny,1,1,High Risk
65049,53,34852,53,199,102,97,2,30,1,1,allow,0,0,Normal
56673,53,29686,53,193,102,91,2,30,1,1,allow,0,0,Normal
27005,27015,12555,27015,887,126,761,2,30,1,1,allow,1,0,Potential Threat
53157,34841,3594,34841,698,320,378,10,16,6,4,allow,1,0,Potential Threat
49762,53,23081,53,760,97,663,2,30,1,1,allow,0,0,Normal
55644,45579,20057,45579,70,70,0,1,5,1,0,allow,1,0,Potential Threat
50436,445,0,0,70,70,0,1,0,1,0,drop,0,1,Known Attack
45855,25174,0,0,62,62,0,1,0,1,0,deny,0,1,Known Attack
64493,53,5722,53,353,101,252,4,54,2,2,allow,0,0,Normal
54007,445,0,0,66,66,0,1,0,1,0,drop,0,1,Known Attack
59786,25174,0,0,66,66,0,1,0,1,0,deny,0,1,Known Attack
65127,53,45861,53,194,102,92,2,30,1,1,allow,0,0,Normal
60409,44739,34320,44739,70,70,0,2,8,2,0,allow,1,0,Potential Threat
51522,445,0,0,70,70,0,1,0,1,0,drop,0,1,Known Attack
49749,443,9817,443,438048,86860,351188,491,420,213,278,allow,1,0,Potential Threat
65426,80,28723,80,65980,5156,60824,86,23,39,47,allow,1,0,Potential Threat
60812,445,0,0,70,70,0,1,0,1,0,drop,0,1,Known Attack
28306,25604,0,0,62,62,0,1,0,1,0,deny,0,1,Known Attack
64926,53,24382,53,166,86,80,2,30,1,1,allow,0,0,Normal
53716,443,47470,443,70,70,0,2,8,2,0,allow,0,0,Normal
64410,445,0,0,70,70,0,1,0,1,0,drop,0,1,Known Attack
61599,445,0,0,70,70,0,1,0,1,0,drop,0,1,Known Attack
47674,443,2134,443,7576,2983,4593,33,42,18,15,allow,1,0,Potential Threat
53434,53,32877,53,261,261,0,4,47,4,0,allow,0,0,Normal
55406,53,15179,53,768,99,669,2,30,1,1,allow,0,0,Normal
50511,445,0,0,66,66,0,1,0,1,0,drop,0,1,Known Attack
56532,443,14584,443,198167,11702,186465,220,105,84,136,allow,1,0,Potential Threat
22357,6004,0,0,62,62,0,1,0,1,0,deny,0,1,Known Attack
64240,50584,0,0,66,66,0,1,0,1,0,deny,1,1,High Risk
64767,80,54344,80,3199,988,2211,14,99,7,7,allow,1,0,Potential Threat
49722,53,53892,53,873,280,593,8,80,4,4,allow,0,0,Normal
42917,52952,0,0,62,62,0,1,0,1,0,deny,0,1,Known Attack
56790,445,0,0,66,66,0,1,0,1,0,drop,0,1,Known Attack
27005,27212,63313,27212,889,126,763,2,30,1,1,allow,1,0,Potential Threat
37575,443,28180,443,499,425,74,4,0,3,1,allow,1,0,Potential Threat
36712,53,0,0,139,70,69,2,30,1,1,allow,0,0,Normal
34085,80,34085,80,490,264,226,8,140,5,3,allow,1,0,Potential Threat
49445,80,19716,80,1586,808,778,13,45,7,6,allow,0,0,Normal
26900,27017,20527,27017,422,164,258,6,30,3,3,allow,1,0,Potential Threat
60027,443,59128,443,25215,5119,20096,55,144,26,29,allow,1,0,Potential Threat
50607,80,15942,80,1657,1247,410,8,14,5,3,allow,0,0,Normal
14697,8000,41154,8000,274,150,124,4,60,2,2,allow,1,0,Potential Threat
56468,53,3693,53,180,94,86,2,30,1,1,allow,0,0,Normal
60195,445,0,0,66,66,0,1,0,1,0,drop,0,1,Known Attack
55754,53,55090,53,199,102,97,2,30,1,1,allow,0,0,Normal
42973,57470,0,0,62,62,0,1,0,1,0,deny,0,1,Known Attack
33156,3478,41500,3478,338,110,228,2,300,1,1,allow,1,0,Potential Threat
59882,445,0,0,70,70,0,1,0,1,0,drop,0,1,Known Attack
51974,54759,44030,54759,70,70,0,2,7,2,0,allow,1,0,Potential Threat
57835,443,21443,443,9125,3736,5389,19,120,10,9,allow,1,0,Potential Threat
55238,53,10880,53,168,86,82,2,30,1,1,allow,0,0,Normal
12457,57866,0,0,66,66,0,1,0,1,0,deny,1,1,High Risk
60335,443,9738,443,1853,1214,639,18,77,11,7,allow,1,0,Potential Threat
0,0,0,0,98,98,0,1,0,1,0,deny,1,1,High Risk
55598,53,46757,53,186,102,84,2,30,1,1,allow,0,0,Normal
59341,53,56377,53,187,78,109,2,30,1,1,allow,0,0,Normal
63254,445,0,0,66,66,0,1,0,1,0,drop,0,1,Known Attack
6960,53,6960,53,186,83,103,2,30,1,1,allow,1,0,Potential Threat
59694,50584,0,0,66,66,0,1,0,1,0,deny,0,1,Known Attack
53247,443,42679,443,7461,1789,5672,25,69,14,11,allow,1,0,Potential Threat
27005,27015,1344,27015,880,126,754,3,31,2,1,allow,1,0,Potential Threat
10151,55051,56267,55051,468,149,319,2,1200,1,1,allow,1,0,Potential Threat
53813,11392,0,0,62,62,0,1,0,1,0,deny,0,1,Known Attack
3175,60038,0,0,66,66,0,1,91,1,0,allow,1,0,Potential Threat
50401,53,50401,53,200,90,110,2,30,1,1,allow,0,0,Normal
58087,445,0,0,70,70,0,1,0,1,0,drop,0,1,Known Attack
35012,80,6218,80,1295,572,723,12,15,7,5,allow,1,0,Potential Threat
55186,443,62291,443,7375,1549,5826,31,353,10,21,allow,1,0,Potential Threat
49225,8080,49225,8080,43790,20134,23656,73,400,45,28,allow,1,0,Potential Threat
2531,30188,0,0,66,66,0,1,0,1,0,deny,1,1,High Risk
65248,53,49147,53,212,110,102,2,30,1,1,allow,0,0,Normal
42263,443,55947,443,6431,1665,4766,22,275,12,10,allow,1,0,Potential Threat
50290,443,49413,443,26064,2233,23831,44,97,23,21,allow,1,0,Potential Threat
62579,57866,0,0,66,66,0,1,0,1,0,deny,1,1,High Risk
56781,443,59501,443,7870,1881,5989,20,15,11,9,allow,1,0,Potential Threat
56330,53,30393,53,198,101,97,2,31,1,1,allow,0,0,Normal
63951,53,30484,53,193,102,91,2,30,1,1,allow,0,0,Normal
14360,64147,0,0,62,62,0,1,0,1,0,deny,1,1,High Risk
57097,445,0,0,66,66,0,1,0,1,0,drop,0,1,Known Attack
5610,37965,0,0,66,66,0,1,0,1,0,deny,1,1,High Risk
42298,58000,33594,58000,596,256,340,10,30,5,5,allow,1,0,Potential Threat
52143,37807,0,0,66,66,0,1,0,1,0,deny,0,1,Known Attack
51414,22,0,0,60,60,0,1,0,1,0,deny,0,1,Known Attack
46845,443,36578,443,5506,878,4628,16,26,9,7,allow,1,0,Potential Threat
51154,445,0,0,70,70,0,1,0,1,0,drop,0,1,Known Attack
3478,61463,0,0,1094,1094,0,1,0,1,0,deny,1,1,High Risk
42532,22114,0,0,62,62,0,1,0,1,0,deny,0,1,Known Attack
49234,445,0,0,70,70,0,1,0,1,0,drop,0,1,Known Attack
49451,53,64804,53,211,102,109,2,30,1,1,allow,1,0,Potential Threat
56864,15646,57596,15646,70,70,0,1,5,1,0,allow,1,0,Potential Threat
65078,53,19268,53,177,94,83,2,30,1,1,allow,0,0,Normal
64583,53,25231,53,174,89,85,2,30,1,1,allow,0,0,Normal
49522,21247,0,0,62,62,0,1,0,1,0,deny,0,1,Known Attack
32317,53,32317,53,823,98,725,2,30,1,1,allow,0,0,Normal
64568,53,24682,53,388,134,254,2,30,1,1,allow,0,0,Normal
56646,53,30377,53,177,94,83,2,30,1,1,allow,0,0,Normal
18754,30188,0,0,62,62,0,1,0,1,0,deny,0,1,Known Attack
58759,443,21160,443,6012,873,5139,18,25,9,9,allow,1,0,Potential Threat
49635,53,17449,53,210,110,100,2,30,1,1,allow,0,0,Normal
58468,57587,0,0,66,66,0,1,0,1,0,deny,1,1,High Risk
58638,5900,0,0,62,62,0,1,0,1,0,deny,0,1,Known Attack
64746,445,0,0,70,70,0,1,0,1,0,drop,0,1,Known Attack
55136,11392,0,0,66,66,0,1,0,1,0,deny,0,1,Known Attack
64052,53,55826,53,232,102,130,2,30,1,1,allow,0,0,Normal
55374,25,55374,25,130,66,64,2,5,1,1,allow,0,0,Normal
65229,53,50750,53,193,102,91,2,31,1,1,allow,0,0,Normal
63331,51221,0,0,62,62,0,1,0,1,0,deny,1,1,High Risk
52150,443,44913,443,5481,3086,2395,26,49,13,13,allow,1,0,Potential Threat
62910,993,51747,993,9108,4045,5063,84,72,39,45,allow,1,0,Potential Threat
49250,53,20588,53,731,85,646,2,30,1,1,allow,0,0,Normal
50977,56205,0,0,66,66,0,1,0,1,0,deny,0,1,Known Attack
41970,23,0,0,60,60,0,1,0,1,0,deny,0,1,Known Attack
50267,80,27570,80,12364,548,11816,17,46,6,11,allow,1,0,Potential Threat
58346,443,42517,443,5571,1518,4053,22,614,13,9,allow,1,0,Potential Threat
17786,44847,0,0,62,62,0,1,0,1,0,deny,1,1,High Risk
6712,44818,0,0,66,66,0,1,0,1,0,deny,1,1,High Risk
38334,443,30322,443,1864,250,1614,8,121,4,4,allow,1,0,Potential Threat
49418,30007,64637,30007,242,71,171,2,30,1,1,allow,1,0,Potential Threat
45997,443,45997,443,1494,898,596,12,142,6,6,allow,1,0,Potential Threat
38093,11392,0,0,146,146,0,1,0,1,0,deny,0,1,Known Attack
57843,443,8573,443,25053,19627,5426,38,76,23,15,allow,1,0,Potential Threat
55311,44847,0,0,66,66,0,1,0,1,0,deny,0,1,Known Attack
50533,445,0,0,70,70,0,1,0,1,0,drop,0,1,Known Attack
6666,16010,0,0,60,60,0,1,0,1,0,deny,1,1,High Risk
64989,53,13455,53,167,86,81,2,30,1,1,allow,0,0,Normal
19328,53,26253,53,236,86,150,2,29,1,1,allow,0,0,Normal
17097,62413,0,0,62,62,0,1,0,1,0,deny,1,1,High Risk
63455,445,0,0,70,70,0,1,0,1,0,drop,0,1,Known Attack
11816,53,11816,53,240,98,142,2,30,1,1,allow,0,0,Normal
59234,21247,0,0,62,62,0,1,0,1,0,deny,0,1,Known Attack
49451,445,0,0,70,70,0,1,0,1,0,drop,0,1,Known Attack
55965,53,4442,53,184,94,90,2,30,1,1,allow,0,0,Normal
59405,443,60870,443,9052,2120,6932,28,23,14,14,allow,1,0,Potential Threat
50011,53,8163,53,272,110,162,2,30,1,1,allow,0,0,Normal
49334,53,5617,53,300,99,201,4,38,2,2,allow,0,0,Normal
6712,161,0,0,82,82,0,1,0,1,0,deny,0,1,Known Attack
53375,445,0,0,70,70,0,1,0,1,0,drop,0,1,Known Attack
45673,30188,0,0,146,146,0,1,0,1,0,deny,1,1,High Risk
55341,39004,0,0,74,74,0,1,0,1,0,deny,0,1,Known Attack
49855,53,11171,53,290,102,188,2,30,1,1,allow,0,0,Normal
49191,51253,24345,51253,504,318,186,8,15,5,3,allow,1,0,Potential Threat
49885,445,0,0,70,70,0,1,0,1,0,drop,0,1,Known Attack
14185,48637,0,0,60,60,0,1,0,1,0,deny,1,1,High Risk
28584,37965,0,0,62,62,0,1,0,1,0,deny,0,1,Known Attack
41156,443,9223,443,59486,3261,56225,74,360,29,45,allow,1,0,Potential Threat
40252,443,46211,443,543828,50144,493684,682,172,254,428,allow,1,0,Potential Threat
44543,443,30865,443,13478,2683,10795,36,104,19,17,allow,1,0,Potential Threat
58665,445,0,0,66,66,0,1,0,1,0,drop,0,1,Known Attack
60629,445,0,0,70,70,0,1,0,1,0,drop,0,1,Known Attack
5588,5588,0,0,3354,1792,1562,46,193,23,23,allow,1,0,Potential Threat
49178,53,17300,53,348,105,243,4,45,2,2,allow,0,0,Normal
55464,53,12452,53,214,110,104,2,30,1,1,allow,0,0,Normal
21173,37965,0,0,62,62,0,1,0,1,0,deny,1,1,High Risk
64419,445,0,0,66,66,0,1,0,1,0,drop,0,1,Known Attack
47179,53733,0,0,146,146,0,1,0,1,0,deny,1,1,High Risk
56896,53,21578,53,177,94,83,2,30,1,1,allow,0,0,Normal
65388,55783,0,0,66,66,0,1,0,1,0,deny,1,1,High Risk
64853,53,57521,53,814,110,704,2,29,1,1,allow,1,0,Potential Threat
56489,53,9715,53,172,88,84,2,31,1,1,allow,0,0,Normal
47595,33435,0,0,106,106,0,1,60,1,0,allow,1,0,Potential Threat
55427,53,22421,53,200,102,98,2,33,1,1,allow,0,0,Normal
56403,443,13577,443,1710,976,734,16,81,8,8,allow,1,0,Potential Threat
54137,443,48423,443,2573,330,2243,12,136,5,7,allow,1,0,Potential Threat
64357,53,46898,53,182,93,89,2,30,1,1,allow,0,0,Normal
58715,445,0,0,70,70,0,1,0,1,0,drop,0,1,Known Attack
54129,445,0,0,70,70,0,1,0,1,0,drop,0,1,Known Attack
56636,80,30803,80,234,234,0,4,12,4,0,allow,0,0,Normal
64989,53,11063,53,578,286,292,9,15,5,4,allow,1,0,Potential Threat
50104,445,0,0,70,70,0,1,0,1,0,drop,0,1,Known Attack
65205,445,0,0,70,70,0,1,0,1,0,drop,0,1,Known Attack
55834,53,32935,53,184,94,90,2,31,1,1,allow,0,0,Normal
58638,5900,0,0,62,62,0,1,0,1,0,deny,0,1,Known Attack
50334,445,0,0,70,70,0,1,0,1,0,drop,0,1,Known Attack
56498,53,6287,53,199,102,97,2,30,1,1,allow,0,0,Normal
57603,445,0,0,66,66,0,1,0,1,0,drop,0,1,Known Attack
27005,1202,59034,1202,865,126,739,2,30,1,1,allow,1,0,Potential Threat
64640,445,0,0,70,70,0,1,0,1,0,drop,0,1,Known Attack
65456,53,31398,53,364,102,262,2,29,1,1,allow,0,0,Normal
51745,57470,0,0,145,145,0,1,0,1,0,deny,1,1,High Risk
1070,26467,0,0,62,62,0,1,0,1,0,deny,1,1,High Risk
58638,5900,0,0,62,62,0,1,0,1,0,deny,0,1,Known Attack
63578,5228,10061,5228,8544,2633,5911,51,154,28,23,allow,1,0,Potential Threat
52236,15313,56383,15313,70,70,0,2,5,2,0,allow,1,0,Potential Threat
64036,23718,0,0,66,66,0,1,0,1,0,deny,0,1,Known Attack
10011,443,63236,443,14565,3464,11101,59,151,31,28,allow,1,0,Potential Threat
51789,40800,21058,40800,70,70,0,2,8,2,0,allow,1,0,Potential Threat
49540,80,39259,80,374,192,182,7,42,4,3,allow,0,0,Normal
49353,53,9997,53,237,94,143,2,30,1,1,allow,0,0,Normal
57344,443,60771,443,3872,1641,2231,14,125,6,8,allow,1,0,Potential Threat
55621,445,0,0,70,70,0,1,0,1,0,drop,0,1,Known Attack
37716,443,28375,443,14009,10561,3448,30,135,16,14,allow,1,0,Potential Threat
53047,443,44730,443,13229,3527,9702,56,91,28,28,allow,1,0,Potential Threat
48271,25174,0,0,146,146,0,1,0,1,0,deny,1,1,High Risk
993,58185,0,0,129,129,0,1,0,1,0,deny,1,1,High Risk
56306,57587,0,0,146,146,0,1,0,1,0,deny,1,1,High Risk
27005,27014,60254,27014,879,126,753,2,31,1,1,allow,1,0,Potential Threat
54819,443,51937,443,9035,1873,7162,28,124,14,14,allow,1,0,Potential Threat
55146,53,27596,53,178,91,87,2,31,1,1,allow,0,0,Normal
63095,443,9067,443,571,166,405,2,30,1,1,allow,0,0,Normal
64114,445,0,0,66,66,0,1,0,1,0,drop,0,1,Known Attack
51388,443,13575,443,6703,3312,3391,31,145,14,17,allow,1,0,Potential Threat
46640,9002,46640,9002,124,60,64,2,5,1,1,allow,1,0,Potential Threat
56326,53,47935,53,177,94,83,2,31,1,1,allow,0,0,Normal
15635,41182,0,0,66,66,0,1,0,1,0,deny,1,1,High Risk
65184,27126,4649,27126,268,78,190,2,29,1,1,allow,1,0,Potential Threat
50569,80,5164,80,318,192,126,6,26,4,2,allow,0,0,Normal
25222,37965,0,0,62,62,0,1,0,1,0,deny,1,1,High Risk
60464,11385,6156,11385,1090,712,378,16,26,10,6,allow,1,0,Potential Threat
49788,443,22621,443,74171,1888,72283,72,126,18,54,allow,1,0,Potential Threat
53748,51413,38549,51413,70,70,0,2,7,2,0,allow,1,0,Potential Threat
63122,445,0,0,70,70,0,1,0,1,0,drop,0,1,Known Attack
3578,51505,0,0,66,66,0,1,0,1,0,deny,1,1,High Risk
39596,53,5876,53,168,78,90,2,30,1,1,allow,0,0,Normal
55051,53,56758,53,167,86,81,2,30,1,1,allow,0,0,Normal
49795,53,15978,53,209,110,99,2,30,1,1,allow,0,0,Normal
58638,5900,0,0,62,62,0,1,0,1,0,deny,0,1,Known Attack
57416,66,17429,66,70,70,0,2,7,2,0,allow,0,0,Normal
50424,55777,0,0,62,62,0,1,0,1,0,deny,0,1,Known Attack
64122,53,40984,53,214,110,104,2,30,1,1,allow,0,0,Normal
49872,443,32419,443,4595,1038,3557,19,54,11,8,allow,1,0,Potential Threat
27005,30009,8020,30009,889,126,763,3,31,2,1,allow,1,0,Potential Threat
64644,53,30010,53,364,89,275,4,33,2,2,allow,0,0,Normal
58056,443,24409,443,6821,1076,5745,21,38,12,9,allow,1,0,Potential Threat
49487,53,45596,53,267,102,165,2,30,1,1,allow,0,0,Normal
41000,443,31779,443,10675,5079,5596,88,588,47,41,allow,1,0,Potential Threat
30456,36237,0,0,146,146,0,1,0,1,0,deny,1,1,High Risk
53021,445,0,0,70,70,0,1,0,1,0,drop,0,1,Known Attack
53024,123,1742,123,184,94,90,2,30,1,1,allow,0,0,Normal
56809,53,37761,53,178,94,84,2,30,1,1,allow,0,0,Normal
59147,51505,0,0,66,66,0,1,0,1,0,deny,0,1,Known Attack
55330,445,0,0,70,70,0,1,0,1,0,drop,0,1,Known Attack
58612,445,0,0,70,70,0,1,0,1,0,drop,0,1,Known Attack
54302,445,0,0,70,70,0,1,0,1,0,drop,0,1,Known Attack
64284,53,55514,53,229,110,119,2,30,1,1,allow,0,0,Normal
54359,445,0,0,70,70,0,1,0,1,0,drop,0,1,Known Attack
50900,80,32944,80,14423569,189925,14233644,12194,135,2586,9608,allow,1,0,Potential Threat
43218,443,34506,443,2683108,71922,2611186,2467,150,623,1844,allow,1,0,Potential Threat
50284,443,42928,443,13168,2875,10293,48,99,27,21,allow,1,0,Potential Threat
49785,443,35177,443,7757,1949,5808,22,126,12,10,allow,1,0,Potential Threat
51880,8000,15502,8000,750,360,390,10,60,5,5,allow,1,0,Potential Threat
64604,53,45485,53,429,109,320,4,37,2,2,allow,0,0,Normal
10532,26672,0,0,60,60,0,1,0,1,0,deny,1,1,High Risk
58638,5900,58638,5900,156,62,94,2,10,1,1,allow,1,0,Potential Threat
21641,51505,0,0,62,62,0,1,0,1,0,deny,1,1,High Risk
49765,53,13036,53,194,102,92,2,31,1,1,allow,0,0,Normal
53746,7546,3408,7546,70,70,0,2,7,2,0,allow,1,0,Potential Threat
51961,443,54912,443,2600,1396,1204,18,48,10,8,allow,1,0,Potential Threat
45238,44847,0,0,66,66,0,1,0,1,0,deny,0,1,Known Attack
26447,80,26447,80,12599,1479,11120,28,16,15,13,allow,1,0,Potential Threat
53111,80,26592,80,45904,3904,42000,65,16,33,32,allow,1,0,Potential Threat
64336,445,0,0,70,70,0,1,0,1,0,drop,0,1,Known Attack
23807,44847,0,0,66,66,0,1,0,1,0,deny,1,1,High Risk
52683,22114,0,0,62,62,0,1,0,1,0,deny,0,1,Known Attack
57336,443,14468,443,6956,2856,4100,28,16,16,12,allow,1,0,Potential Threat
42389,42873,0,0,74,74,0,1,0,1,0,deny,0,1,Known Attack
54990,445,0,0,70,70,0,1,0,1,0,drop,0,1,Known Attack
49697,53,43942,53,195,94,101,2,30,1,1,allow,0,0,Normal
56966,35440,0,0,66,66,0,1,0,1,0,deny,0,1,Known Attack
49533,80,42327,80,8220,849,7371,13,28,5,8,allow,1,0,Potential Threat
49976,22114,0,0,66,66,0,1,0,1,0,deny,0,1,Known Attack
58468,445,0,0,70,70,0,1,0,1,0,drop,0,1,Known Attack
49894,1433,0,0,60,60,0,1,0,1,0,deny,0,1,Known Attack
63445,64631,0,0,66,66,0,1,0,1,0,deny,1,1,High Risk
64257,53,54453,53,168,86,82,2,31,1,1,allow,0,0,Normal
57470,1337,6563,1337,330,330,0,6,1200,6,0,allow,1,0,Potential Threat
43732,443,8555,443,19123,2319,16804,39,28,21,18,allow,1,0,Potential Threat
62459,445,0,0,66,66,0,1,0,1,0,drop,0,1,Known Attack
62792,53,0,0,88,88,0,1,0,1,0,deny,0,1,Known Attack
49287,53,21721,53,405,90,315,4,59,2,2,allow,0,0,Normal
51603,443,62273,443,2927,2062,865,14,134,8,6,allow,1,0,Potential Threat
49602,445,0,0,70,70,0,1,0,1,0,drop,0,1,Known Attack
49186,53,38504,53,198,102,96,2,30,1,1,allow,0,0,Normal
49418,27400,52679,27400,78,78,0,1,30,1,0,allow,1,0,Potential Threat
26651,25174,0,0,62,62,0,1,0,1,0,deny,0,1,Known Attack
26889,50265,0,0,62,62,0,1,0,1,0,deny,1,1,High Risk
50637,44847,0,0,62,62,0,1,0,1,0,deny,0,1,Known Attack
50,38211,0,0,66,66,0,1,0,1,0,deny,1,1,High Risk
25620,50432,0,0,146,146,0,1,0,1,0,deny,1,1,High Risk
58278,443,36015,443,3581,1045,2536,10,122,5,5,allow,1,0,Potential Threat
49557,53,61895,53,1298,100,1198,4,32,2,2,allow,1,0,Potential Threat
60877,443,6098,443,8536,2392,6144,29,45,17,12,allow,1,0,Potential Threat
27147,22114,0,0,146,146,0,1,0,1,0,deny,1,1,High Risk
27537,25198,0,0,148,148,0,1,0,1,0,deny,1,1,High Risk
25504,53,50116,53,311,86,225,2,30,1,1,allow,1,0,Potential Threat
64823,53,30935,53,508,102,406,2,30,1,1,allow,0,0,Normal
43260,41615,0,0,145,145,0,1,0,1,0,deny,1,1,High Risk
19068,37965,0,0,62,62,0,1,0,1,0,deny,1,1,High Risk
54749,445,0,0,70,70,0,1,0,1,0,drop,0,1,Known Attack
57034,44847,0,0,66,66,0,1,0,1,0,deny,0,1,Known Attack
60960,49049,0,0,66,66,0,1,0,1,0,deny,0,1,Known Attack
61013,41705,0,0,66,66,0,1,0,1,0,deny,0,1,Known Attack
59377,443,61380,443,43483,26315,17168,86,62,54,32,allow,1,0,Potential Threat
41753,443,5130,443,11570,3005,8565,43,255,20,23,allow,1,0,Potential Threat
58638,5900,0,0,62,62,0,1,0,1,0,deny,0,1,Known Attack
3564,57470,0,0,62,62,0,1,0,1,0,deny,1,1,High Risk
65423,443,16318,443,5854,1796,4058,21,142,10,11,allow,1,0,Potential Threat
59592,37965,0,0,62,62,0,1,0,1,0,deny,0,1,Known Attack
52920,443,42636,443,6253,2132,4121,19,16,10,9,allow,1,0,Potential Threat
42316,443,23676,443,6397,2103,4294,17,26,9,8,allow,1,0,Potential Threat
54805,80,8562,80,448,78,370,6,24,1,5,allow,0,0,Normal
52076,44847,0,0,66,66,0,1,0,1,0,deny,0,1,Known Attack
34286,53,18958,53,199,94,105,2,30,1,1,allow,0,0,Normal
51985,80,53937,80,14233438,253696,13979742,12752,54,3515,9237,allow,1,0,Potential Threat
49437,443,14429,443,586175,29694,556481,753,182,349,404,allow,1,0,Potential Threat
49456,53,3975,53,199,102,97,2,30,1,1,allow,0,0,Normal
64335,53,25261,53,193,102,91,2,30,1,1,allow,0,0,Normal
63751,17102,12860,17102,312,132,180,6,6,3,3,allow,1,0,Potential Threat
49976,445,0,0,70,70,0,1,0,1,0,drop,0,1,Known Attack
64139,53,9779,53,498,93,405,4,47,2,2,allow,0,0,Normal
64976,53,29065,53,193,102,91,2,29,1,1,allow,0,0,Normal
62737,64147,0,0,66,66,0,1,0,1,0,deny,1,1,High Risk
49764,443,53395,443,7128,865,6263,19,127,9,10,allow,1,0,Potential Threat
37346,443,8413,443,7814,2339,5475,26,316,12,14,allow,1,0,Potential Threat
13179,57866,0,0,62,62,0,1,0,1,0,deny,1,1,High Risk
56625,53,48390,53,193,102,91,2,29,1,1,allow,0,0,Normal
50477,443,35054,443,2604,1413,1191,15,83,9,6,allow,1,0,Potential Threat
53136,80,42745,80,23974,12718,11256,37,36,19,18,allow,1,0,Potential Threat
46417,443,30278,443,359878,6703,353175,325,36,88,237,allow,1,0,Potential Threat
26900,27017,12136,27017,422,164,258,6,30,3,3,allow,1,0,Potential Threat
59956,445,0,0,70,70,0,1,0,1,0,drop,0,1,Known Attack
52607,443,23239,443,2860,258,2602,9,121,4,5,allow,1,0,Potential Threat
26449,80,26449,80,642,338,304,10,33,6,4,allow,1,0,Potential Threat
54267,445,0,0,66,66,0,1,0,1,0,drop,0,1,Known Attack
61802,23,0,0,60,60,0,1,0,1,0,deny,0,1,Known Attack
49948,53,31917,53,177,94,83,2,30,1,1,allow,0,0,Normal
49418,32038,58741,32038,235,78,157,2,30,1,1,allow,1,0,Potential Threat
55027,53,18719,53,168,86,82,2,30,1,1,allow,0,0,Normal
49936,53,12720,53,754,94,660,2,30,1,1,allow,0,0,Normal
58597,35440,0,0,62,62,0,1,0,1,0,deny,0,1,Known Attack
43495,5223,36493,5223,142,142,0,1,4,1,0,allow,1,0,Potential Threat
38660,15000,20760,15000,138,78,60,2,5,1,1,allow,1,0,Potential Threat
30227,3386,30227,3386,146,60,86,2,30,1,1,allow,1,0,Potential Threat
64908,53,50995,53,304,94,210,2,30,1,1,allow,0,0,Normal
49872,53,15358,53,216,94,122,2,30,1,1,allow,0,0,Normal
51413,57470,0,0,72,72,0,1,0,1,0,deny,0,1,Known Attack
56493,443,6298,443,10532,6786,3746,55,81,28,27,allow,1,0,Potential Threat
55535,53,24278,53,199,102,97,2,29,1,1,allow,0,0,Normal
26198,64147,0,0,62,62,0,1,0,1,0,deny,1,1,High Risk
50901,80,6668,80,14661588,141996,14519592,11768,134,2012,9756,allow,1,0,Potential Threat
54234,53,54234,53,237,91,146,2,33,1,1,allow,0,0,Normal
56693,443,44446,443,3886,2545,1341,18,18,10,8,allow,1,0,Potential Threat
53816,22114,0,0,62,62,0,1,0,1,0,deny,0,1,Known Attack
57408,53,58813,53,190,97,93,2,30,1,1,allow,0,0,Normal
42222,53,45931,53,209,86,123,2,30,1,1,allow,0,0,Normal
55531,445,0,0,70,70,0,1,0,1,0,drop,0,1,Known Attack
65428,53,31541,53,195,102,93,2,31,1,1,allow,0,0,Normal
45099,123,62953,123,184,94,90,2,30,1,1,allow,1,0,Potential Threat
3478,61463,0,0,64,64,0,1,0,1,0,deny,1,1,High Risk
2707,37,0,0,60,60,0,1,0,1,0,deny,1,1,High Risk
43286,80,30144,80,1638,1324,314,10,15,5,5,allow,1,0,Potential Threat
51136,80,1499,80,366,240,126,7,21,5,2,allow,1,0,Potential Threat
51071,443,30007,443,13412,5710,7702,50,257,24,26,allow,1,0,Potential Threat
49380,445,0,0,70,70,0,1,0,1,0,drop,0,1,Known Attack
11136,17500,0,0,62,62,0,1,0,1,0,deny,0,1,Known Attack
49895,443,39538,443,6060,1040,5020,20,34,11,9,allow,1,0,Potential Threat
65009,53,11589,53,152,78,74,2,30,1,1,allow,0,0,Normal
41246,443,49001,443,78,78,0,1,5,1,0,allow,0,0,Normal
43725,443,24670,443,82838,3838,79000,104,31,42,62,allow,1,0,Potential Threat
39941,2767,0,0,62,62,0,1,0,1,0,deny,0,1,Known Attack
53715,445,0,0,70,70,0,1,0,1,0,drop,0,1,Known Attack
62348,50584,0,0,66,66,0,1,0,1,0,deny,1,1,High Risk
38698,443,26967,443,628,250,378,11,39,5,6,allow,1,0,Potential Threat
59651,445,0,0,70,70,0,1,0,1,0,drop,0,1,Known Attack
43749,443,15009,443,8900,2090,6810,26,80,14,12,allow,1,0,Potential Threat
50027,445,0,0,70,70,0,1,0,1,0,drop,0,1,Known Attack
21892,15503,0,0,62,62,0,1,0,1,0,deny,0,1,Known Attack
54455,445,0,0,66,66,0,1,0,1,0,drop,0,1,Known Attack
55252,443,43197,443,16179,1763,14416,38,46,17,21,allow,1,0,Potential Threat
59319,445,0,0,70,70,0,1,0,1,0,drop,0,1,Known Attack
37469,53,51680,53,168,78,90,2,30,1,1,allow,0,0,Normal
55519,53,47075,53,193,102,91,2,30,1,1,allow,0,0,Normal
61430,37965,0,0,66,66,0,1,0,1,0,deny,0,1,Known Attack
52548,445,0,0,70,70,0,1,0,1,0,drop,0,1,Known Attack
36732,443,61155,443,7449,2359,5090,15,120,7,8,allow,1,0,Potential Threat
42279,443,42279,443,3414,1979,1435,22,69,11,11,allow,1,0,Potential Threat
58429,443,42456,443,10588,1664,8924,29,631,11,18,allow,1,0,Potential Threat
49242,443,26105,443,4528,803,3725,14,15,8,6,allow,0,0,Normal
49215,52611,46200,52611,70,70,0,2,8,2,0,allow,1,0,Potential Threat
55350,53,27984,53,177,94,83,2,29,1,1,allow,0,0,Normal
27005,27013,23327,27013,869,126,743,2,30,1,1,allow,1,0,Potential Threat
54167,53,54167,53,242,98,144,2,30,1,1,allow,0,0,Normal
59848,443,53182,443,2431,1164,1267,27,46,11,16,allow,1,0,Potential Threat
10126,57470,0,0,62,62,0,1,0,1,0,deny,1,1,High Risk
39154,80,25294,80,1504,926,578,15,36,9,6,allow,1,0,Potential Threat
53490,62413,0,0,66,66,0,1,0,1,0,deny,1,1,High Risk
56137,53,23667,53,199,102,97,2,31,1,1,allow,0,0,Normal
58872,443,51853,443,342665,10261,332404,369,90,117,252,allow,1,0,Potential Threat
6057,51221,0,0,78,78,0,1,0,1,0,deny,1,1,High Risk
57268,443,29567,443,11546,3604,7942,38,120,20,18,allow,1,0,Potential Threat
49438,443,47897,443,135574,9426,126148,201,183,102,99,allow,1,0,Potential Threat
443,9986,0,0,669,669,0,1,0,1,0,deny,1,1,High Risk
63547,445,0,0,70,70,0,1,0,1,0,drop,0,1,Known Attack
52169,443,53007,443,7905,4819,3086,27,139,13,14,allow,1,0,Potential Threat
63856,6881,6366,6881,66,66,0,2,8,2,0,allow,1,0,Potential Threat
61085,37965,0,0,62,62,0,1,0,1,0,deny,0,1,Known Attack
9150,443,24673,443,16023,3677,12346,42,37,21,21,allow,1,0,Potential Threat
38681,443,38681,443,3028,1828,1200,19,21,11,8,allow,1,0,Potential Threat
61816,80,7127,80,2058,589,1469,10,45,6,4,allow,1,0,Potential Threat
21179,44847,0,0,146,146,0,1,0,1,0,deny,1,1,High Risk
63080,37965,0,0,66,66,0,1,0,1,0,deny,0,1,Known Attack
61845,11392,0,0,66,66,0,1,0,1,0,deny,0,1,Known Attack
57377,445,0,0,70,70,0,1,0,1,0,drop,0,1,Known Attack
59977,445,0,0,70,70,0,1,0,1,0,drop,0,1,Known Attack
51703,3010,58034,3010,70,70,0,1,5,1,0,allow,1,0,Potential Threat
58638,5900,58638,5900,130,66,64,2,4,1,1,allow,1,0,Potential Threat
64025,26826,22306,26826,66,66,0,2,7,2,0,allow,1,0,Potential Threat
37395,443,29125,443,16590,1630,14960,33,199,15,18,allow,1,0,Potential Threat
65051,445,0,0,70,70,0,1,0,1,0,drop,0,1,Known Attack
56594,53,5143,53,173,94,79,2,30,1,1,allow,0,0,Normal
50504,53,13475,53,168,86,82,2,31,1,1,allow,0,0,Normal
50657,443,9730,443,3339,2205,1134,21,38,13,8,allow,1,0,Potential Threat
60466,64337,52523,64337,70,70,0,2,8,2,0,allow,1,0,Potential Threat
52179,445,0,0,70,70,0,1,0,1,0,drop,0,1,Known Attack
53224,445,0,0,66,66,0,1,0,1,0,drop,0,1,Known Attack
39932,443,25651,443,8309,4385,3924,26,121,12,14,allow,1,0,Potential Threat
55551,53,29205,53,176,90,86,2,30,1,1,allow,0,0,Normal
2180,63710,0,0,66,66,0,1,0,1,0,deny,1,1,High Risk
45001,443,55898,443,570,318,252,10,20,6,4,allow,1,0,Potential Threat
62616,443,35713,443,32504,1730,30774,44,122,17,27,allow,1,0,Potential Threat
65136,53,56323,53,458,104,354,4,57,2,2,allow,1,0,Potential Threat
64499,445,0,0,70,70,0,1,0,1,0,drop,0,1,Known Attack
49699,53,17835,53,266,89,177,4,58,2,2,allow,0,0,Normal
53172,56013,19244,56013,70,70,0,2,8,2,0,allow,1,0,Potential Threat
49950,443,56465,443,6770,2219,4551,21,89,11,10,allow,1,0,Potential Threat
45424,23,0,0,60,60,0,1,0,1,0,deny,0,1,Known Attack
63983,53,48725,53,447,94,353,4,54,2,2,allow,0,0,Normal
57377,53,64833,53,1165,94,1071,2,30,1,1,allow,1,0,Potential Threat
49152,53,17272,53,307,105,202,4,31,2,2,allow,0,0,Normal
61700,53,61700,53,221,90,131,2,30,1,1,allow,0,0,Normal
61835,443,61835,443,21703,2433,19270,44,76,18,26,allow,1,0,Potential Threat
55273,53,49246,53,317,85,232,4,60,2,2,allow,0,0,Normal
30966,44847,0,0,146,146,0,1,0,1,0,deny,1,1,High Risk
56326,53,62646,53,177,94,83,2,30,1,1,allow,0,0,Normal
49845,443,54304,443,8518,2260,6258,32,806,12,20,allow,1,0,Potential Threat
52307,445,0,0,70,70,0,1,0,1,0,drop,0,1,Known Attack
55484,25174,0,0,62,62,0,1,0,1,0,deny,0,1,Known Attack
45941,23386,0,0,60,60,0,1,0,1,0,deny,0,1,Known Attack
48817,36292,48817,36292,519,158,361,2,1200,1,1,allow,1,0,Potential Threat
49820,123,49820,123,184,94,90,2,30,1,1,allow,0,0,Normal
50477,445,0,0,66,66,0,1,0,1,0,drop,0,1,Known Attack
64885,53,4392,53,166,86,80,2,29,1,1,allow,0,0,Normal
57246,53,12592,53,183,94,89,2,30,1,1,allow,0,0,Normal
60945,443,60945,443,4680,1773,2907,19,29,11,8,allow,1,0,Potential Threat
38688,443,23677,443,90166,3481,86685,96,16,31,65,allow,1,0,Potential Threat
58638,5900,0,0,62,62,0,1,0,1,0,deny,0,1,Known Attack
49800,53,35452,53,485,93,392,4,48,2,2,allow,0,0,Normal
56697,53,7977,53,711,87,624,2,31,1,1,allow,0,0,Normal
60688,445,0,0,70,70,0,1,0,1,0,drop,0,1,Known Attack
55752,53,44697,53,200,102,98,2,30,1,1,allow,0,0,Normal
55675,49271,26954,49271,504,318,186,8,16,5,3,allow,1,0,Potential Threat
39475,443,29487,443,3310,2291,1019,17,16,10,7,allow,1,0,Potential Threat
57678,445,0,0,66,66,0,1,0,1,0,drop,0,1,Known Attack
9519,443,34920,443,3910,370,3540,16,34,5,11,allow,1,0,Potential Threat
49838,443,59419,443,6915,3106,3809,21,144,10,11,allow,1,0,Potential Threat
9445,56205,0,0,62,62,0,1,0,1,0,deny,1,1,High Risk
51965,443,54764,443,12738,5385,7353,37,67,21,16,allow,1,0,Potential Threat
30496,57470,0,0,62,62,0,1,0,1,0,deny,1,1,High Risk
45964,55559,0,0,60,60,0,1,0,1,0,deny,1,1,High Risk
65021,53,29006,53,256,93,163,2,30,1,1,allow,0,0,Normal
43154,53,41451,53,168,78,90,2,30,1,1,allow,0,0,Normal
49867,445,0,0,70,70,0,1,0,1,0,drop,0,1,Known Attack
64780,53,37698,53,627,224,403,6,56,3,3,allow,1,0,Potential Threat
41950,53,0,0,86,86,0,1,30,1,0,allow,0,0,Normal
50584,6889,59579,6889,161,161,0,2,1200,2,0,allow,1,0,Potential Threat
56858,445,0,0,70,70,0,1,0,1,0,drop,0,1,Known Attack
64677,57470,0,0,66,66,0,1,0,1,0,deny,1,1,High Risk
48590,443,14073,443,3538,2083,1455,17,256,9,8,allow,1,0,Potential Threat
50683,443,25335,443,6414,1372,5042,19,171,9,10,allow,1,0,Potential Threat
8536,37965,0,0,62,62,0,1,0,1,0,deny,1,1,High Risk
55058,53,37390,53,216,110,106,2,30,1,1,allow,0,0,Normal
51432,25174,0,0,146,146,0,1,0,1,0,deny,1,1,High Risk
0,0,0,0,200,102,98,2,0,1,1,allow,1,0,Potential Threat
16524,22114,0,0,62,62,0,1,0,1,0,deny,0,1,Known Attack
48230,57866,0,0,62,62,0,1,0,1,0,deny,1,1,High Risk
46726,53,27470,53,168,78,90,2,30,1,1,allow,0,0,Normal
59103,445,0,0,70,70,0,1,0,1,0,drop,0,1,Known Attack
50652,445,0,0,70,70,0,1,0,1,0,drop,0,1,Known Attack
62303,445,0,0,66,66,0,1,0,1,0,drop,0,1,Known Attack
55836,445,0,0,66,66,0,1,0,1,0,drop,0,1,Known Attack
38358,22300,0,0,60,60,0,1,0,1,0,deny,0,1,Known Attack
43210,443,51289,443,5960402,99613,5860789,5017,133,952,4065,allow,1,0,Potential Threat
42433,443,64701,443,6381,3801,2580,19,135,10,9,allow,1,0,Potential Threat
55565,64147,0,0,66,66,0,1,0,1,0,deny,1,1,High Risk
54280,3398,0,0,60,60,0,1,0,1,0,deny,0,1,Known Attack
42020,80,16578,80,42657,2962,39695,68,38,36,32,allow,1,0,Potential Threat
57570,443,57570,443,175212,28668,146544,186,180,69,117,allow,1,0,Potential Threat
49476,53,34696,53,764,102,662,2,30,1,1,allow,0,0,Normal
59662,445,0,0,66,66,0,1,0,1,0,drop,0,1,Known Attack
35100,11392,0,0,62,62,0,1,0,1,0,deny,0,1,Known Attack
58549,445,0,0,70,70,0,1,0,1,0,drop,0,1,Known Attack
58638,5900,0,0,62,62,0,1,0,1,0,deny,0,1,Known Attack
50258,443,57201,443,7975,1974,6001,31,210,15,16,allow,1,0,Potential Threat
64930,53,11667,53,317,96,221,4,32,2,2,allow,0,0,Normal
64584,80,64584,80,142674,8057,134617,192,27,94,98,allow,1,0,Potential Threat
56620,53,8741,53,214,102,112,2,30,1,1,allow,0,0,Normal
4594,35993,0,0,62,62,0,1,0,1,0,deny,1,1,High Risk
61550,5529,0,0,145,145,0,1,0,1,0,deny,0,1,Known Attack
61733,443,10616,443,168812,5693,163119,186,21,68,118,allow,1,0,Potential Threat
60423,35440,0,0,146,146,0,1,0,1,0,deny,1,1,High Risk
25533,22114,0,0,62,62,0,1,0,1,0,deny,0,1,Known Attack
59679,37807,0,0,66,66,0,1,0,1,0,deny,0,1,Known Attack
50642,53,60676,53,173,94,79,2,30,1,1,allow,0,0,Normal
56582,23718,0,0,66,66,0,1,0,1,0,deny,0,1,Known Attack
58754,445,0,0,70,70,0,1,0,1,0,drop,0,1,Known Attack
10319,42707,0,0,62,62,0,1,0,1,0,deny,1,1,High Risk
49738,53,39292,53,228,86,142,2,29,1,1,allow,0,0,Normal
50265,41198,60886,41198,330,330,0,6,1200,6,0,allow,1,0,Potential Threat
17315,11392,0,0,66,66,0,1,0,1,0,deny,0,1,Known Attack
64789,445,0,0,66,66,0,1,0,1,0,drop,0,1,Known Attack
58890,53,0,0,180,82,98,2,31,1,1,allow,0,0,Normal
52661,80,52661,80,1950,1338,612,11,14,5,6,allow,1,0,Potential Threat
63743,25174,0,0,62,62,0,1,0,1,0,deny,0,1,Known Attack
63461,51505,0,0,66,66,0,1,0,1,0,deny,1,1,High Risk
61407,443,61407,443,4552,1645,2907,19,26,11,8,allow,1,0,Potential Threat
58638,5900,0,0,62,62,0,1,0,1,0,deny,0,1,Known Attack
50202,53,23143,53,166,86,80,2,30,1,1,allow,0,0,Normal
56183,53,22164,53,179,94,85,2,30,1,1,allow,0,0,Normal
41339,443,20728,443,7450,1203,6247,22,16,12,10,allow,1,0,Potential Threat
50052,65008,0,0,60,60,0,1,0,1,0,deny,1,1,High Risk
52508,445,0,0,66,66,0,1,0,1,0,drop,0,1,Known Attack
65020,53,48553,53,184,94,90,2,30,1,1,allow,0,0,Normal
52082,14804,9932,14804,70,70,0,2,8,2,0,allow,1,0,Potential Threat
49162,53,33526,53,183,94,89,2,30,1,1,allow,0,0,Normal
56889,53,27625,53,206,105,101,2,31,1,1,allow,0,0,Normal
38570,443,8181,443,6260,1587,4673,21,191,12,9,allow,1,0,Potential Threat
47325,443,49234,443,130,70,60,2,15,1,1,allow,0,0,Normal
59343,53,0,0,627,72,555,2,30,1,1,allow,0,0,Normal
52158,443,56576,443,2149,1549,600,14,45,8,6,allow,1,0,Potential Threat
40159,53,40159,53,229,89,140,2,31,1,1,allow,0,0,Normal
58952,445,0,0,70,70,0,1,0,1,0,drop,0,1,Known Attack
56740,443,11618,443,456259,379546,76713,1179,364,656,523,allow,1,0,Potential Threat
62324,445,0,0,70,70,0,1,0,1,0,drop,0,1,Known Attack
55159,53,29350,53,200,102,98,2,30,1,1,allow,0,0,Normal
44976,53,45616,53,86,86,0,1,30,1,0,allow,0,0,Normal
53868,443,61364,443,499,425,74,4,1,3,1,allow,1,0,Potential Threat
57450,445,0,0,70,70,0,1,0,1,0,drop,0,1,Known Attack
64461,445,0,0,70,70,0,1,0,1,0,drop,0,1,Known Attack
58151,443,48543,443,6563,1656,4907,22,318,13,9,allow,1,0,Potential Threat
58547,53,0,0,86,86,0,1,29,1,0,allow,0,0,Normal
65299,445,0,0,70,70,0,1,0,1,0,drop,0,1,Known Attack
59977,30188,0,0,66,66,0,1,0,1,0,deny,0,1,Known Attack
41545,443,41545,443,4719,1812,2907,19,29,11,8,allow,1,0,Potential Threat
57417,53,7685,53,199,102,97,2,30,1,1,allow,0,0,Normal
49636,53,15924,53,180,94,86,2,31,1,1,allow,0,0,Normal
54023,443,2526,443,7653,1188,6465,21,16,12,9,allow,1,0,Potential Threat
53120,49860,25192,49860,70,70,0,1,5,1,0,allow,1,0,Potential Threat
12457,57866,0,0,66,66,0,1,0,1,0,deny,1,1,High Risk
1111,25174,0,0,62,62,0,1,0,1,0,deny,1,1,High Risk
62149,445,0,0,70,70,0,1,0,1,0,drop,0,1,Known Attack
34382,26314,0,0,143,143,0,1,0,1,0,deny,1,1,High Risk
49943,80,49943,80,254742,14106,240636,305,22,131,174,allow,1,0,Potential Threat
62183,57470,0,0,74,74,0,1,0,1,0,deny,1,1,High Risk
53121,8986,30082,8986,70,70,0,1,5,1,0,allow,1,0,Potential Threat
58224,445,0,0,70,70,0,1,0,1,0,drop,0,1,Known Attack
23936,35440,0,0,62,62,0,1,0,1,0,deny,0,1,Known Attack
63458,443,33627,443,7934,1372,6562,25,63,12,13,allow,1,0,Potential Threat
49811,443,7864,443,7551,2453,5098,22,126,12,10,allow,1,0,Potential Threat
49624,53,37843,53,216,94,122,2,30,1,1,allow,0,0,Normal
51634,443,38565,443,3174,346,2828,12,121,5,7,allow,1,0,Potential Threat
62148,37965,0,0,62,62,0,1,0,1,0,deny,0,1,Known Attack
49256,53,34162,53,174,89,85,2,31,1,1,allow,0,0,Normal
49593,53,25320,53,253,102,151,2,30,1,1,allow,0,0,Normal
65425,53,4149,53,402,142,260,2,30,1,1,allow,0,0,Normal
35187,443,10629,443,13057,1460,11597,28,255,14,14,allow,1,0,Potential Threat
64537,53,37078,53,168,86,82,2,30,1,1,allow,0,0,Normal
56733,53,5625,53,183,94,89,2,30,1,1,allow,0,0,Normal
64538,53,37074,53,194,102,92,2,30,1,1,allow,0,0,Normal
35450,23,0,0,60,60,0,1,0,1,0,deny,0,1,Known Attack
62504,445,0,0,70,70,0,1,0,1,0,drop,0,1,Known Attack
60681,445,0,0,70,70,0,1,0,1,0,drop,0,1,Known Attack
49384,53,17338,53,181,94,87,2,31,1,1,allow,0,0,Normal
1027,64147,0,0,62,62,0,1,0,1,0,deny,1,1,High Risk
54821,445,0,0,70,70,0,1,0,1,0,drop,0,1,Known Attack
49636,443,48846,443,6158,1149,5009,17,52,9,8,allow,1,0,Potential Threat
48285,8080,0,0,184,78,106,3,10,2,1,allow,0,0,Normal
20939,60461,0,0,60,60,0,1,0,1,0,deny,1,1,High Risk
58793,445,0,0,66,66,0,1,0,1,0,drop,0,1,Known Attack
60579,25174,0,0,66,66,0,1,0,1,0,deny,0,1,Known Attack
56937,8200,52360,8200,78,78,0,1,30,1,0,allow,1,0,Potential Threat
43078,80,13694,80,1052,612,440,10,15,5,5,allow,0,0,Normal
56161,53,4993,53,817,102,715,2,30,1,1,allow,0,0,Normal
49230,53,1845,53,168,86,82,2,31,1,1,allow,0,0,Normal
16630,44847,0,0,62,62,0,1,0,1,0,deny,1,1,High Risk
443,35556,443,35556,70,70,0,1,4,1,0,allow,1,0,Potential Threat
57131,31061,0,0,145,145,0,1,0,1,0,deny,1,1,High Risk
40439,443,42690,443,8126,1627,6499,29,165,16,13,allow,1,0,Potential Threat
56806,445,0,0,70,70,0,1,0,1,0,drop,0,1,Known Attack
52018,53,53682,53,164,78,86,2,30,1,1,allow,0,0,Normal
65290,3389,65290,3389,3327,1438,1889,15,16,8,7,allow,1,0,Potential Threat
49201,53,3474,53,200,102,98,2,30,1,1,allow,0,0,Normal
34539,80,34539,80,22098,1602,20496,24,57,6,18,allow,1,0,Potential Threat
32051,37965,0,0,62,62,0,1,0,1,0,deny,0,1,Known Attack
49847,443,53706,443,6117,976,5141,21,72,10,11,allow,1,0,Potential Threat
60854,443,16841,443,10447,2417,8030,26,16,15,11,allow,1,0,Potential Threat
50579,443,37078,443,2707,1383,1324,29,36,16,13,allow,1,0,Potential Threat
55888,445,0,0,70,70,0,1,0,1,0,drop,0,1,Known Attack
50906,443,11737,443,124,64,60,2,15,1,1,allow,0,0,Normal
5048,53,5048,53,247,98,149,2,34,1,1,allow,1,0,Potential Threat
58795,443,29024,443,19700,12992,6708,44,18,23,21,allow,1,0,Potential Threat
56892,53,32986,53,199,102,97,2,31,1,1,allow,0,0,Normal
35864,44847,0,0,78,78,0,1,0,1,0,deny,1,1,High Risk
7184,15503,0,0,66,66,0,1,0,1,0,deny,1,1,High Risk
35894,53,14493,53,198,93,105,2,30,1,1,allow,0,0,Normal
43568,80,8531,80,2277,1521,756,16,16,10,6,allow,1,0,Potential Threat
64831,53,56461,53,216,110,106,2,30,1,1,allow,0,0,Normal
65500,445,0,0,66,66,0,1,0,1,0,drop,0,1,Known Attack
47050,53,14793,53,199,94,105,2,30,1,1,allow,0,0,Normal
52974,445,0,0,70,70,0,1,0,1,0,drop,0,1,Known Attack
56756,53,42523,53,760,97,663,2,30,1,1,allow,0,0,Normal
61661,53,61661,53,235,90,145,2,33,1,1,allow,0,0,Normal
49837,53,39920,53,212,108,104,2,30,1,1,allow,0,0,Normal
57789,30188,0,0,62,62,0,1,0,1,0,deny,0,1,Known Attack
65241,53,18449,53,200,102,98,2,31,1,1,allow,0,0,Normal
53539,6881,61115,6881,492,306,186,8,14,5,3,allow,1,0,Potential Threat
49214,443,4327,443,17273,11238,6035,73,919,36,37,allow,1,0,Potential Threat
49986,53,35150,53,209,94,115,2,30,1,1,allow,0,0,Normal
60411,58131,51349,58131,70,70,0,2,8,2,0,allow,1,0,Potential Threat
63697,25010,4091,25010,504,382,122,8,16,6,2,allow,1,0,Potential Threat
58638,5900,0,0,62,62,0,1,0,1,0,deny,0,1,Known Attack
49921,53,27368,53,214,110,104,2,30,1,1,allow,0,0,Normal
53071,25174,0,0,66,66,0,1,0,1,0,deny,0,1,Known Attack
58498,445,0,0,66,66,0,1,0,1,0,drop,0,1,Known Attack
53182,443,14179,443,16255,8279,7976,42,422,21,21,allow,1,0,Potential Threat
50391,445,0,0,70,70,0,1,0,1,0,drop,0,1,Known Attack
55082,445,0,0,66,66,0,1,0,1,0,drop,0,1,Known Attack
54210,64097,0,0,66,66,0,1,0,1,0,deny,1,1,High Risk
65309,53,6020,53,227,110,117,2,30,1,1,allow,0,0,Normal
56612,53,15256,53,274,87,187,4,30,2,2,allow,0,0,Normal
63092,46776,0,0,78,78,0,1,0,1,0,deny,1,1,High Risk
45941,23386,0,0,60,60,0,1,0,1,0,deny,0,1,Known Attack
49197,2710,30685,2710,70,70,0,1,4,1,0,allow,0,0,Normal
50490,445,0,0,66,66,0,1,0,1,0,drop,0,1,Known Attack
33845,53,0,0,82,82,0,1,30,1,0,allow,0,0,Normal
51963,445,0,0,66,66,0,1,0,1,0,deny,0,1,Known Attack
56654,443,29055,443,18544,4402,14142,31,191,14,17,allow,1,0,Potential Threat
59478,445,0,0,70,70,0,1,0,1,0,drop,0,1,Known Attack
49314,443,60912,443,8599,4862,3737,47,195,26,21,allow,1,0,Potential Threat
50653,445,0,0,66,66,0,1,0,1,0,drop,0,1,Known Attack
49551,445,0,0,70,70,0,1,0,1,0,drop,0,1,Known Attack
49182,445,0,0,70,70,0,1,0,1,0,drop,0,1,Known Attack
45313,64147,0,0,62,62,0,1,0,1,0,deny,1,1,High Risk
48144,21247,0,0,66,66,0,1,0,1,0,deny,0,1,Known Attack
55315,53,5468,53,196,102,94,2,31,1,1,allow,0,0,Normal
49213,443,9169,443,157994,4952,153042,186,255,68,118,allow,1,0,Potential Threat
65304,53,52702,53,194,86,108,2,29,1,1,allow,0,0,Normal
55893,45711,0,0,78,78,0,1,0,1,0,deny,0,1,Known Attack
27005,27015,38392,27015,878,126,752,2,30,1,1,allow,1,0,Potential Threat
50544,443,14371,443,11083,4570,6513,24,35,13,11,allow,1,0,Potential Threat
51059,445,0,0,66,66,0,1,0,1,0,drop,0,1,Known Attack
64685,53,47182,53,193,102,91,2,30,1,1,allow,0,0,Normal
65386,53,22726,53,184,102,82,2,29,1,1,allow,0,0,Normal
54941,445,0,0,70,70,0,1,0,1,0,drop,0,1,Known Attack
65428,53,15132,53,195,102,93,2,29,1,1,allow,0,0,Normal
55442,53,12898,53,177,94,83,2,30,1,1,allow,0,0,Normal
53791,53,53567,53,260,86,174,2,30,1,1,allow,0,0,Normal
39213,443,39213,443,4378,1471,2907,19,29,11,8,allow,1,0,Potential Threat
57035,80,15633,80,953,524,429,11,256,6,5,allow,1,0,Potential Threat
53870,443,3316,443,499,425,74,4,1,3,1,allow,0,0,Normal
53917,445,0,0,66,66,0,1,0,1,0,drop,0,1,Known Attack
36804,25174,0,0,66,66,0,1,0,1,0,deny,0,1,Known Attack
14442,443,28353,443,2601,1455,1146,18,15,8,10,allow,1,0,Potential Threat
55817,36829,0,0,66,66,0,1,0,1,0,deny,0,1,Known Attack
36641,25174,0,0,66,66,0,1,0,1,0,deny,0,1,Known Attack
63590,443,25710,443,6187,933,5254,18,147,10,8,allow,1,0,Potential Threat
61730,25320,0,0,66,66,0,1,0,1,0,deny,0,1,Known Attack
55387,53,41194,53,164,86,78,2,30,1,1,allow,0,0,Normal
49994,26467,0,0,66,66,0,1,0,1,0,deny,0,1,Known Attack
57849,50584,0,0,66,66,0,1,0,1,0,deny,0,1,Known Attack
52035,80,21577,80,426,240,186,8,24,5,3,allow,0,0,Normal
58263,445,0,0,70,70,0,1,0,1,0,drop,0,1,Known Attack
49452,443,53461,443,13184,2507,10677,27,64,14,13,allow,1,0,Potential Threat
23940,41615,0,0,146,146,0,1,0,1,0,deny,1,1,High Risk
65195,53,58646,53,249,94,155,2,30,1,1,allow,0,0,Normal
64912,53,24794,53,183,94,89,2,30,1,1,allow,0,0,Normal
40682,443,13381,443,10010,4051,5959,32,346,17,15,allow,1,0,Potential Threat
28035,443,12518,443,5458,1390,4068,17,15,9,8,allow,1,0,Potential Threat
64315,53,11433,53,322,102,220,2,30,1,1,allow,0,0,Normal
49900,445,0,0,70,70,0,1,0,1,0,drop,0,1,Known Attack
60044,445,0,0,70,70,0,1,0,1,0,drop,0,1,Known Attack
55872,53,6785,53,196,102,94,2,30,1,1,allow,0,0,Normal
49418,32058,6170,32058,78,78,0,1,30,1,0,allow,1,0,Potential Threat
59594,445,0,0,66,66,0,1,0,1,0,drop,0,1,Known Attack
39536,80,4904,80,2749,1732,1017,21,361,12,9,allow,1,0,Potential Threat
64614,53,45879,53,616,188,428,6,35,3,3,allow,1,0,Potential Threat
51413,32480,0,0,72,72,0,1,0,1,0,deny,0,1,Known Attack
63773,445,0,0,66,66,0,1,0,1,0,drop,0,1,Known Attack
63081,53,24594,53,304,86,218,2,30,1,1,allow,0,0,Normal
443,50238,0,0,331,331,0,1,0,1,0,deny,1,1,High Risk
49332,443,62500,443,27727,1971,25756,51,80,21,30,allow,1,0,Potential Threat
52184,443,13267,443,13902,3253,10649,26,135,14,12,allow,1,0,Potential Threat
23349,30188,0,0,62,62,0,1,0,1,0,deny,0,1,Known Attack
59920,443,3699,443,7359,2050,5309,18,16,10,8,allow,1,0,Potential Threat
65453,445,0,0,70,70,0,1,0,1,0,drop,0,1,Known Attack
56497,53,23071,53,214,110,104,2,30,1,1,allow,0,0,Normal
58638,5900,0,0,62,62,0,1,0,1,0,deny,0,1,Known Attack
58638,5900,0,0,62,62,0,1,0,1,0,deny,0,1,Known Attack
50767,57470,0,0,62,62,0,1,0,1,0,deny,0,1,Known Attack
49891,53,42483,53,164,84,80,2,31,1,1,allow,0,0,Normal
63701,46824,0,0,66,66,0,1,0,1,0,deny,1,1,High Risk
49597,80,58897,80,372,192,180,7,41,4,3,allow,0,0,Normal
57152,53,57152,53,241,98,143,2,30,1,1,allow,0,0,Normal
50153,80,50079,80,41846,1261,40585,45,75,13,32,allow,1,0,Potential Threat
49543,53,24051,53,880,189,691,6,75,3,3,allow,0,0,Normal
37698,443,12829,443,1781,1062,719,16,275,8,8,allow,1,0,Potential Threat
49994,26467,0,0,66,66,0,1,0,1,0,deny,0,1,Known Attack
64291,445,0,0,66,66,0,1,0,1,0,drop,0,1,Known Attack
61427,443,64293,443,7288,1763,5525,22,77,12,10,allow,1,0,Potential Threat
3341,23117,0,0,66,66,0,1,0,1,0,deny,1,1,High Risk
64304,53,40913,53,1054,293,761,8,94,4,4,allow,1,0,Potential Threat
16330,50584,0,0,62,62,0,1,0,1,0,deny,1,1,High Risk
56341,53,11727,53,243,94,149,2,30,1,1,allow,0,0,Normal
26439,37965,0,0,66,66,0,1,0,1,0,deny,0,1,Known Attack
49935,80,29909,80,1130,613,517,11,15,6,5,allow,0,0,Normal
27005,30015,42725,30015,1700,126,1574,4,31,2,2,allow,1,0,Potential Threat
54160,443,65221,443,9464,1751,7713,29,48,13,16,allow,1,0,Potential Threat
42951,44847,0,0,66,66,0,1,0,1,0,deny,0,1,Known Attack
48706,23393,0,0,60,60,0,1,0,1,0,deny,0,1,Known Attack
15503,62336,46736,62336,127653507,122661116,4992391,161030,2162,82907,78123,allow,1,0,Potential Threat
58808,445,0,0,66,66,0,1,0,1,0,drop,0,1,Known Attack
49547,445,0,0,70,70,0,1,0,1,0,drop,0,1,Known Attack
63852,35440,0,0,66,66,0,1,0,1,0,deny,0,1,Known Attack
55471,53,40426,53,760,97,663,2,31,1,1,allow,0,0,Normal
64359,53,39260,53,192,98,94,2,31,1,1,allow,0,0,Normal
54007,50265,0,0,66,66,0,1,0,1,0,deny,0,1,Known Attack
36394,443,63478,443,6485,1692,4793,23,170,13,10,allow,1,0,Potential Threat
50735,445,0,0,66,66,0,1,0,1,0,drop,0,1,Known Attack
42306,443,42899,443,449862,38989,410873,644,280,286,358,allow,1,0,Potential Threat
55912,53,21691,53,184,94,90,2,31,1,1,allow,0,0,Normal
23650,37807,0,0,62,62,0,1,0,1,0,deny,0,1,Known Attack
63482,445,0,0,70,70,0,1,0,1,0,drop,0,1,Known Attack
62067,445,0,0,70,70,0,1,0,1,0,drop,0,1,Known Attack
51650,80,8862,80,2681,1044,1637,22,255,12,10,allow,1,0,Potential Threat
62618,445,0,0,66,66,0,1,0,1,0,drop,0,1,Known Attack
50584,12948,3713,12948,346,161,185,2,1200,1,1,allow,1,0,Potential Threat
53995,41985,42236,41985,70,70,0,2,7,2,0,allow,1,0,Potential Threat
64883,53,2709,53,184,94,90,2,30,1,1,allow,0,0,Normal
65516,445,0,0,70,70,0,1,0,1,0,drop,0,1,Known Attack
58582,50584,0,0,62,62,0,1,0,1,0,deny,0,1,Known Attack
58074,11392,0,0,66,66,0,1,0,1,0,deny,0,1,Known Attack
60406,443,21053,443,8404,1892,6512,23,30,12,11,allow,1,0,Potential Threat
51145,80,27456,80,78198970,2041652,76157318,79332,368,28698,50634,allow,1,0,Potential Threat
57996,445,0,0,70,70,0,1,0,1,0,drop,0,1,Known Attack
57083,53,19689,53,198,102,96,2,30,1,1,allow,0,0,Normal
58638,5900,0,0,62,62,0,1,0,1,0,deny,0,1,Known Attack
49248,445,0,0,66,66,0,1,0,1,0,drop,0,1,Known Attack
56281,53,7565,53,177,94,83,2,30,1,1,allow,0,0,Normal
44121,23,0,0,60,60,0,1,0,1,0,deny,0,1,Known Attack
64159,445,0,0,66,66,0,1,0,1,0,drop,0,1,Known Attack
58446,56205,0,0,62,62,0,1,0,1,0,deny,1,1,High Risk
49558,80,45042,80,39679,7315,32364,45,24,17,28,allow,1,0,Potential Threat
61817,445,0,0,70,70,0,1,0,1,0,drop,0,1,Known Attack
63020,445,0,0,70,70,0,1,0,1,0,drop,0,1,Known Attack
50847,445,0,0,66,66,0,1,0,1,0,drop,0,1,Known Attack
37965,44056,39211,44056,158,158,0,1,1199,1,0,allow,1,0,Potential Threat
53446,445,0,0,70,70,0,1,0,1,0,drop,0,1,Known Attack
61128,445,0,0,66,66,0,1,0,1,0,drop,0,1,Known Attack
58824,445,0,0,70,70,0,1,0,1,0,drop,0,1,Known Attack
9202,80,37636,80,2949,546,2403,11,25,6,5,allow,1,0,Potential Threat
49418,22114,0,0,66,66,0,1,0,1,0,deny,0,1,Known Attack
52706,53,0,0,82,82,0,2,40,2,0,allow,0,0,Normal
65198,445,0,0,66,66,0,1,0,1,0,drop,0,1,Known Attack
57150,53,64897,53,177,94,83,2,30,1,1,allow,1,0,Potential Threat
50095,30188,0,0,66,66,0,1,0,1,0,deny,0,1,Known Attack
40400,22114,0,0,62,62,0,1,0,1,0,deny,0,1,Known Attack
25187,31573,0,0,62,62,0,1,0,1,0,deny,1,1,High Risk
50263,53,58515,53,771,102,669,2,30,1,1,allow,0,0,Normal
49567,443,55321,443,6408,2531,3877,21,15,11,10,allow,1,0,Potential Threat
55049,443,4491,443,1600,1089,511,13,151,7,6,allow,1,0,Potential Threat
64235,53,30515,53,321,99,222,4,52,2,2,allow,0,0,Normal
63260,445,0,0,66,66,0,1,0,1,0,drop,0,1,Known Attack
31845,55777,0,0,62,62,0,1,0,1,0,deny,1,1,High Risk
123,123,14772,123,184,94,90,2,29,1,1,allow,1,0,Potential Threat
50069,53,45809,53,764,102,662,2,29,1,1,allow,0,0,Normal
13654,50584,0,0,146,146,0,1,0,1,0,deny,1,1,High Risk
57577,443,27380,443,39421,4980,34441,57,144,23,34,allow,1,0,Potential Threat
50911,445,0,0,70,70,0,1,0,1,0,drop,0,1,Known Attack
64721,53,29674,53,214,110,104,2,30,1,1,allow,0,0,Normal
65206,53,46359,53,167,86,81,2,30,1,1,allow,0,0,Normal
64266,53,43619,53,168,86,82,2,30,1,1,allow,0,0,Normal
53273,443,62514,443,17169,6566,10603,52,37,24,28,allow,1,0,Potential Threat
23478,1433,0,0,60,60,0,1,0,1,0,deny,0,1,Known Attack
50949,45960,0,0,62,62,0,1,0,1,0,deny,0,1,Known Attack
54959,53,28413,53,211,110,101,2,30,1,1,allow,0,0,Normal
49351,53,27652,53,166,86,80,2,30,1,1,allow,0,0,Normal
49418,32036,34122,32036,243,78,165,2,30,1,1,allow,1,0,Potential Threat
65506,53,16583,53,197,102,95,2,30,1,1,allow,0,0,Normal
51221,49857,1668,49857,791,266,525,8,1200,4,4,allow,1,0,Potential Threat
26924,37965,0,0,66,66,0,1,0,1,0,deny,1,1,High Risk
37612,443,3287,443,2141,1270,871,18,130,10,8,allow,1,0,Potential Threat
57122,53,4958,53,199,102,97,2,29,1,1,allow,0,0,Normal
64937,53,47101,53,210,110,100,2,30,1,1,allow,0,0,Normal
55573,445,0,0,66,66,0,1,0,1,0,drop,0,1,Known Attack
55000,53,30925,53,753,93,660,2,31,1,1,allow,0,0,Normal
51814,445,0,0,66,66,0,1,0,1,0,drop,0,1,Known Attack
64823,445,0,0,70,70,0,1,0,1,0,drop,0,1,Known Attack
60379,443,42355,443,4162,2121,2041,25,95,14,11,allow,1,0,Potential Threat
27005,27015,55025,27015,1624,126,1498,4,31,2,2,allow,1,0,Potential Threat
51339,445,0,0,70,70,0,1,0,1,0,drop,0,1,Known Attack
51667,25826,43054,25826,9415,9415,0,11,30,11,0,allow,1,0,Potential Threat
25254,5555,0,0,60,60,0,1,0,1,0,deny,0,1,Known Attack
57431,53,35038,53,392,134,258,2,30,1,1,allow,0,0,Normal
46662,36237,0,0,62,62,0,1,0,1,0,deny,0,1,Known Attack
49579,80,10648,80,277736,7810,269926,277,65,91,186,allow,1,0,Potential Threat
64266,53,49573,53,168,86,82,2,31,1,1,allow,0,0,Normal
56757,53,30520,53,167,86,81,2,31,1,1,allow,0,0,Normal
41409,80,32220,80,1484,877,607,11,34,6,5,allow,0,0,Normal
18650,23718,0,0,62,62,0,1,0,1,0,deny,0,1,Known Attack
64598,53,18969,53,222,94,128,2,29,1,1,allow,0,0,Normal
51745,57470,0,0,62,62,0,1,0,1,0,deny,0,1,Known Attack
62429,445,0,0,70,70,0,1,0,1,0,drop,0,1,Known Attack
37247,443,37247,443,4401,1494,2907,19,25,11,8,allow,1,0,Potential Threat
49297,53,44299,53,183,94,89,2,30,1,1,allow,0,0,Normal
53146,50393,43018,50393,70,70,0,1,5,1,0,allow,1,0,Potential Threat
33305,54532,0,0,60,60,0,1,0,1,0,deny,1,1,High Risk
50915,53,63317,53,168,78,90,2,30,1,1,allow,1,0,Potential Threat
4009,53,4009,53,231,88,143,2,33,1,1,allow,1,0,Potential Threat
55595,33677,1152,33677,210,140,70,4,14,3,1,allow,1,0,Potential Threat
52198,445,0,0,70,70,0,1,0,1,0,drop,0,1,Known Attack
53178,26467,0,0,62,62,0,1,0,1,0,deny,0,1,Known Attack
50360,37965,0,0,66,66,0,1,0,1,0,deny,0,1,Known Attack
52095,56079,0,0,62,62,0,1,0,1,0,deny,0,1,Known Attack
53597,445,0,0,70,70,0,1,0,1,0,drop,0,1,Known Attack
54870,443,54870,443,313399,38167,275232,411,23,205,206,allow,1,0,Potential Threat
47812,443,45871,443,25864,15150,10714,105,217,54,51,allow,1,0,Potential Threat
65484,53,32858,53,195,102,93,2,30,1,1,allow,0,0,Normal
27898,52700,0,0,62,62,0,1,0,1,0,deny,1,1,High Risk
51354,445,0,0,70,70,0,1,0,1,0,drop,0,1,Known Attack
58638,5900,0,0,62,62,0,1,0,1,0,deny,0,1,Known Attack
56639,48817,0,0,66,66,0,1,0,1,0,deny,0,1,Known Attack
49518,53,16482,53,193,102,91,2,30,1,1,allow,0,0,Normal
56873,445,0,0,70,70,0,1,0,1,0,drop,0,1,Known Attack
34932,38608,0,0,62,62,0,1,0,1,0,deny,0,1,Known Attack
60212,445,0,0,70,70,0,1,0,1,0,drop,0,1,Known Attack
64854,53,42024,53,172,88,84,2,30,1,1,allow,0,0,Normal
51320,37965,0,0,62,62,0,1,0,1,0,deny,0,1,Known Attack
6892,36949,0,0,159,159,0,1,0,1,0,deny,1,1,High Risk
61675,80,46507,80,5108,676,4432,14,15,7,7,allow,1,0,Potential Threat
49978,53,13448,53,190,97,93,2,30,1,1,allow,0,0,Normal
41916,443,13885,443,8634,3251,5383,24,17,14,10,allow,1,0,Potential Threat
57470,18634,6347,18634,594,594,0,10,1199,10,0,allow,1,0,Potential Threat
443,60082,0,0,74,74,0,1,0,1,0,deny,1,1,High Risk
57982,64147,0,0,66,66,0,1,0,1,0,deny,1,1,High Risk
63347,25174,0,0,62,62,0,1,0,1,0,deny,0,1,Known Attack
51076,80,51076,80,8170,844,7326,17,42,7,10,allow,1,0,Potential Threat
55053,53,47870,53,216,102,114,2,30,1,1,allow,0,0,Normal
37014,23,0,0,60,60,0,1,0,1,0,deny,0,1,Known Attack
56661,53,1967,53,900,110,790,2,30,1,1,allow,0,0,Normal
57146,445,0,0,66,66,0,1,0,1,0,drop,0,1,Known Attack
29159,39004,0,0,62,62,0,1,0,1,0,deny,1,1,High Risk
58209,445,0,0,70,70,0,1,0,1,0,drop,0,1,Known Attack
43176,53,34266,53,168,78,90,2,30,1,1,allow,0,0,Normal
49334,53,23056,53,184,94,90,2,31,1,1,allow,0,0,Normal
38664,37965,0,0,62,62,0,1,0,1,0,deny,0,1,Known Attack
55538,53,48787,53,195,102,93,2,30,1,1,allow,0,0,Normal
56760,53,60380,53,760,96,664,2,31,1,1,allow,0,0,Normal
36685,35440,0,0,62,62,0,1,0,1,0,deny,0,1,Known Attack
62952,38741,48558,38741,18963,9580,9383,211,348,109,102,allow,1,0,Potential Threat
25961,55783,0,0,66,66,0,1,0,1,0,deny,1,1,High Risk
55018,445,0,0,66,66,0,1,0,1,0,drop,0,1,Known Attack
49343,443,10308,443,1556,769,787,17,134,9,8,allow,1,0,Potential Threat
49484,53,47845,53,742,88,654,2,31,1,1,allow,0,0,Normal
56643,443,24007,443,1560,988,572,13,21,7,6,allow,0,0,Normal
50584,61467,32483,61467,1377,300,1077,6,1200,3,3,allow,1,0,Potential Threat
63046,53,33586,53,510,164,346,2,30,1,1,allow,0,0,Normal
52618,80,60049,80,1141,529,612,10,18,6,4,allow,1,0,Potential Threat
65300,53,18303,53,195,102,93,2,31,1,1,allow,0,0,Normal
65439,53,10579,53,228,110,118,2,30,1,1,allow,0,0,Normal
49713,53,34138,53,198,94,104,2,30,1,1,allow,0,0,Normal
65189,27015,25952,27015,281,78,203,2,30,1,1,allow,1,0,Potential Threat
52228,445,0,0,70,70,0,1,0,1,0,drop,0,1,Known Attack
64559,53,44867,53,168,86,82,2,31,1,1,allow,0,0,Normal
64509,9571,0,0,62,62,0,1,0,1,0,deny,0,1,Known Attack
63545,445,0,0,70,70,0,1,0,1,0,drop,0,1,Known Attack
63711,445,0,0,66,66,0,1,0,1,0,drop,0,1,Known Attack
58082,443,14473,443,45314943,1391230,43923713,47149,303,15196,31953,allow,1,0,Potential Threat
65165,53,54019,53,200,102,98,2,31,1,1,allow,0,0,Normal
53837,443,2999,443,499,425,74,4,0,3,1,allow,0,0,Normal
65071,53,53845,53,411,99,312,4,52,2,2,allow,0,0,Normal
50016,80,57935,80,827,687,140,6,32,4,2,allow,0,0,Normal
56568,53,34489,53,102,102,0,1,30,1,0,allow,0,0,Normal
62861,443,20935,443,4777,2262,2515,10,122,5,5,allow,1,0,Potential Threat
54730,445,0,0,70,70,0,1,0,1,0,drop,0,1,Known Attack
57090,51505,0,0,66,66,0,1,0,1,0,deny,0,1,Known Attack
56422,53,18940,53,199,102,97,2,30,1,1,allow,0,0,Normal
64875,53,51837,53,211,102,109,2,30,1,1,allow,0,0,Normal
56703,53,61350,53,198,101,97,2,31,1,1,allow,0,0,Normal
64962,53,48454,53,226,94,132,2,30,1,1,allow,0,0,Normal
55161,445,0,0,70,70,0,1,0,1,0,drop,0,1,Known Attack
37569,443,55677,443,120566,15345,105221,173,125,72,101,allow,1,0,Potential Threat
48557,37965,0,0,62,62,0,1,0,1,0,deny,0,1,Known Attack
50945,80,53857,80,6920116,91852,6828264,6765,79,1277,5488,allow,1,0,Potential Threat
54516,53,54516,53,235,90,145,2,33,1,1,allow,0,0,Normal
64980,445,0,0,70,70,0,1,0,1,0,drop,0,1,Known Attack
63934,53,32673,53,209,110,99,2,29,1,1,allow,0,0,Normal
39715,443,41417,443,65276,4554,60722,82,217,34,48,allow,1,0,Potential Threat
47178,53,0,0,82,82,0,2,40,2,0,allow,0,0,Normal
56536,443,9088,443,8866,2743,6123,23,139,11,12,allow,1,0,Potential Threat
10035,443,49026,443,7915,1634,6281,25,315,11,14,allow,1,0,Potential Threat
58638,5900,0,0,62,62,0,1,0,1,0,deny,0,1,Known Attack
49308,22114,0,0,66,66,0,1,0,1,0,deny,0,1,Known Attack
56639,53,13077,53,168,86,82,2,31,1,1,allow,0,0,Normal
57665,52700,0,0,66,66,0,1,0,1,0,deny,0,1,Known Attack
60136,56205,0,0,66,66,0,1,0,1,0,deny,1,1,High Risk
65401,53,57745,53,235,102,133,2,29,1,1,allow,0,0,Normal
44945,80,24197,80,1729,1287,442,7,15,5,2,allow,1,0,Potential Threat
52155,80,42520,80,1056,682,374,10,15,6,4,allow,0,0,Normal
63832,25174,0,0,62,62,0,1,0,1,0,deny,0,1,Known Attack
34808,22114,0,0,66,66,0,1,0,1,0,deny,0,1,Known Attack
49509,53,2190,53,339,110,229,2,30,1,1,allow,0,0,Normal
49406,443,41618,443,7808,2879,4929,36,186,19,17,allow,1,0,Potential Threat
64249,53,32881,53,181,94,87,2,30,1,1,allow,0,0,Normal
8430,53,61822,53,239209,233954,5255,2850,88,2822,28,allow,1,0,Potential Threat
49001,40108,0,0,161,161,0,1,0,1,0,deny,1,1,High Risk
60290,53,25533,53,199,94,105,2,29,1,1,allow,0,0,Normal
25565,62979,0,0,60,60,0,1,0,1,0,deny,1,1,High Risk
37683,53,37683,53,240,98,142,2,30,1,1,allow,0,0,Normal
57139,53,34151,53,166,86,80,2,29,1,1,allow,0,0,Normal
58555,443,6848,443,15546,2361,13185,39,123,18,21,allow,1,0,Potential Threat
55838,443,19179,443,7034,2039,4995,37,255,18,19,allow,1,0,Potential Threat
50402,445,0,0,70,70,0,1,0,1,0,drop,0,1,Known Attack
53015,64147,0,0,62,62,0,1,0,1,0,deny,1,1,High Risk
37621,443,45461,443,27993,2483,25510,51,48,25,26,allow,1,0,Potential Threat
62053,445,0,0,66,66,0,1,0,1,0,drop,0,1,Known Attack
52748,445,0,0,70,70,0,1,0,1,0,drop,0,1,Known Attack
57499,80,58855,80,30979,1798,29181,46,14,23,23,allow,1,0,Potential Threat
48513,443,48513,443,4566,1659,2907,19,27,11,8,allow,1,0,Potential Threat
53270,443,48173,443,21684,2143,19541,38,322,16,22,allow,1,0,Potential Threat
57131,35776,0,0,145,145,0,1,0,1,0,deny,1,1,High Risk
36144,443,59381,443,8859,1662,7197,26,75,14,12,allow,1,0,Potential Threat
55136,11392,0,0,62,62,0,1,0,1,0,deny,0,1,Known Attack
49411,53,10560,53,195,102,93,2,31,1,1,allow,0,0,Normal
64790,53,64538,53,779,86,693,2,30,1,1,allow,1,0,Potential Threat
54792,443,48996,443,9515,2231,7284,25,22,14,11,allow,1,0,Potential Threat
53906,12051,34312,12051,258,70,188,4,9,2,2,allow,1,0,Potential Threat
1738,80,1738,80,87958,5378,82580,100,95,39,61,allow,1,0,Potential Threat
49701,443,3982,443,28497,1646,26851,31,138,9,22,allow,1,0,Potential Threat
50522,445,0,0,70,70,0,1,0,1,0,drop,0,1,Known Attack
58864,443,26989,443,312852,8845,304007,317,45,99,218,allow,1,0,Potential Threat
57126,53,50266,53,183,94,89,2,30,1,1,allow,0,0,Normal
6881,46776,0,0,146,146,0,1,0,1,0,deny,1,1,High Risk
10088,443,42389,443,7243,1860,5383,26,330,14,12,allow,1,0,Potential Threat
65438,53,17432,53,332,94,238,2,29,1,1,allow,0,0,Normal
50128,80,27649,80,20575,11455,9120,92,966,47,45,allow,1,0,Potential Threat
54305,39004,0,0,62,62,0,1,0,1,0,deny,0,1,Known Attack
56622,53,31873,53,214,110,104,2,30,1,1,allow,0,0,Normal
62748,445,0,0,70,70,0,1,0,1,0,drop,0,1,Known Attack
53545,443,54715,443,7330,2295,5035,19,135,9,10,allow,1,0,Potential Threat
37603,443,61350,443,573,425,148,5,1,3,2,allow,1,0,Potential Threat
49284,53,41000,53,195,86,109,2,30,1,1,allow,0,0,Normal
40342,53,32234,53,168,78,90,2,29,1,1,allow,0,0,Normal
53774,58433,12540,58433,320,140,180,6,7,3,3,allow,1,0,Potential Threat
56688,443,37544,443,32780,6864,25916,142,345,57,85,allow,1,0,Potential Threat
60338,445,0,0,70,70,0,1,0,1,0,drop,0,1,Known Attack
55025,443,11622,443,7599,3113,4486,30,20,17,13,allow,1,0,Potential Threat
50130,53,36317,53,179,94,85,2,30,1,1,allow,0,0,Normal
60965,445,0,0,70,70,0,1,0,1,0,drop,0,1,Known Attack
64505,53,32135,53,214,102,112,2,30,1,1,allow,0,0,Normal
5790,43890,0,0,62,62,0,1,0,1,0,deny,1,1,High Risk
60867,443,23930,443,14125,3827,10298,33,45,18,15,allow,1,0,Potential Threat
49665,53,35069,53,168,86,82,2,32,1,1,allow,0,0,Normal
52936,445,0,0,66,66,0,1,0,1,0,drop,0,1,Known Attack
57137,53,2649,53,279,96,183,4,31,2,2,allow,0,0,Normal
49761,80,17829,80,2113,1181,932,10,127,6,4,allow,1,0,Potential Threat
58744,1433,0,0,60,60,0,1,0,1,0,deny,0,1,Known Attack
27005,27237,36473,27237,876,126,750,2,30,1,1,allow,1,0,Potential Threat
62935,445,0,0,70,70,0,1,0,1,0,drop,0,1,Known Attack
19412,53,19412,53,229,98,131,2,30,1,1,allow,0,0,Normal
55564,53,55564,53,215,88,127,2,30,1,1,allow,0,0,Normal
52280,44847,0,0,66,66,0,1,0,1,0,deny,0,1,Known Attack
63869,34368,37141,34368,70,70,0,1,4,1,0,allow,1,0,Potential Threat
46000,53,44521,53,164,78,86,2,31,1,1,allow,0,0,Normal
57136,53,53104,53,177,94,83,2,30,1,1,allow,0,0,Normal
64415,53,15855,53,221,94,127,2,30,1,1,allow,0,0,Normal
16387,51369,0,0,60,60,0,1,0,1,0,deny,1,1,High Risk
52162,15104,33803,15104,70,70,0,2,7,2,0,allow,1,0,Potential Threat
53680,445,0,0,70,70,0,1,0,1,0,drop,0,1,Known Attack
57252,53,26443,53,229,102,127,2,30,1,1,allow,0,0,Normal
57206,53,29989,53,292,85,207,4,50,2,2,allow,0,0,Normal
26048,21,0,0,60,60,0,1,0,1,0,deny,0,1,Known Attack
53366,445,0,0,66,66,0,1,0,1,0,drop,0,1,Known Attack
63914,32805,62469,32805,66,66,0,2,8,2,0,allow,1,0,Potential Threat
37627,443,10583,443,70,70,0,2,5,2,0,allow,0,0,Normal
3052,20421,0,0,104,104,0,1,0,1,0,deny,1,1,High Risk
49991,80,28668,80,2095,1010,1085,11,87,6,5,allow,0,0,Normal
44884,443,19838,443,36435,28844,7591,65,396,35,30,allow,1,0,Potential Threat
58174,445,0,0,66,66,0,1,0,1,0,drop,0,1,Known Attack
52666,40108,0,0,148,148,0,1,0,1,0,deny,1,1,High Risk
57970,445,0,0,66,66,0,1,0,1,0,drop,0,1,Known Attack
65136,445,0,0,66,66,0,1,0,1,0,drop,0,1,Known Attack
49524,445,0,0,66,66,0,1,0,1,0,drop,0,1,Known Attack
55554,445,0,0,70,70,0,1,0,1,0,drop,0,1,Known Attack
64190,2767,0,0,66,66,0,1,0,1,0,deny,0,1,Known Attack
50465,445,0,0,70,70,0,1,0,1,0,drop,0,1,Known Attack
52560,445,0,0,70,70,0,1,0,1,0,drop,0,1,Known Attack
52167,80,36480,80,1734,800,934,10,16,6,4,allow,0,0,Normal
27005,27015,42995,27015,1758,252,1506,5,32,3,2,allow,1,0,Potential Threat
14082,50584,0,0,66,66,0,1,0,1,0,deny,1,1,High Risk
49708,53,16944,53,178,94,84,2,30,1,1,allow,0,0,Normal
55942,445,0,0,70,70,0,1,0,1,0,drop,0,1,Known Attack
49631,443,24213,443,6304,1793,4511,29,255,15,14,allow,1,0,Potential Threat
50254,445,0,0,70,70,0,1,0,1,0,drop,0,1,Known Attack
51811,445,0,0,70,70,0,1,0,1,0,drop,0,1,Known Attack
50471,80,51148,80,1658,1247,411,8,15,5,3,allow,0,0,Normal
50503,443,44653,443,9295,3094,6201,24,82,12,12,allow,1,0,Potential Threat
47749,53,47749,53,248,106,142,2,30,1,1,allow,0,0,Normal
65207,443,12429,443,8188,2769,5419,22,611,12,10,allow,1,0,Potential Threat
58638,5900,0,0,62,62,0,1,0,1,0,deny,0,1,Known Attack
60489,53151,64380,53151,70,70,0,2,8,2,0,allow,1,0,Potential Threat
52051,29868,57987,29868,70,70,0,1,4,1,0,allow,1,0,Potential Threat
5379,37965,0,0,62,62,0,1,0,1,0,deny,1,1,High Risk
14923,51505,0,0,62,62,0,1,0,1,0,deny,1,1,High Risk
55141,53,55990,53,184,94,90,2,30,1,1,allow,0,0,Normal
57128,445,0,0,70,70,0,1,0,1,0,drop,0,1,Known Attack
51398,445,0,0,70,70,0,1,0,1,0,drop,0,1,Known Attack
56924,53,48740,53,216,110,106,2,30,1,1,allow,0,0,Normal
60612,445,0,0,70,70,0,1,0,1,0,drop,0,1,Known Attack
31404,36841,0,0,100,100,0,1,0,1,0,deny,1,1,High Risk
56246,53,10681,53,816,97,719,2,31,1,1,allow,0,0,Normal
63968,53,62729,53,200,102,98,2,30,1,1,allow,1,0,Potential Threat
49891,443,20308,443,1820,1101,719,18,73,10,8,allow,0,0,Normal
49933,445,0,0,70,70,0,1,0,1,0,drop,0,1,Known Attack
64753,53,4084,53,287,102,185,2,30,1,1,allow,0,0,Normal
64228,53,55912,53,266,110,156,2,30,1,1,allow,0,0,Normal
64478,445,0,0,70,70,0,1,0,1,0,drop,0,1,Known Attack
55232,53,34536,53,177,94,83,2,29,1,1,allow,0,0,Normal
59728,5900,0,0,60,60,0,1,0,1,0,deny,0,1,Known Attack
64232,445,0,0,66,66,0,1,0,1,0,drop,0,1,Known Attack
33459,80,37833,80,1658,1344,314,10,14,5,5,allow,1,0,Potential Threat
49360,53,51221,53,321,102,219,2,30,1,1,allow,0,0,Normal
61933,445,0,0,66,66,0,1,0,1,0,drop,0,1,Known Attack
55312,53,24613,53,195,102,93,2,30,1,1,allow,0,0,Normal
61884,445,0,0,70,70,0,1,0,1,0,drop,0,1,Known Attack
47657,443,24927,443,502,140,362,8,140,3,5,allow,1,0,Potential Threat
53518,29500,52778,29500,320,140,180,6,7,3,3,allow,1,0,Potential Threat
37628,443,37628,443,1452,817,635,16,20,9,7,allow,1,0,Potential Threat
2422,50584,0,0,62,62,0,1,0,1,0,deny,1,1,High Risk
59738,443,4655,443,510,164,346,2,31,1,1,allow,0,0,Normal
0,0,0,0,244,244,0,2,0,2,0,allow,1,0,Potential Threat
62860,443,23047,443,4954,2554,2400,11,122,6,5,allow,1,0,Potential Threat
55296,23718,0,0,66,66,0,1,0,1,0,deny,0,1,Known Attack
58935,445,0,0,66,66,0,1,0,1,0,drop,0,1,Known Attack
58530,445,0,0,66,66,0,1,0,1,0,drop,0,1,Known Attack
59773,53,31376,53,193,94,99,2,30,1,1,allow,0,0,Normal
50668,58833,0,0,66,66,0,1,0,1,0,deny,1,1,High Risk
52931,443,65247,443,8519,1687,6832,29,17,16,13,allow,1,0,Potential Threat
50594,25174,0,0,66,66,0,1,0,1,0,deny,0,1,Known Attack
49922,445,0,0,70,70,0,1,0,1,0,drop,0,1,Known Attack
64823,53,7121,53,199,102,97,2,31,1,1,allow,0,0,Normal
49290,53,50836,53,184,94,90,2,30,1,1,allow,0,0,Normal
2074,32480,0,0,146,146,0,1,0,1,0,deny,1,1,High Risk
49350,80,17216,80,2485,529,1956,12,17,6,6,allow,0,0,Normal
53126,47035,20200,47035,70,70,0,1,5,1,0,allow,1,0,Potential Threat
50020,53,1594,53,210,102,108,2,30,1,1,allow,0,0,Normal
56860,53,63586,53,184,102,82,2,30,1,1,allow,1,0,Potential Threat
50264,443,29730,443,430,60,370,7,24,2,5,allow,0,0,Normal
42071,443,52227,443,9366,5830,3536,23,121,12,11,allow,1,0,Potential Threat
64711,53,46738,53,211,110,101,2,30,1,1,allow,0,0,Normal
27969,25174,0,0,66,66,0,1,0,1,0,deny,0,1,Known Attack
38484,48637,0,0,60,60,0,1,0,1,0,deny,0,1,Known Attack
58874,443,39745,443,21478,2212,19266,47,86,19,28,allow,1,0,Potential Threat
1038,37965,0,0,62,62,0,1,0,1,0,deny,1,1,High Risk
57015,80,24329,80,214,140,74,4,31,3,1,allow,0,0,Normal
65201,53,38349,53,216,110,106,2,30,1,1,allow,0,0,Normal
56163,53,27486,53,188,96,92,2,31,1,1,allow,0,0,Normal
50787,445,0,0,66,66,0,1,0,1,0,drop,0,1,Known Attack
60697,445,0,0,66,66,0,1,0,1,0,drop,0,1,Known Attack
59789,445,0,0,70,70,0,1,0,1,0,drop,0,1,Known Attack
51541,3389,51541,3389,3609,1654,1955,19,18,11,8,allow,1,0,Potential Threat
59422,445,0,0,70,70,0,1,0,1,0,drop,0,1,Known Attack
54955,443,20454,443,10265,1831,8434,34,319,17,17,allow,1,0,Potential Threat
63772,35440,0,0,66,66,0,1,0,1,0,deny,0,1,Known Attack
57001,53,43521,53,177,94,83,2,30,1,1,allow,0,0,Normal
55229,53,55587,53,199,94,105,2,30,1,1,allow,0,0,Normal
49535,80,31379,80,1548,847,701,10,16,5,5,allow,0,0,Normal
49392,80,13895,80,156587,46628,109959,307,314,203,104,allow,1,0,Potential Threat
49160,57470,0,0,146,146,0,1,0,1,0,deny,1,1,High Risk
55774,8060,26633,8060,70,70,0,2,8,2,0,allow,1,0,Potential Threat
52312,80,52312,80,450,246,204,8,29,5,3,allow,0,0,Normal
65091,445,0,0,70,70,0,1,0,1,0,drop,0,1,Known Attack
57122,53,3566,53,216,110,106,2,30,1,1,allow,0,0,Normal
34600,80,41483,80,3089,775,2314,15,16,9,6,allow,1,0,Potential Threat
58638,5900,0,0,62,62,0,1,0,1,0,deny,0,1,Known Attack
61865,445,0,0,70,70,0,1,0,1,0,drop,0,1,Known Attack
60339,7010,60339,7010,3322,2027,1295,16,16,9,7,allow,1,0,Potential Threat
64999,53,20323,53,515,86,429,4,45,2,2,allow,0,0,Normal
57664,80,57664,80,1917,1468,449,10,19,6,4,allow,1,0,Potential Threat
7482,57470,0,0,66,66,0,1,0,1,0,deny,1,1,High Risk
64726,53,58493,53,352,94,258,2,30,1,1,allow,0,0,Normal
56134,53,59241,53,183,94,89,2,29,1,1,allow,0,0,Normal
64762,53,20987,53,194,102,92,2,31,1,1,allow,0,0,Normal
57706,445,0,0,70,70,0,1,0,1,0,drop,0,1,Known Attack
29017,2222,0,0,60,60,0,1,0,1,0,deny,0,1,Known Attack
61345,21247,0,0,62,62,0,1,0,1,0,deny,0,1,Known Attack
54883,51505,0,0,62,62,0,1,0,1,0,deny,0,1,Known Attack
60114,445,0,0,70,70,0,1,0,1,0,drop,0,1,Known Attack
59361,445,0,0,70,70,0,1,0,1,0,drop,0,1,Known Attack
63527,445,0,0,70,70,0,1,0,1,0,drop,0,1,Known Attack
16393,22114,0,0,62,62,0,1,0,1,0,deny,0,1,Known Attack
9223,443,33719,443,4081,443,3638,12,15,6,6,allow,1,0,Potential Threat
56126,53,32815,53,183,94,89,2,30,1,1,allow,0,0,Normal
61135,50265,0,0,62,62,0,1,0,1,0,deny,1,1,High Risk
56579,53,36844,53,288,94,194,2,30,1,1,allow,0,0,Normal
57068,445,0,0,70,70,0,1,0,1,0,drop,0,1,Known Attack
58528,445,0,0,70,70,0,1,0,1,0,drop,0,1,Known Attack
58357,62413,0,0,146,146,0,1,0,1,0,deny,1,1,High Risk
65380,53,10002,53,180,94,86,2,30,1,1,allow,0,0,Normal
65189,27214,42310,27214,231,78,153,2,29,1,1,allow,1,0,Potential Threat
63133,445,0,0,70,70,0,1,0,1,0,drop,0,1,Known Attack
55815,443,3642,443,8602,1050,7552,16,120,7,9,allow,1,0,Potential Threat
49312,53,8379,53,216,94,122,2,29,1,1,allow,0,0,Normal
0,0,0,0,156,156,0,2,0,2,0,deny,1,1,High Risk
52696,21247,0,0,66,66,0,1,0,1,0,deny,0,1,Known Attack
55481,53,35011,53,758,96,662,2,30,1,1,allow,0,0,Normal
55478,445,0,0,66,66,0,1,0,1,0,drop,0,1,Known Attack
55411,53,25352,53,183,94,89,2,30,1,1,allow,0,0,Normal
50684,443,36548,443,6909,2495,4414,20,15,11,9,allow,1,0,Potential Threat
54184,445,0,0,70,70,0,1,0,1,0,drop,0,1,Known Attack
57255,445,0,0,70,70,0,1,0,1,0,drop,0,1,Known Attack
55669,53,24694,53,195,94,101,2,30,1,1,allow,0,0,Normal
51265,31652,0,0,72,72,0,1,0,1,0,reset-both,0,1,Known Attack
64588,53,11970,53,193,102,91,2,29,1,1,allow,0,0,Normal
49918,53,24031,53,196,100,96,2,31,1,1,allow,0,0,Normal
52933,80,52933,80,98765,5293,93472,131,199,48,83,allow,1,0,Potential Threat
56192,53,2949,53,170,87,83,2,30,1,1,allow,0,0,Normal
64878,26467,0,0,145,145,0,1,0,1,0,deny,1,1,High Risk
56906,50584,0,0,146,146,0,1,0,1,0,deny,1,1,High Risk
59974,443,48312,443,200862,57949,142913,361,24,172,189,allow,1,0,Potential Threat
53803,17637,39254,17637,70,70,0,1,5,1,0,allow,1,0,Potential Threat
61110,445,0,0,66,66,0,1,0,1,0,drop,0,1,Known Attack
51272,12210,15332,12210,70,70,0,1,5,1,0,allow,1,0,Potential Threat
61609,25174,0,0,146,146,0,1,0,1,0,deny,1,1,High Risk
49540,53,42804,53,754,94,660,2,31,1,1,allow,0,0,Normal
56379,53,29859,53,166,86,80,2,31,1,1,allow,0,0,Normal
49765,53,55989,53,233,102,131,2,30,1,1,allow,0,0,Normal
64835,445,0,0,66,66,0,1,0,1,0,drop,0,1,Known Attack
55325,53,48577,53,198,101,97,2,30,1,1,allow,0,0,Normal
64296,445,0,0,66,66,0,1,0,1,0,drop,0,1,Known Attack
61406,445,0,0,70,70,0,1,0,1,0,drop,0,1,Known Attack
56415,53,9528,53,199,102,97,2,30,1,1,allow,0,0,Normal
55000,5222,35744,5222,32608,22014,10594,225,215,124,101,allow,1,0,Potential Threat
49536,53,5228,53,239,94,145,2,30,1,1,allow,0,0,Normal
54828,443,24747,443,6296,1556,4740,22,16,12,10,allow,1,0,Potential Threat
49762,80,8921,80,2114,1182,932,10,127,6,4,allow,1,0,Potential Threat
56689,445,0,0,66,66,0,1,0,1,0,drop,0,1,Known Attack
55915,53,47313,53,86,86,0,1,30,1,0,allow,0,0,Normal
3818,37965,0,0,66,66,0,1,0,1,0,deny,1,1,High Risk
34810,25174,0,0,62,62,0,1,0,1,0,deny,0,1,Known Attack
58472,445,0,0,70,70,0,1,0,1,0,drop,0,1,Known Attack
52015,80,59849,80,14830,11044,3786,27,37,15,12,allow,1,0,Potential Threat
64562,53,22327,53,371,94,277,2,30,1,1,allow,0,0,Normal
65181,53,41975,53,421,96,325,4,42,2,2,allow,0,0,Normal
4232,50584,0,0,66,66,0,1,0,1,0,deny,1,1,High Risk
52188,13182,17024,13182,70,70,0,1,4,1,0,allow,1,0,Potential Threat
49769,53,37724,53,780,93,687,2,31,1,1,allow,0,0,Normal
37965,51413,62222,51413,158,158,0,1,1200,1,0,allow,1,0,Potential Threat
51880,8001,53470,8001,86,86,0,1,29,1,0,allow,1,0,Potential Threat
58246,445,0,0,66,66,0,1,0,1,0,drop,0,1,Known Attack
34170,80,4419,80,2865,2000,865,12,16,7,5,allow,1,0,Potential Threat
40203,80,61605,80,28577,1878,26699,47,31,23,24,allow,1,0,Potential Threat
64070,53,32128,53,243,94,149,2,31,1,1,allow,0,0,Normal
56278,52752,0,0,62,62,0,1,0,1,0,deny,0,1,Known Attack
51810,445,0,0,70,70,0,1,0,1,0,drop,0,1,Known Attack
51872,443,26165,443,442,250,192,8,30,5,3,allow,0,0,Normal
50968,443,5698,443,7532,3051,4481,13,120,6,7,allow,1,0,Potential Threat
6881,6881,0,0,62,62,0,1,0,1,0,deny,0,1,Known Attack
64055,45105,11907,45105,66,66,0,2,7,2,0,allow,1,0,Potential Threat
55052,53,42687,53,198,102,96,2,30,1,1,allow,0,0,Normal
65136,53,1364,53,86,86,0,1,30,1,0,allow,0,0,Normal
37927,50265,0,0,66,66,0,1,0,1,0,deny,0,1,Known Attack
7308,50584,0,0,66,66,0,1,0,1,0,deny,1,1,High Risk
50801,443,41271,443,6893,1384,5509,19,140,9,10,allow,1,0,Potential Threat
55649,443,18027,443,7045,2145,4900,18,136,8,10,allow,1,0,Potential Threat
57813,443,65376,443,6163,925,5238,18,109,10,8,allow,1,0,Potential Threat
53459,37807,0,0,62,62,0,1,0,1,0,deny,0,1,Known Attack
59374,51505,0,0,62,62,0,1,0,1,0,deny,0,1,Known Attack
49532,53,28306,53,730,102,628,2,31,1,1,allow,0,0,Normal
50405,445,0,0,70,70,0,1,0,1,0,drop,0,1,Known Attack
56972,53,28054,53,177,94,83,2,30,1,1,allow,0,0,Normal
49418,33058,55897,33058,244,78,166,2,30,1,1,allow,1,0,Potential Threat
11136,19910,0,0,145,145,0,1,0,1,0,deny,1,1,High Risk
56513,53,43170,53,184,86,98,2,30,1,1,allow,0,0,Normal
56656,445,0,0,70,70,0,1,0,1,0,drop,0,1,Known Attack
55698,45710,57579,45710,70,70,0,1,5,1,0,allow,1,0,Potential Threat
52565,445,0,0,70,70,0,1,0,1,0,drop,0,1,Known Attack
55232,25174,0,0,146,146,0,1,0,1,0,deny,1,1,High Risk
49229,53,40938,53,183,94,89,2,29,1,1,allow,0,0,Normal
52216,80,58055,80,15824,805,15019,25,18,9,16,allow,1,0,Potential Threat
46116,57470,0,0,74,74,0,1,0,1,0,deny,1,1,High Risk
60234,80,15861,80,1131,772,359,10,151,6,4,allow,1,0,Potential Threat
44411,37965,0,0,62,62,0,1,0,1,0,deny,0,1,Known Attack
48706,23393,0,0,60,60,0,1,0,1,0,deny,0,1,Known Attack
2525,23,0,0,60,60,0,1,0,1,0,deny,1,1,High Risk
26553,57470,0,0,62,62,0,1,0,1,0,deny,1,1,High Risk
55496,80,55496,80,124,60,64,2,5,1,1,allow,0,0,Normal
2791,7302,0,0,62,62,0,1,0,1,0,deny,1,1,High Risk
50272,53,50516,53,168,78,90,2,30,1,1,allow,0,0,Normal
47727,25174,0,0,146,146,0,1,0,1,0,deny,1,1,High Risk
57236,53,14592,53,748,95,653,2,30,1,1,allow,0,0,Normal
65383,53,42198,53,267,94,173,2,30,1,1,allow,0,0,Normal
64175,56502,0,0,66,66,0,1,0,1,0,deny,1,1,High Risk
55708,445,0,0,70,70,0,1,0,1,0,drop,0,1,Known Attack
54167,50584,0,0,66,66,0,1,0,1,0,deny,0,1,Known Attack
65192,53,4438,53,172,88,84,2,30,1,1,allow,0,0,Normal
59892,445,0,0,70,70,0,1,0,1,0,drop,0,1,Known Attack
53118,445,0,0,70,70,0,1,0,1,0,drop,0,1,Known Attack
55630,53,11814,53,197,102,95,2,30,1,1,allow,0,0,Normal
57757,445,0,0,70,70,0,1,0,1,0,drop,0,1,Known Attack
50282,37965,0,0,66,66,0,1,0,1,0,deny,0,1,Known Attack
50022,443,50896,443,70,70,0,2,5,2,0,allow,0,0,Normal
64454,445,0,0,70,70,0,1,0,1,0,drop,0,1,Known Attack
63667,57470,0,0,145,145,0,1,0,1,0,deny,1,1,High Risk
38368,15000,38283,15000,130,70,60,2,5,1,1,allow,1,0,Potential Threat
50611,445,0,0,66,66,0,1,0,1,0,drop,0,1,Known Attack
10797,50584,0,0,62,62,0,1,0,1,0,deny,1,1,High Risk
60544,445,0,0,70,70,0,1,0,1,0,drop,0,1,Known Attack
38678,443,20008,443,380978,8857,372121,373,16,115,258,allow,1,0,Potential Threat
49856,443,10855,443,5512,978,4534,20,60,10,10,allow,1,0,Potential Threat
49672,80,61052,80,3874260,98179,3776081,4003,1072,1479,2524,allow,1,0,Potential Threat
50880,445,0,0,70,70,0,1,0,1,0,drop,0,1,Known Attack
56257,53,40578,53,177,94,83,2,31,1,1,allow,0,0,Normal
64791,53,19745,53,763,102,661,2,29,1,1,allow,0,0,Normal
59624,445,0,0,70,70,0,1,0,1,0,drop,0,1,Known Attack
41432,53,63040,53,202,83,119,2,30,1,1,allow,1,0,Potential Threat
64431,53,36891,53,177,94,83,2,30,1,1,allow,0,0,Normal
50402,445,0,0,66,66,0,1,0,1,0,drop,0,1,Known Attack
58758,445,0,0,66,66,0,1,0,1,0,drop,0,1,Known Attack
40865,8100,52976,8100,78,78,0,1,5,1,0,allow,1,0,Potential Threat
63708,445,0,0,70,70,0,1,0,1,0,drop,0,1,Known Attack
55223,53,54493,53,168,86,82,2,31,1,1,allow,0,0,Normal
10967,3389,10967,3389,293,223,70,4,1,3,1,reset-both,1,1,High Risk
58638,5900,0,0,62,62,0,1,0,1,0,deny,0,1,Known Attack
57585,51221,0,0,62,62,0,1,0,1,0,deny,0,1,Known Attack
58785,53,54759,53,211,86,125,2,30,1,1,allow,0,0,Normal
37034,25174,0,0,62,62,0,1,0,1,0,deny,0,1,Known Attack
61701,15503,0,0,66,66,0,1,0,1,0,deny,0,1,Known Attack
61636,25735,61636,25735,3828,1516,2312,29,5271,18,11,allow,1,0,Potential Threat
50028,53,64249,53,256,102,154,2,30,1,1,allow,1,0,Potential Threat
43129,20220,0,0,62,62,0,1,0,1,0,deny,0,1,Known Attack
55075,445,0,0,70,70,0,1,0,1,0,drop,0,1,Known Attack
58251,36237,0,0,66,66,0,1,0,1,0,deny,0,1,Known Attack
43314,443,48162,443,6102,782,5320,17,67,8,9,allow,1,0,Potential Threat
51218,5223,10817,5223,11005,5789,5216,34,23,18,16,allow,1,0,Potential Threat
53884,48754,22273,48754,70,70,0,1,4,1,0,allow,1,0,Potential Threat
59653,80,58858,80,1139,609,530,10,34,6,4,allow,1,0,Potential Threat
64818,53,61380,53,260,102,158,2,30,1,1,allow,1,0,Potential Threat
56552,53,11395,53,190,97,93,2,31,1,1,allow,0,0,Normal
52219,37398,8768,37398,316,136,180,6,8,3,3,allow,1,0,Potential Threat
7934,443,7934,443,6593,3073,3520,27,82,14,13,allow,1,0,Potential Threat
443,28417,0,0,82,82,0,1,0,1,0,deny,1,1,High Risk
51098,445,0,0,70,70,0,1,0,1,0,drop,0,1,Known Attack
56996,445,0,0,70,70,0,1,0,1,0,drop,0,1,Known Attack
33812,443,2950,443,16120,8754,7366,36,327,21,15,allow,1,0,Potential Threat
58638,5900,0,0,62,62,0,1,0,1,0,deny,0,1,Known Attack
49985,443,2510,443,10737,3664,7073,20,137,10,10,allow,1,0,Potential Threat
63599,445,0,0,70,70,0,1,0,1,0,drop,0,1,Known Attack
58638,5900,0,0,62,62,0,1,0,1,0,deny,0,1,Known Attack
51896,445,0,0,66,66,0,1,0,1,0,drop,0,1,Known Attack
49332,445,0,0,66,66,0,1,0,1,0,drop,0,1,Known Attack
58999,445,0,0,66,66,0,1,0,1,0,drop,0,1,Known Attack
61886,443,1075,443,8829,3335,5494,16,126,9,7,allow,1,0,Potential Threat
49535,445,0,0,66,66,0,1,0,1,0,drop,0,1,Known Attack
45103,80,17939,80,1748,716,1032,19,409,6,13,allow,1,0,Potential Threat
55577,53,20988,53,199,102,97,2,30,1,1,allow,0,0,Normal
49917,53,47966,53,752,93,659,2,31,1,1,allow,0,0,Normal
64665,53,19631,53,181,94,87,2,31,1,1,allow,0,0,Normal
52042,53,52042,53,478,292,186,5,30,3,2,allow,0,0,Normal
39807,443,25771,443,1684,1031,653,16,92,9,7,allow,1,0,Potential Threat
54826,56205,0,0,66,66,0,1,0,1,0,deny,0,1,Known Attack
60765,445,0,0,70,70,0,1,0,1,0,drop,0,1,Known Attack
55335,445,0,0,70,70,0,1,0,1,0,drop,0,1,Known Attack
45292,443,27457,443,26444,2671,23773,52,363,25,27,allow,1,0,Potential Threat
61406,445,0,0,70,70,0,1,0,1,0,drop,0,1,Known Attack
57290,53,54259,53,178,94,84,2,30,1,1,allow,0,0,Normal
55659,37787,47813,37787,70,70,0,2,8,2,0,allow,1,0,Potential Threat
49707,53,0,0,82,82,0,1,31,1,0,allow,0,0,Normal
55889,53,7976,53,168,86,82,2,30,1,1,allow,0,0,Normal
56382,53,40376,53,195,102,93,2,29,1,1,allow,0,0,Normal
58095,445,0,0,70,70,0,1,0,1,0,drop,0,1,Known Attack
51977,18504,5519,18504,70,70,0,1,5,1,0,allow,1,0,Potential Threat
60281,80,39760,80,1151,711,440,10,16,5,5,allow,1,0,Potential Threat
49226,53,7327,53,194,102,92,2,29,1,1,allow,0,0,Normal
65428,53,7407,53,731,85,646,2,31,1,1,allow,0,0,Normal
64962,64147,0,0,66,66,0,1,0,1,0,deny,1,1,High Risk
56482,443,53337,443,10788,6521,4267,61,134,31,30,allow,1,0,Potential Threat
27988,40029,26130,40029,140,78,62,2,30,1,1,allow,1,0,Potential Threat
2383,37965,0,0,66,66,0,1,0,1,0,deny,1,1,High Risk
50782,445,0,0,66,66,0,1,0,1,0,drop,0,1,Known Attack
51796,48779,55326,48779,70,70,0,2,8,2,0,allow,1,0,Potential Threat
65164,53,35312,53,262,94,168,2,30,1,1,allow,0,0,Normal
35428,443,14497,443,9592,2361,7231,25,15,14,11,allow,1,0,Potential Threat
35292,8100,45355,8100,78,78,0,1,4,1,0,allow,1,0,Potential Threat
47377,443,54637,443,2725,1153,1572,19,208,8,11,allow,1,0,Potential Threat
53904,1024,57585,1024,70,70,0,2,8,2,0,allow,1,0,Potential Threat
59146,445,0,0,66,66,0,1,0,1,0,drop,0,1,Known Attack
56056,445,0,0,70,70,0,1,0,1,0,drop,0,1,Known Attack
62799,25174,0,0,62,62,0,1,0,1,0,deny,0,1,Known Attack
55420,445,0,0,70,70,0,1,0,1,0,drop,0,1,Known Attack
44864,25,44864,25,130,66,64,2,5,1,1,allow,0,0,Normal
57233,50934,0,0,66,66,0,1,0,1,0,deny,0,1,Known Attack
56704,53,2427,53,318,94,224,2,30,1,1,allow,0,0,Normal
43916,21,0,0,60,60,0,1,0,1,0,deny,0,1,Known Attack
56702,445,0,0,70,70,0,1,0,1,0,drop,0,1,Known Attack
49935,53,10954,53,75,75,0,1,30,1,0,allow,0,0,Normal
52098,445,0,0,70,70,0,1,0,1,0,drop,0,1,Known Attack
56909,443,38825,443,31860,21778,10082,84,190,42,42,allow,1,0,Potential Threat
33555,443,31836,443,10856,3151,7705,34,361,16,18,allow,1,0,Potential Threat
50396,62413,0,0,66,66,0,1,0,1,0,deny,1,1,High Risk
64235,445,0,0,66,66,0,1,0,1,0,drop,0,1,Known Attack
15774,56205,0,0,66,66,0,1,0,1,0,deny,1,1,High Risk
55235,53,63921,53,178,94,84,2,30,1,1,allow,1,0,Potential Threat
17781,50265,0,0,62,62,0,1,0,1,0,deny,1,1,High Risk
53691,445,0,0,66,66,0,1,0,1,0,drop,0,1,Known Attack
47445,443,40456,443,8710,2009,6701,30,395,10,20,allow,1,0,Potential Threat
46261,80,62301,80,3578,1673,1905,16,186,9,7,allow,1,0,Potential Threat
49440,443,59866,443,5141,896,4245,17,69,8,9,allow,1,0,Potential Threat
60367,443,5802,443,12979,6398,6581,39,115,22,17,allow,1,0,Potential Threat
65114,53,6427,53,253,87,166,4,31,2,2,allow,0,0,Normal
50281,443,10698,443,25811,4278,21533,73,100,38,35,allow,1,0,Potential Threat
50991,443,38073,443,6448,2376,4072,22,2,10,12,allow,1,0,Potential Threat
53753,445,0,0,66,66,0,1,0,1,0,drop,0,1,Known Attack
51087,80,58473,80,6363,3093,3270,36,130,19,17,allow,1,0,Potential Threat
55282,53,18223,53,771,101,670,2,31,1,1,allow,0,0,Normal
55876,445,0,0,70,70,0,1,0,1,0,drop,0,1,Known Attack
49817,53,29101,53,401,91,310,4,29,2,2,allow,0,0,Normal
59739,35253,0,0,62,62,0,1,0,1,0,deny,0,1,Known Attack
42277,443,42277,443,2200,1253,947,23,76,12,11,allow,1,0,Potential Threat
64030,53,24656,53,338,110,228,2,30,1,1,allow,0,0,Normal
27005,27018,55202,27018,881,126,755,2,30,1,1,allow,1,0,Potential Threat
51811,445,0,0,70,70,0,1,0,1,0,drop,0,1,Known Attack
65002,445,0,0,70,70,0,1,0,1,0,drop,0,1,Known Attack
55174,53,1640,53,774,101,673,2,0,1,1,allow,0,0,Normal
19944,22114,0,0,66,66,0,1,0,1,0,deny,0,1,Known Attack
49921,53,58309,53,214,110,104,2,30,1,1,allow,0,0,Normal
50936,80,62610,80,10423067,111935,10311132,8558,119,1601,6957,allow,1,0,Potential Threat
42951,44847,0,0,66,66,0,1,0,1,0,deny,0,1,Known Attack
50810,445,0,0,70,70,0,1,0,1,0,drop,0,1,Known Attack
49414,53,16481,53,770,102,668,2,31,1,1,allow,0,0,Normal
51890,31122,40957,31122,70,70,0,2,8,2,0,allow,1,0,Potential Threat
56724,443,8554,443,14956,2081,12875,30,20,16,14,allow,1,0,Potential Threat
65489,53,22228,53,242,102,140,2,30,1,1,allow,0,0,Normal
49418,27022,63608,27022,229,71,158,2,31,1,1,allow,1,0,Potential Threat
31994,53,31994,53,244,98,146,2,33,1,1,allow,0,0,Normal
52008,49383,19063,49383,70,70,0,1,5,1,0,allow,1,0,Potential Threat
54570,445,0,0,66,66,0,1,0,1,0,drop,0,1,Known Attack
64689,53,18910,53,182,93,89,2,31,1,1,allow,0,0,Normal
9237,80,59192,80,378,192,186,7,26,4,3,allow,1,0,Potential Threat
47169,15000,52806,15000,130,70,60,2,5,1,1,allow,1,0,Potential Threat
60166,80,1732,80,186,64,122,4,28,2,2,allow,0,0,Normal
65453,445,0,0,66,66,0,1,0,1,0,drop,0,1,Known Attack
57044,445,0,0,66,66,0,1,0,1,0,drop,0,1,Known Attack
60049,25174,0,0,66,66,0,1,0,1,0,deny,0,1,Known Attack
55796,53,15761,53,196,102,94,2,31,1,1,allow,0,0,Normal
51638,443,56586,443,8176,2082,6094,26,360,12,14,allow,1,0,Potential Threat
59523,37965,0,0,62,62,0,1,0,1,0,deny,0,1,Known Attack
39538,80,23642,80,2191,1142,1049,21,370,9,12,allow,1,0,Potential Threat
52165,49740,12957,49740,70,70,0,1,5,1,0,allow,1,0,Potential Threat
52649,445,0,0,70,70,0,1,0,1,0,drop,0,1,Known Attack
62102,443,56889,443,3466,821,2645,11,121,5,6,allow,1,0,Potential Threat
57729,443,45932,443,12689,5742,6947,26,43,14,12,allow,1,0,Potential Threat
55700,26957,33294,26957,70,70,0,2,8,2,0,allow,1,0,Potential Threat
54061,443,17849,443,126027,103934,22093,380,239,237,143,allow,1,0,Potential Threat
27005,27016,57250,27016,1784,252,1532,5,31,3,2,allow,1,0,Potential Threat
51976,443,42576,443,2466,1497,969,21,46,12,9,allow,1,0,Potential Threat
53259,445,0,0,70,70,0,1,0,1,0,drop,0,1,Known Attack
22784,9571,0,0,62,62,0,1,0,1,0,deny,0,1,Known Attack
54898,443,54771,443,78537,4022,74515,120,386,55,65,allow,1,0,Potential Threat
64276,53,63257,53,398,105,293,4,46,2,2,allow,1,0,Potential Threat
37659,443,25278,443,3354,2353,1001,18,45,11,7,allow,1,0,Potential Threat
32845,9797,0,0,60,60,0,1,0,1,0,deny,0,1,Known Attack
51353,445,0,0,70,70,0,1,0,1,0,drop,0,1,Known Attack
65117,53,5041,53,196,100,96,2,31,1,1,allow,0,0,Normal
60556,28678,33348,28678,1806,1806,0,22,224,22,0,allow,1,0,Potential Threat
64463,53,2430,53,183,94,89,2,29,1,1,allow,0,0,Normal
31521,57470,0,0,145,145,0,1,0,1,0,deny,1,1,High Risk
49351,53,13338,53,166,86,80,2,30,1,1,allow,0,0,Normal
31660,35440,0,0,66,66,0,1,0,1,0,deny,0,1,Known Attack
58936,443,47053,443,9081,3368,5713,42,76,24,18,allow,1,0,Potential Threat
25363,22114,0,0,66,66,0,1,0,1,0,deny,0,1,Known Attack
51766,48169,32212,48169,70,70,0,1,5,1,0,allow,1,0,Potential Threat
49418,27015,47175,27015,234,78,156,2,30,1,1,allow,1,0,Potential Threat
56387,25174,0,0,66,66,0,1,0,1,0,deny,0,1,Known Attack
40500,48817,0,0,143,143,0,1,0,1,0,deny,1,1,High Risk
64945,53,11913,53,760,97,663,2,30,1,1,allow,0,0,Normal
47982,443,20773,443,83558,8567,74991,180,171,92,88,allow,1,0,Potential Threat
54235,445,0,0,70,70,0,1,0,1,0,drop,0,1,Known Attack
44453,1433,0,0,60,60,0,1,0,1,0,deny,0,1,Known Attack
55029,443,56750,443,35270,2782,32488,48,51,22,26,allow,1,0,Potential Threat
6881,35894,0,0,62,62,0,1,0,1,0,deny,1,1,High Risk
60787,445,0,0,70,70,0,1,0,1,0,drop,0,1,Known Attack
42934,443,24809,443,232,172,60,3,5,2,1,allow,0,0,Normal
39392,80,20430,80,1325,442,883,16,414,4,12,allow,1,0,Potential Threat
47910,7454,0,0,60,60,0,1,0,1,0,deny,0,1,Known Attack
64162,53,14611,53,225,110,115,2,30,1,1,allow,0,0,Normal
65045,53,16728,53,197,102,95,2,29,1,1,allow,0,0,Normal
64041,80,63585,80,314,192,122,6,15,4,2,allow,1,0,Potential Threat
60045,443,3000,443,1573,769,804,16,47,9,7,allow,1,0,Potential Threat
58889,445,0,0,66,66,0,1,0,1,0,drop,0,1,Known Attack
55169,53,64266,53,775,103,672,2,30,1,1,allow,1,0,Potential Threat
59801,443,35070,443,5678,2820,2858,25,141,11,14,allow,1,0,Potential Threat
50343,445,0,0,66,66,0,1,0,1,0,drop,0,1,Known Attack
46837,57470,0,0,62,62,0,1,0,1,0,deny,0,1,Known Attack
56660,53,34940,53,183,94,89,2,30,1,1,allow,0,0,Normal
33107,443,4785,443,3820081,140348,3679733,4457,136,1736,2721,allow,1,0,Potential Threat
38697,443,5230,443,90001,3161,86840,91,15,26,65,allow,1,0,Potential Threat
26448,9192,0,0,145,145,0,1,0,1,0,deny,1,1,High Risk
58251,36237,0,0,66,66,0,1,0,1,0,deny,0,1,Known Attack
56743,53,5034,53,209,110,99,2,30,1,1,allow,0,0,Normal
52733,445,0,0,70,70,0,1,0,1,0,drop,0,1,Known Attack
48346,443,9051,443,2272788,106549,2166239,2492,190,850,1642,allow,1,0,Potential Threat
58638,5900,0,0,62,62,0,1,0,1,0,deny,0,1,Known Attack
39068,443,31079,443,10831,1381,9450,22,20,12,10,allow,1,0,Potential Threat
7664,2149,0,0,66,66,0,1,0,1,0,deny,0,1,Known Attack
56845,53,65473,53,233,102,131,2,30,1,1,allow,1,0,Potential Threat
64368,22114,0,0,62,62,0,1,0,1,0,deny,0,1,Known Attack
48015,443,45822,443,19394,2961,16433,51,196,24,27,allow,1,0,Potential Threat
56020,445,0,0,66,66,0,1,0,1,0,drop,0,1,Known Attack
56857,53,63903,53,190,97,93,2,31,1,1,allow,1,0,Potential Threat
60527,35440,0,0,66,66,0,1,0,1,0,deny,0,1,Known Attack
49331,445,0,0,66,66,0,1,0,1,0,drop,0,1,Known Attack
51244,21162,0,0,100,100,0,1,0,1,0,deny,0,1,Known Attack
50635,80,60349,80,3722,1504,2218,13,20,7,6,allow,1,0,Potential Threat
50148,445,0,0,66,66,0,1,0,1,0,drop,0,1,Known Attack
53963,445,0,0,66,66,0,1,0,1,0,drop,0,1,Known Attack
65209,53,36498,53,166,86,80,2,30,1,1,allow,0,0,Normal
27160,64147,0,0,66,66,0,1,0,1,0,deny,1,1,High Risk
49805,6881,0,0,66,66,0,1,0,1,0,deny,0,1,Known Attack
56952,53,29584,53,193,102,91,2,30,1,1,allow,0,0,Normal
45964,2225,0,0,60,60,0,1,0,1,0,deny,0,1,Known Attack
49777,53,2324,53,485,79,406,4,31,2,2,allow,0,0,Normal
63529,445,0,0,70,70,0,1,0,1,0,drop,0,1,Known Attack
54563,445,0,0,70,70,0,1,0,1,0,drop,0,1,Known Attack
58871,443,24562,443,405189,13572,391617,446,89,155,291,allow,1,0,Potential Threat
49878,53,64175,53,327,102,225,2,30,1,1,allow,1,0,Potential Threat
49915,443,34488,443,7648,2967,4681,23,15,13,10,allow,1,0,Potential Threat
64771,53,10938,53,228,110,118,2,30,1,1,allow,0,0,Normal
55864,445,0,0,70,70,0,1,0,1,0,drop,0,1,Known Attack
49630,443,54596,443,7776,2266,5510,17,35,9,8,allow,1,0,Potential Threat
49354,443,37956,443,22643,7456,15187,32,15,17,15,allow,1,0,Potential Threat
65056,53,16740,53,168,94,74,2,30,1,1,allow,0,0,Normal
61698,445,0,0,70,70,0,1,0,1,0,drop,0,1,Known Attack
59651,60038,0,0,66,66,0,1,90,1,0,allow,1,0,Potential Threat
50854,445,0,0,70,70,0,1,0,1,0,drop,0,1,Known Attack
63009,443,26712,443,304,86,218,2,29,1,1,allow,0,0,Normal
57303,53,43423,53,177,94,83,2,30,1,1,allow,0,0,Normal
8194,21247,0,0,146,146,0,1,0,1,0,deny,1,1,High Risk
1880,57470,0,0,146,146,0,1,0,1,0,deny,1,1,High Risk
65008,445,0,0,70,70,0,1,0,1,0,drop,0,1,Known Attack
65350,53,48988,53,168,86,82,2,30,1,1,allow,0,0,Normal
443,45788,0,0,332,332,0,1,0,1,0,deny,1,1,High Risk
56588,53,38290,53,305,99,206,4,49,2,2,allow,0,0,Normal
39186,53,39186,53,371,237,134,3,33,2,1,allow,0,0,Normal
49383,445,0,0,70,70,0,1,0,1,0,drop,0,1,Known Attack
49760,1443,52471,1443,626,352,274,10,15,6,4,allow,1,0,Potential Threat
51976,80,64058,80,366,240,126,7,25,5,2,allow,1,0,Potential Threat
51939,445,0,0,70,70,0,1,0,1,0,drop,0,1,Known Attack
54796,22114,0,0,66,66,0,1,0,1,0,deny,0,1,Known Attack
55440,53,49182,53,752,93,659,2,31,1,1,allow,0,0,Normal
51353,46314,0,0,145,145,0,1,0,1,0,deny,1,1,High Risk
6881,21162,0,0,146,146,0,1,0,1,0,deny,1,1,High Risk
57269,53,43829,53,183,94,89,2,30,1,1,allow,0,0,Normal
57095,53,10011,53,177,94,83,2,30,1,1,allow,0,0,Normal
57470,5382,65418,5382,2411,1328,1083,19,1200,11,8,allow,1,0,Potential Threat
53142,47933,51357,47933,698,320,378,10,17,6,4,allow,1,0,Potential Threat
53692,53,53692,53,262,82,180,2,29,1,1,allow,0,0,Normal
59125,445,0,0,70,70,0,1,0,1,0,drop,0,1,Known Attack
56856,47715,33664,47715,70,70,0,2,8,2,0,allow,1,0,Potential Threat
55194,53,9824,53,195,102,93,2,31,1,1,allow,0,0,Normal
49648,443,58904,443,11011,4522,6489,35,45,17,18,allow,1,0,Potential Threat
64064,29856,35804,29856,66,66,0,2,8,2,0,allow,1,0,Potential Threat
65418,53,64332,53,211,102,109,2,30,1,1,allow,1,0,Potential Threat
64531,53,13391,53,754,94,660,2,30,1,1,allow,0,0,Normal
64101,445,0,0,70,70,0,1,0,1,0,drop,0,1,Known Attack
52485,445,0,0,70,70,0,1,0,1,0,drop,0,1,Known Attack
53761,54363,63571,54363,618,432,186,9,16,6,3,allow,1,0,Potential Threat
51418,53,32808,53,168,78,90,2,30,1,1,allow,0,0,Normal
64702,53,11324,53,760,97,663,2,31,1,1,allow,0,0,Normal
43827,443,64958,443,130,70,60,2,14,1,1,allow,1,0,Potential Threat
58638,5900,0,0,62,62,0,1,0,1,0,deny,0,1,Known Attack
59658,445,0,0,70,70,0,1,0,1,0,drop,0,1,Known Attack
61554,445,0,0,70,70,0,1,0,1,0,drop,0,1,Known Attack
65160,443,49536,443,1786,172,1614,7,120,3,4,allow,1,0,Potential Threat
57226,51505,0,0,66,66,0,1,0,1,0,deny,0,1,Known Attack
47013,44512,0,0,62,62,0,1,0,1,0,deny,0,1,Known Attack
53497,443,53212,443,17187157,553524,16633633,18453,352,6098,12355,allow,1,0,Potential Threat
63750,63343,38388,63343,66,66,0,2,8,2,0,allow,1,0,Potential Threat
62930,21247,0,0,66,66,0,1,0,1,0,deny,0,1,Known Attack
39817,443,13115,443,516080,28328,487752,660,95,305,355,allow,1,0,Potential Threat
53083,445,0,0,70,70,0,1,0,1,0,drop,0,1,Known Attack
52064,80,62647,80,65658,3155,62503,76,621,26,50,allow,1,0,Potential Threat
49243,80,49243,80,378,180,198,7,53,4,3,allow,0,0,Normal
49488,443,58643,443,90030,13137,76893,92,47,29,63,allow,1,0,Potential Threat
65046,53,1859,53,211,94,117,2,31,1,1,allow,0,0,Normal
53284,80,44514,80,6995,783,6212,14,317,7,7,allow,1,0,Potential Threat
53608,1024,52758,1024,70,70,0,2,8,2,0,allow,0,0,Normal
52462,25174,0,0,62,62,0,1,0,1,0,deny,0,1,Known Attack
25629,28678,25311,28678,1806,1806,0,22,225,22,0,allow,1,0,Potential Threat
64880,9694,0,0,66,66,0,1,0,1,0,deny,0,1,Known Attack
62081,445,0,0,70,70,0,1,0,1,0,drop,0,1,Known Attack
41787,443,37748,443,34237,22442,11795,86,131,41,45,allow,1,0,Potential Threat
55107,53,60741,53,184,94,90,2,29,1,1,allow,0,0,Normal
61944,445,0,0,70,70,0,1,0,1,0,drop,0,1,Known Attack
14715,56205,0,0,62,62,0,1,0,1,0,deny,1,1,High Risk
53513,56205,0,0,146,146,0,1,0,1,0,deny,1,1,High Risk
53035,80,53035,80,373926,8227,365699,379,143,130,249,allow,1,0,Potential Threat
57911,443,43527,443,9662,4079,5583,66,194,30,36,allow,1,0,Potential Threat
49267,53,65415,53,184,94,90,2,30,1,1,allow,1,0,Potential Threat
60015,445,0,0,70,70,0,1,0,1,0,drop,0,1,Known Attack
52231,50934,0,0,62,62,0,1,0,1,0,deny,0,1,Known Attack
60190,443,8550,443,10178,1101,9077,22,125,10,12,allow,1,0,Potential Threat
36003,123,29238,123,184,94,90,2,30,1,1,allow,0,0,Normal
57281,445,0,0,70,70,0,1,0,1,0,drop,0,1,Known Attack
58435,445,0,0,66,66,0,1,0,1,0,drop,0,1,Known Attack
64585,53,51194,53,210,110,100,2,30,1,1,allow,0,0,Normal
55656,445,0,0,70,70,0,1,0,1,0,drop,0,1,Known Attack
56773,445,0,0,70,70,0,1,0,1,0,drop,0,1,Known Attack
56041,53,6902,53,185,102,83,2,30,1,1,allow,0,0,Normal
56176,53,62297,53,102,102,0,1,30,1,0,allow,1,0,Potential Threat
10252,11392,0,0,62,62,0,1,0,1,0,deny,0,1,Known Attack
56446,445,0,0,70,70,0,1,0,1,0,drop,0,1,Known Attack
27005,27018,49128,27018,879,126,753,2,30,1,1,allow,1,0,Potential Threat
56958,53,59654,53,816,102,714,2,30,1,1,allow,0,0,Normal
56260,80,50522,80,72600,58760,13840,186,1232,107,79,allow,1,0,Potential Threat
65204,53,43316,53,183,94,89,2,30,1,1,allow,0,0,Normal
49500,80,17093,80,309313,41646,267667,433,486,113,320,allow,1,0,Potential Threat
59557,445,0,0,70,70,0,1,0,1,0,drop,0,1,Known Attack
46919,443,8853,443,7094,1672,5422,21,361,10,11,allow,1,0,Potential Threat
53106,59478,22060,59478,70,70,0,1,5,1,0,allow,1,0,Potential Threat
14829,443,14829,443,214215,11945,202270,260,94,110,150,allow,1,0,Potential Threat
35657,48637,0,0,62,62,0,1,0,1,0,deny,0,1,Known Attack
61060,445,0,0,70,70,0,1,0,1,0,drop,0,1,Known Attack
20012,8443,0,0,60,60,0,1,0,1,0,deny,0,1,Known Attack
49208,6881,3930,6881,70,70,0,2,8,2,0,allow,1,0,Potential Threat
61078,445,0,0,66,66,0,1,0,1,0,drop,0,1,Known Attack
50073,443,21032,443,9873,2384,7489,25,242,14,11,allow,1,0,Potential Threat
58638,5900,0,0,62,62,0,1,0,1,0,deny,0,1,Known Attack
45908,33330,0,0,60,60,0,1,0,1,0,deny,0,1,Known Attack
49633,80,21073,80,318,192,126,6,41,4,2,allow,0,0,Normal
55976,445,0,0,70,70,0,1,0,1,0,drop,0,1,Known Attack
53626,33194,63366,33194,70,70,0,1,4,1,0,allow,1,0,Potential Threat
62278,445,0,0,70,70,0,1,0,1,0,drop,0,1,Known Attack
64416,445,0,0,70,70,0,1,0,1,0,drop,0,1,Known Attack
8080,37965,0,0,62,62,0,1,0,1,0,deny,1,1,High Risk
38350,80,18584,80,1678,1364,314,10,16,5,5,allow,1,0,Potential Threat
57324,443,38455,443,5612,733,4879,16,14,9,7,allow,1,0,Potential Threat
65290,53,6842,53,181,94,87,2,29,1,1,allow,0,0,Normal
56995,53,18611,53,168,86,82,2,30,1,1,allow,0,0,Normal
35049,80,15791,80,5773,1197,4576,14,32,8,6,allow,1,0,Potential Threat
55545,445,0,0,70,70,0,1,0,1,0,drop,0,1,Known Attack
49809,53,6008,53,386,134,252,2,30,1,1,allow,0,0,Normal
55347,443,1685,443,116686,21822,94864,224,186,112,112,allow,1,0,Potential Threat
1024,57470,0,0,62,62,0,1,0,1,0,deny,1,1,High Risk
56792,53,2003,53,782,105,677,2,31,1,1,allow,0,0,Normal
52904,445,0,0,70,70,0,1,0,1,0,drop,0,1,Known Attack
44099,443,28525,443,6235,1562,4673,21,191,12,9,allow,1,0,Potential Threat
49601,53,48706,53,762,97,665,2,30,1,1,allow,0,0,Normal
51155,443,21340,443,54411,4588,49823,74,131,30,44,allow,1,0,Potential Threat
58870,443,45632,443,1411,921,490,12,15,7,5,allow,1,0,Potential Threat
53074,445,0,0,70,70,0,1,0,1,0,drop,0,1,Known Attack
49651,37965,0,0,74,74,0,1,0,1,0,deny,0,1,Known Attack
55443,53,31894,53,751,95,656,2,31,1,1,allow,0,0,Normal
10669,49756,0,0,60,60,0,1,0,1,0,deny,1,1,High Risk
55487,445,0,0,70,70,0,1,0,1,0,drop,0,1,Known Attack
1446,35440,0,0,62,62,0,1,0,1,0,deny,1,1,High Risk
52221,443,62267,443,4567,717,3850,17,148,7,10,allow,1,0,Potential Threat
50443,53,37606,53,788,108,680,2,31,1,1,allow,0,0,Normal
41577,53,15196,53,168,78,90,2,30,1,1,allow,0,0,Normal
49369,53,34405,53,324,86,238,4,47,2,2,allow,0,0,Normal
27005,27013,41883,27013,879,126,753,2,30,1,1,allow,1,0,Potential Threat
56491,56205,0,0,146,146,0,1,0,1,0,deny,1,1,High Risk
51494,445,0,0,66,66,0,1,0,1,0,drop,0,1,Known Attack
54114,443,54114,443,171467,27550,143917,220,85,108,112,allow,1,0,Potential Threat
53648,31637,17348,31637,70,70,0,2,7,2,0,allow,1,0,Potential Threat
16387,56995,0,0,60,60,0,1,0,1,0,deny,1,1,High Risk
56148,445,0,0,70,70,0,1,0,1,0,drop,0,1,Known Attack
58143,445,0,0,66,66,0,1,0,1,0,drop,0,1,Known Attack
50767,57470,0,0,66,66,0,1,0,1,0,deny,0,1,Known Attack
43356,443,48473,443,79561,11513,68048,183,94,95,88,allow,1,0,Potential Threat
10192,25174,0,0,66,66,0,1,0,1,0,deny,0,1,Known Attack
51846,80,21384,80,366,240,126,7,31,5,2,allow,0,0,Normal
62197,22114,0,0,66,66,0,1,0,1,0,deny,0,1,Known Attack
56312,53,11008,53,190,97,93,2,31,1,1,allow,0,0,Normal
56246,80,56246,80,101654,1739,99915,95,15,25,70,allow,1,0,Potential Threat
51641,443,16546,443,7419,2682,4737,26,66,13,13,allow,1,0,Potential Threat
62115,57470,0,0,66,66,0,1,0,1,0,deny,1,1,High Risk
56730,53,51057,53,733,86,647,2,30,1,1,allow,0,0,Normal
58497,445,0,0,66,66,0,1,0,1,0,drop,0,1,Known Attack
63495,50584,0,0,66,66,0,1,0,1,0,deny,1,1,High Risk
35796,443,15213,443,664348,23858,640490,757,119,292,465,allow,1,0,Potential Threat
49418,27017,55350,27017,275,71,204,2,31,1,1,allow,1,0,Potential Threat
46002,443,21932,443,6299,1424,4875,27,291,10,17,allow,1,0,Potential Threat
51648,80,37574,80,974005,25912,948093,1003,32,361,642,allow,1,0,Potential Threat
56048,53,3715,53,296,110,186,2,30,1,1,allow,0,0,Normal
51163,443,48007,443,9466,2602,6864,41,185,20,21,allow,1,0,Potential Threat
50290,53,2460,53,211,110,101,2,30,1,1,allow,0,0,Normal
48589,443,15567,443,15400,9133,6267,40,272,22,18,allow,1,0,Potential Threat
56584,445,0,0,66,66,0,1,0,1,0,drop,0,1,Known Attack
51699,445,0,0,70,70,0,1,0,1,0,drop,0,1,Known Attack
50613,445,0,0,70,70,0,1,0,1,0,drop,0,1,Known Attack
39353,9339,55496,9339,170706,9877,160829,260,46,110,150,allow,1,0,Potential Threat
14252,35993,0,0,62,62,0,1,0,1,0,deny,1,1,High Risk
55842,64147,0,0,66,66,0,1,0,1,0,deny,1,1,High Risk
6355,25174,0,0,146,146,0,1,0,1,0,deny,1,1,High Risk
52513,443,40002,443,5096,810,4286,15,15,8,7,allow,1,0,Potential Threat
57470,24874,7043,24874,132,132,0,3,1199,3,0,allow,1,0,Potential Threat
59942,22114,0,0,62,62,0,1,0,1,0,deny,0,1,Known Attack
43563,443,50861,443,466,392,74,4,0,3,1,allow,0,0,Normal
58885,15000,9072,15000,138,78,60,2,5,1,1,allow,1,0,Potential Threat
11136,15503,0,0,145,145,0,1,0,1,0,deny,1,1,High Risk
55158,53,38311,53,212,102,110,2,30,1,1,allow,0,0,Normal
57416,53,53137,53,193,102,91,2,29,1,1,allow,0,0,Normal
59616,445,0,0,66,66,0,1,0,1,0,drop,0,1,Known Attack
65371,443,38245,443,34653,2523,32130,65,83,26,39,allow,1,0,Potential Threat
26900,27017,53527,27017,254,82,172,4,30,2,2,allow,1,0,Potential Threat
4257,35440,0,0,62,62,0,1,0,1,0,deny,1,1,High Risk
46369,443,62410,443,12157,3583,8574,81,480,34,47,allow,1,0,Potential Threat
51048,445,0,0,70,70,0,1,0,1,0,drop,0,1,Known Attack
55618,56205,0,0,62,62,0,1,0,1,0,deny,0,1,Known Attack
16057,56205,0,0,62,62,0,1,0,1,0,deny,1,1,High Risk
55155,53,1843,53,183,94,89,2,30,1,1,allow,0,0,Normal
51527,445,0,0,70,70,0,1,0,1,0,drop,0,1,Known Attack
53656,31573,0,0,66,66,0,1,0,1,0,deny,0,1,Known Attack
52099,445,0,0,66,66,0,1,0,1,0,drop,0,1,Known Attack
56975,53,16815,53,413,170,243,6,31,3,3,allow,0,0,Normal
55181,53,51083,53,815,95,720,2,31,1,1,allow,0,0,Normal
53276,80,53276,80,42664,1998,40666,53,27,20,33,allow,1,0,Potential Threat
55010,445,0,0,70,70,0,1,0,1,0,drop,0,1,Known Attack
11295,40018,13039,40018,156,94,62,2,30,1,1,allow,1,0,Potential Threat
65505,53,17210,53,166,86,80,2,29,1,1,allow,0,0,Normal
33688,80,62587,80,1638,1324,314,10,16,5,5,allow,1,0,Potential Threat
36738,123,0,0,234,234,0,1,0,1,0,deny,0,1,Known Attack
52079,445,0,0,70,70,0,1,0,1,0,drop,0,1,Known Attack
45237,53,45237,53,235,90,145,2,33,1,1,allow,0,0,Normal
38947,443,49748,443,16499,9522,6977,44,364,22,22,allow,1,0,Potential Threat
49646,443,27491,443,12279,4202,8077,33,43,16,17,allow,1,0,Potential Threat
51594,443,50600,443,5854,1148,4706,18,23,10,8,allow,1,0,Potential Threat
49209,53,48140,53,199,102,97,2,31,1,1,allow,0,0,Normal
55689,37965,0,0,66,66,0,1,0,1,0,deny,0,1,Known Attack
0,0,0,0,98,98,0,1,0,1,0,deny,1,1,High Risk
59586,57470,0,0,66,66,0,1,0,1,0,deny,1,1,High Risk
59524,445,0,0,70,70,0,1,0,1,0,drop,0,1,Known Attack
60481,445,0,0,70,70,0,1,0,1,0,drop,0,1,Known Attack
57172,53,27478,53,196,102,94,2,31,1,1,allow,0,0,Normal
57367,53,62826,53,170,87,83,2,30,1,1,allow,1,0,Potential Threat
53914,44209,7956,44209,1729,985,744,16,16,9,7,allow,1,0,Potential Threat
55078,80,14305,80,265275,25834,239441,366,101,182,184,allow,1,0,Potential Threat
50052,65010,0,0,60,60,0,1,0,1,0,deny,1,1,High Risk
49478,53,25544,53,172,94,78,2,30,1,1,allow,0,0,Normal
49667,53,34670,53,183,94,89,2,29,1,1,allow,0,0,Normal
50583,53,45479,53,196,102,94,2,30,1,1,allow,0,0,Normal
41232,443,32307,443,1807,1048,759,16,25,8,8,allow,1,0,Potential Threat
35671,443,43722,443,6824,1142,5682,24,134,13,11,allow,1,0,Potential Threat
46108,48817,0,0,145,145,0,1,0,1,0,deny,1,1,High Risk
56637,53,46210,53,199,102,97,2,30,1,1,allow,0,0,Normal
3478,61463,0,0,431,431,0,1,0,1,0,deny,1,1,High Risk
15854,50584,0,0,146,146,0,1,0,1,0,deny,1,1,High Risk
49976,53,5693,53,393,110,283,2,30,1,1,allow,0,0,Normal
55199,443,3846,443,18132,8636,9496,40,176,23,17,allow,1,0,Potential Threat
49978,53,54478,53,760,97,663,2,31,1,1,allow,0,0,Normal
33849,53,34954,53,336,231,105,3,30,2,1,allow,0,0,Normal
57727,443,62460,443,54944,4374,50570,88,361,44,44,allow,1,0,Potential Threat
50641,443,27533,443,1473,890,583,13,140,7,6,allow,1,0,Potential Threat
52277,445,0,0,70,70,0,1,0,1,0,drop,0,1,Known Attack
50996,443,60752,443,12654,1719,10935,28,21,15,13,allow,1,0,Potential Threat
56805,443,33799,443,8022,2002,6020,20,15,11,9,allow,1,0,Potential Threat
56357,53,34112,53,178,94,84,2,30,1,1,allow,0,0,Normal
56624,80,12583,80,234,234,0,4,12,4,0,allow,0,0,Normal
58006,443,30394,443,9596,1688,7908,26,255,13,13,allow,1,0,Potential Threat
50494,443,62791,443,5331564,43954,5287610,4171,80,672,3499,allow,1,0,Potential Threat
56613,53,57106,53,307,134,173,2,30,1,1,allow,0,0,Normal
52083,26607,11051,26607,70,70,0,2,7,2,0,allow,1,0,Potential Threat
47357,50584,0,0,66,66,0,1,0,1,0,deny,0,1,Known Attack
55405,53,37369,53,199,102,97,2,30,1,1,allow,0,0,Normal
47582,443,49001,443,6214,1733,4481,13,120,6,7,allow,1,0,Potential Threat
11136,15503,0,0,145,145,0,1,0,1,0,deny,1,1,High Risk
51777,63497,24893,63497,316,136,180,6,6,3,3,allow,1,0,Potential Threat
59830,443,59830,443,21205,1711,19494,32,1806,11,21,allow,1,0,Potential Threat
53448,445,0,0,66,66,0,1,0,1,0,drop,0,1,Known Attack
49797,445,0,0,66,66,0,1,0,1,0,drop,0,1,Known Attack
62105,445,0,0,70,70,0,1,0,1,0,drop,0,1,Known Attack
18011,44847,0,0,66,66,0,1,0,1,0,deny,1,1,High Risk
58992,445,0,0,70,70,0,1,0,1,0,drop,0,1,Known Attack
54904,445,0,0,70,70,0,1,0,1,0,drop,0,1,Known Attack
40260,44610,0,0,145,145,0,1,0,1,0,deny,1,1,High Risk
39038,443,14810,443,3970,2230,1740,17,114,10,7,allow,1,0,Potential Threat
32090,43890,0,0,146,146,0,1,0,1,0,deny,1,1,High Risk
54520,443,49982,443,8152,4874,3278,22,138,11,11,allow,1,0,Potential Threat
63921,445,0,0,70,70,0,1,0,1,0,drop,0,1,Known Attack
65472,53,45041,53,209,110,99,2,30,1,1,allow,0,0,Normal
7000,23117,0,0,62,62,0,1,0,1,0,deny,1,1,High Risk
46999,993,56009,993,45153,20621,24532,323,43,165,158,allow,1,0,Potential Threat
58993,443,16211,443,1437,736,701,15,28,7,8,allow,1,0,Potential Threat
42019,443,22698,443,21620,7973,13647,112,488,57,55,allow,1,0,Potential Threat
61919,445,0,0,70,70,0,1,0,1,0,drop,0,1,Known Attack
62208,37965,0,0,66,66,0,1,0,1,0,deny,0,1,Known Attack
53512,23280,49318,23280,1950,957,993,17,17,10,7,allow,1,0,Potential Threat
65373,443,38852,443,3104883,106687,2998196,3406,190,1320,2086,allow,1,0,Potential Threat
56665,53,16180,53,216,102,114,2,30,1,1,allow,0,0,Normal
65264,53,51558,53,198,94,104,2,29,1,1,allow,0,0,Normal
56956,53,28771,53,182,93,89,2,30,1,1,allow,0,0,Normal
45533,80,45533,80,52365,3013,49352,53,51,13,40,allow,1,0,Potential Threat
58638,5900,0,0,62,62,0,1,0,1,0,deny,0,1,Known Attack
40994,443,58076,443,1396,735,661,14,80,8,6,allow,1,0,Potential Threat
50474,443,49167,443,17449456,390704,17058752,16816,383,4917,11899,allow,1,0,Potential Threat
5222,48709,0,0,66,66,0,1,0,1,0,deny,1,1,High Risk
59936,443,30573,443,10879,3057,7822,38,32,21,17,allow,1,0,Potential Threat
49718,53,42238,53,807,94,713,2,30,1,1,allow,0,0,Normal
51584,445,0,0,70,70,0,1,0,1,0,drop,0,1,Known Attack
49405,53,14474,53,94,94,0,1,30,1,0,allow,0,0,Normal
52255,445,0,0,66,66,0,1,0,1,0,drop,0,1,Known Attack
47910,7454,0,0,60,60,0,1,0,1,0,deny,0,1,Known Attack
56966,53,53823,53,177,94,83,2,30,1,1,allow,0,0,Normal
30960,45714,65388,45714,330,330,0,6,3609,6,0,allow,1,0,Potential Threat
12087,59033,0,0,148,148,0,1,0,1,0,deny,1,1,High Risk
64711,53,31035,53,273,118,155,2,30,1,1,allow,0,0,Normal
57781,445,0,0,70,70,0,1,0,1,0,drop,0,1,Known Attack
64045,7426,33466,7426,70,70,0,1,4,1,0,allow,1,0,Potential Threat
55129,445,0,0,70,70,0,1,0,1,0,drop,0,1,Known Attack
64346,51505,0,0,66,66,0,1,0,1,0,deny,1,1,High Risk
48817,1049,48817,1049,334,158,176,2,1199,1,1,allow,1,0,Potential Threat
64871,445,0,0,70,70,0,1,0,1,0,drop,0,1,Known Attack
59044,445,0,0,70,70,0,1,0,1,0,drop,0,1,Known Attack
55810,53,11576,53,183,94,89,2,29,1,1,allow,0,0,Normal
24504,37965,0,0,62,62,0,1,0,1,0,deny,0,1,Known Attack
56964,53,13707,53,267,87,180,4,57,2,2,allow,0,0,Normal
37052,53,37052,53,259,104,155,2,30,1,1,allow,0,0,Normal
52410,8604,0,0,66,66,0,1,0,1,0,deny,0,1,Known Attack
58900,443,22833,443,8547,5209,3338,30,19,15,15,allow,1,0,Potential Threat
51743,64147,0,0,62,62,0,1,0,1,0,deny,1,1,High Risk
50509,80,1536,80,49872,11098,38774,65,24,27,38,allow,1,0,Potential Threat
51569,445,0,0,70,70,0,1,0,1,0,drop,0,1,Known Attack
59787,445,0,0,70,70,0,1,0,1,0,drop,0,1,Known Attack
61099,443,1871,443,82,82,0,1,5,1,0,allow,0,0,Normal
52139,445,0,0,66,66,0,1,0,1,0,drop,0,1,Known Attack
51172,44847,0,0,66,66,0,1,0,1,0,deny,0,1,Known Attack
54431,443,24894,443,9398,2027,7371,33,270,14,19,allow,1,0,Potential Threat
27005,27016,9591,27016,884,126,758,2,30,1,1,allow,1,0,Potential Threat
61764,445,0,0,70,70,0,1,0,1,0,drop,0,1,Known Attack
6057,51221,0,0,62,62,0,1,0,1,0,deny,1,1,High Risk
55631,16191,24420,16191,504,318,186,8,16,5,3,allow,1,0,Potential Threat
56152,56205,0,0,66,66,0,1,0,1,0,deny,0,1,Known Attack
56815,50510,55664,50510,70,70,0,1,5,1,0,allow,1,0,Potential Threat
61861,445,0,0,70,70,0,1,0,1,0,drop,0,1,Known Attack
57541,445,0,0,66,66,0,1,0,1,0,drop,0,1,Known Attack
43333,50584,0,0,146,146,0,1,0,1,0,deny,1,1,High Risk
61416,80,26249,80,2366,764,1602,10,137,5,5,allow,1,0,Potential Threat
50178,445,0,0,70,70,0,1,0,1,0,drop,0,1,Known Attack
49773,80,31365,80,70,70,0,1,5,1,0,allow,0,0,Normal
64607,53,58592,53,211,110,101,2,31,1,1,allow,0,0,Normal
22390,19473,0,0,66,66,0,1,0,1,0,deny,0,1,Known Attack
57602,80,57602,80,4226,2910,1316,19,38,10,9,allow,1,0,Potential Threat
57082,53,9901,53,239,94,145,2,30,1,1,allow,0,0,Normal
37602,53,37602,53,260,106,154,2,32,1,1,allow,0,0,Normal
57322,53,59513,53,196,102,94,2,30,1,1,allow,0,0,Normal
56678,53,49059,53,240,110,130,2,30,1,1,allow,0,0,Normal
46218,23,0,0,60,60,0,1,0,1,0,deny,0,1,Known Attack
49840,443,58601,443,6998,1906,5092,22,24,12,10,allow,1,0,Potential Threat
64010,445,0,0,70,70,0,1,0,1,0,drop,0,1,Known Attack
50038,53,46782,53,177,94,83,2,31,1,1,allow,0,0,Normal
56743,445,0,0,70,70,0,1,0,1,0,drop,0,1,Known Attack
53828,51354,58095,51354,70,70,0,1,4,1,0,allow,1,0,Potential Threat
55651,53,17505,53,199,102,97,2,30,1,1,allow,0,0,Normal
50602,53,48380,53,761,100,661,2,30,1,1,allow,0,0,Normal
56684,443,25036,443,8737,1821,6916,23,23,14,9,allow,1,0,Potential Threat
52303,445,0,0,70,70,0,1,0,1,0,drop,0,1,Known Attack
9055,443,33529,443,6594797,175738,6419059,6398,123,1755,4643,allow,1,0,Potential Threat
58372,445,0,0,70,70,0,1,0,1,0,drop,0,1,Known Attack
59948,22114,0,0,146,146,0,1,0,1,0,deny,1,1,High Risk
65294,53,37568,53,168,86,82,2,30,1,1,allow,0,0,Normal
55325,53,11184,53,210,110,100,2,31,1,1,allow,0,0,Normal
53498,445,0,0,66,66,0,1,0,1,0,drop,0,1,Known Attack
9518,3855,0,0,100,100,0,1,0,1,0,deny,0,1,Known Attack
50575,53,21343,53,184,94,90,2,30,1,1,allow,0,0,Normal
58074,443,57514,443,2974,408,2566,13,135,6,7,allow,1,0,Potential Threat
58724,43890,0,0,66,66,0,1,0,1,0,deny,0,1,Known Attack
39251,53,9429,53,198,93,105,2,30,1,1,allow,0,0,Normal
62664,445,0,0,70,70,0,1,0,1,0,drop,0,1,Known Attack
57139,443,39822,443,2162,1317,845,16,25,9,7,allow,1,0,Potential Threat
13188,35440,0,0,66,66,0,1,0,1,0,deny,1,1,High Risk
50734,443,16701,443,1726,668,1058,13,2033,4,9,allow,1,0,Potential Threat
49882,443,5946,443,5019,1424,3595,15,87,9,6,allow,1,0,Potential Threat
31675,19473,0,0,62,62,0,1,0,1,0,deny,0,1,Known Attack
58976,43890,0,0,66,66,0,1,0,1,0,deny,0,1,Known Attack
50298,445,0,0,70,70,0,1,0,1,0,drop,0,1,Known Attack
61876,443,60944,443,3776,1446,2330,20,153,9,11,allow,1,0,Potential Threat
37570,443,49846,443,499,425,74,4,0,3,1,allow,1,0,Potential Threat
58715,64097,0,0,62,62,0,1,0,1,0,deny,1,1,High Risk
6881,6881,40398,6881,238,118,120,2,1199,1,1,allow,1,0,Potential Threat
57346,443,34868,443,1547,960,587,14,22,8,6,allow,0,0,Normal
64144,445,0,0,66,66,0,1,0,1,0,drop,0,1,Known Attack
61455,443,28409,443,8947,1130,7817,28,124,13,15,allow,1,0,Potential Threat
51399,443,28295,443,642,582,60,2,5,1,1,allow,0,0,Normal
3911,50584,0,0,62,62,0,1,0,1,0,deny,1,1,High Risk
37614,53,37614,53,209,98,111,2,30,1,1,allow,0,0,Normal
49692,53,65365,53,212,110,102,2,30,1,1,allow,1,0,Potential Threat
51715,443,35378,443,4175264,89546,4085718,4141,532,1111,3030,allow,1,0,Potential Threat
60018,64147,0,0,62,62,0,1,0,1,0,deny,1,1,High Risk
64987,445,0,0,70,70,0,1,0,1,0,drop,0,1,Known Attack
53179,445,0,0,66,66,0,1,0,1,0,drop,0,1,Known Attack
64124,80,34060,80,1517,481,1036,11,15,6,5,allow,1,0,Potential Threat
58446,443,26245,443,111535,9830,101705,141,192,62,79,allow,1,0,Potential Threat
12573,53,12573,53,235,90,145,2,32,1,1,allow,0,0,Normal
55539,57470,0,0,66,66,0,1,0,1,0,deny,0,1,Known Attack
60793,40010,33213,40010,316,136,180,6,6,3,3,allow,1,0,Potential Threat
27153,992,0,0,60,60,0,1,0,1,0,deny,0,1,Known Attack
50773,445,0,0,70,70,0,1,0,1,0,drop,0,1,Known Attack
64867,53,35181,53,184,86,98,2,30,1,1,allow,0,0,Normal
64836,53,53586,53,241,94,147,2,30,1,1,allow,0,0,Normal
62900,445,0,0,70,70,0,1,0,1,0,drop,0,1,Known Attack
50547,53,5293,53,210,110,100,2,30,1,1,allow,0,0,Normal
59119,445,0,0,70,70,0,1,0,1,0,drop,0,1,Known Attack
56733,443,4067,443,7941,1952,5989,20,15,11,9,allow,1,0,Potential Threat
40367,80,26121,80,2119,808,1311,12,16,7,5,allow,1,0,Potential Threat
65377,445,0,0,66,66,0,1,0,1,0,drop,0,1,Known Attack
64903,51050,0,0,66,66,0,1,0,1,0,deny,1,1,High Risk
1025,35447,0,0,62,62,0,1,0,1,0,deny,1,1,High Risk
53761,443,39818,443,499,425,74,4,0,3,1,allow,0,0,Normal
51525,35440,0,0,66,66,0,1,0,1,0,deny,0,1,Known Attack
59373,445,0,0,70,70,0,1,0,1,0,drop,0,1,Known Attack
57470,8621,39581,8621,469,150,319,2,1199,1,1,allow,1,0,Potential Threat
36339,50584,0,0,146,146,0,1,0,1,0,deny,1,1,High Risk
31675,19473,0,0,62,62,0,1,0,1,0,deny,0,1,Known Attack
37875,55108,0,0,148,148,0,1,0,1,0,deny,1,1,High Risk
65005,53,27346,53,776,102,674,2,30,1,1,allow,0,0,Normal
443,48346,0,0,81,81,0,1,0,1,0,deny,1,1,High Risk
49537,53,46669,53,269,96,173,4,59,2,2,allow,0,0,Normal
64847,22114,0,0,66,66,0,1,0,1,0,deny,0,1,Known Attack
50441,445,0,0,66,66,0,1,0,1,0,drop,0,1,Known Attack
50544,445,0,0,70,70,0,1,0,1,0,drop,0,1,Known Attack
52454,80,19961,80,2425,529,1896,11,75,6,5,allow,1,0,Potential Threat
3478,61463,0,0,627,627,0,1,0,1,0,deny,1,1,High Risk
53575,445,0,0,66,66,0,1,0,1,0,drop,0,1,Known Attack
49844,53,1140,53,762,98,664,2,31,1,1,allow,0,0,Normal
27005,27013,28763,27013,1628,126,1502,4,31,2,2,allow,1,0,Potential Threat
64808,27098,0,0,66,66,0,1,0,1,0,deny,0,1,Known Attack
27005,27240,14670,27240,868,126,742,2,31,1,1,allow,1,0,Potential Threat
5617,64147,0,0,145,145,0,1,0,1,0,deny,1,1,High Risk
32609,64097,0,0,62,62,0,1,0,1,0,deny,1,1,High Risk
55038,443,25937,443,11429,4904,6525,33,156,18,15,allow,1,0,Potential Threat
60224,445,0,0,66,66,0,1,0,1,0,drop,0,1,Known Attack
48706,23393,0,0,60,60,0,1,0,1,0,deny,0,1,Known Attack
48706,23393,0,0,60,60,0,1,0,1,0,deny,0,1,Known Attack
49216,53,14364,53,181,94,87,2,30,1,1,allow,0,0,Normal
65526,28793,0,0,62,62,0,1,0,1,0,deny,0,1,Known Attack
58320,53,15987,53,331,86,245,2,30,1,1,allow,0,0,Normal
55286,53,22334,53,194,102,92,2,31,1,1,allow,0,0,Normal
55258,53,4040,53,177,94,83,2,30,1,1,allow,0,0,Normal
59016,443,23931,443,12676,4222,8454,36,87,20,16,allow,1,0,Potential Threat
56381,51505,0,0,62,62,0,1,0,1,0,deny,0,1,Known Attack
64769,53,55242,53,418,150,268,2,30,1,1,allow,0,0,Normal
65189,27207,3306,27207,230,78,152,2,30,1,1,allow,1,0,Potential Threat
43076,23,0,0,60,60,0,1,0,1,0,deny,0,1,Known Attack
33084,443,45325,443,15474,4188,11286,14,139,4,10,allow,1,0,Potential Threat
61510,37965,0,0,66,66,0,1,0,1,0,deny,0,1,Known Attack
49308,53,0,0,627,80,547,2,29,1,1,allow,0,0,Normal
33416,23,0,0,60,60,0,1,0,1,0,deny,0,1,Known Attack
61185,54532,0,0,62,62,0,1,0,1,0,deny,1,1,High Risk
60048,445,0,0,70,70,0,1,0,1,0,drop,0,1,Known Attack
37601,443,50258,443,573,425,148,5,0,3,2,allow,1,0,Potential Threat
64966,53,51667,53,458,188,270,6,31,3,3,allow,1,0,Potential Threat
34715,443,46649,443,584,370,214,9,26,6,3,allow,1,0,Potential Threat
51876,443,3089,443,1852,1103,749,16,32,9,7,allow,1,0,Potential Threat
56281,443,8565,443,22352,9825,12527,111,370,55,56,allow,1,0,Potential Threat
58638,5900,0,0,62,62,0,1,0,1,0,deny,0,1,Known Attack
52221,53,10859,53,177,86,91,2,30,1,1,allow,0,0,Normal
34997,22,0,0,60,60,0,1,0,1,0,deny,0,1,Known Attack
53429,445,0,0,70,70,0,1,0,1,0,drop,0,1,Known Attack
44924,53,44924,53,235,90,145,2,32,1,1,allow,0,0,Normal
56172,53,39320,53,216,102,114,2,30,1,1,allow,0,0,Normal
27005,30008,37635,30008,881,126,755,2,30,1,1,allow,1,0,Potential Threat
34211,23,0,0,60,60,0,1,0,1,0,deny,0,1,Known Attack
62812,445,0,0,70,70,0,1,0,1,0,drop,0,1,Known Attack
63033,445,0,0,70,70,0,1,0,1,0,drop,0,1,Known Attack
51759,55308,58744,55308,70,70,0,2,8,2,0,allow,1,0,Potential Threat
40600,53,40600,53,228,90,138,2,30,1,1,allow,0,0,Normal
63360,445,0,0,70,70,0,1,0,1,0,drop,0,1,Known Attack
34355,80,5779,80,416,210,206,7,15,4,3,allow,1,0,Potential Threat
63633,445,0,0,70,70,0,1,0,1,0,drop,0,1,Known Attack
56352,445,0,0,70,70,0,1,0,1,0,drop,0,1,Known Attack
58113,445,0,0,70,70,0,1,0,1,0,drop,0,1,Known Attack
62039,443,46235,443,356,60,296,6,18,2,4,allow,0,0,Normal
52012,445,0,0,70,70,0,1,0,1,0,drop,0,1,Known Attack
13285,29892,0,0,145,145,0,1,0,1,0,deny,1,1,High Risk
64929,53,46254,53,168,86,82,2,31,1,1,allow,0,0,Normal
55452,445,0,0,70,70,0,1,0,1,0,drop,0,1,Known Attack
60496,56871,22838,56871,504,318,186,8,15,5,3,allow,1,0,Potential Threat
60874,443,2065,443,777438,37182,740256,940,64,407,533,allow,1,0,Potential Threat
33305,54532,0,0,60,60,0,1,0,1,0,deny,1,1,High Risk
55265,53,44071,53,199,102,97,2,30,1,1,allow,0,0,Normal
7222,57470,0,0,62,62,0,1,0,1,0,deny,1,1,High Risk
42023,443,45040,443,42402,3988,38414,82,89,39,43,allow,1,0,Potential Threat
50052,65008,0,0,60,60,0,1,0,1,0,deny,1,1,High Risk
46495,4607,0,0,60,60,0,1,0,1,0,deny,0,1,Known Attack
50585,80,63970,80,1726,963,763,13,80,7,6,allow,1,0,Potential Threat
55921,53,12219,53,747,92,655,2,31,1,1,allow,0,0,Normal
49609,80,50781,80,318,192,126,6,41,4,2,allow,0,0,Normal
57807,443,2939,443,9783,5855,3928,22,122,11,11,allow,1,0,Potential Threat
57296,53,58059,53,200,102,98,2,29,1,1,allow,0,0,Normal
49711,14984,0,0,66,66,0,1,0,1,0,deny,0,1,Known Attack
51239,443,46781,443,9649,4615,5034,42,16,24,18,allow,1,0,Potential Threat
60989,443,62484,443,3182,1568,1614,8,120,4,4,allow,1,0,Potential Threat
57433,21247,0,0,66,66,0,1,0,1,0,deny,0,1,Known Attack
55559,53,14649,53,1026,292,734,8,50,4,4,allow,0,0,Normal
12465,11392,0,0,62,62,0,1,0,1,0,deny,0,1,Known Attack
61150,445,0,0,66,66,0,1,0,1,0,drop,0,1,Known Attack
9431,443,45231,443,8693,2545,6148,26,34,13,13,allow,1,0,Potential Threat
27005,27020,41783,27020,898,126,772,2,30,1,1,allow,1,0,Potential Threat
54990,53,46533,53,166,86,80,2,31,1,1,allow,0,0,Normal
47947,80,61494,80,2917,870,2047,14,16,8,6,allow,1,0,Potential Threat
56413,51221,0,0,62,62,0,1,0,1,0,deny,0,1,Known Attack
34416,443,60300,443,10255,2803,7452,35,26,18,17,allow,1,0,Potential Threat
51602,443,19989,443,19664,8943,10721,42,37,22,20,allow,1,0,Potential Threat
62673,34159,0,0,66,66,0,1,0,1,0,deny,0,1,Known Attack
29742,50584,0,0,62,62,0,1,0,1,0,deny,1,1,High Risk
1024,26296,0,0,159,159,0,1,0,1,0,deny,1,1,High Risk
49418,27015,37107,27015,223,71,152,2,31,1,1,allow,1,0,Potential Threat
60710,445,0,0,66,66,0,1,0,1,0,drop,0,1,Known Attack
53771,64351,48425,64351,70,70,0,1,5,1,0,allow,1,0,Potential Threat
56066,445,0,0,66,66,0,1,0,1,0,drop,0,1,Known Attack
53985,30188,0,0,66,66,0,1,0,1,0,deny,0,1,Known Attack
50577,53,42323,53,819,102,717,2,30,1,1,allow,0,0,Normal
64765,53,64580,53,177,94,83,2,30,1,1,allow,1,0,Potential Threat
51834,445,0,0,66,66,0,1,0,1,0,drop,0,1,Known Attack
61591,80,1732,80,124,64,60,2,16,1,1,allow,0,0,Normal
34873,80,34873,80,2148,918,1230,10,20,6,4,allow,1,0,Potential Threat
28014,443,49655,443,6435,1089,5346,18,75,9,9,allow,1,0,Potential Threat
55188,445,0,0,66,66,0,1,0,1,0,drop,0,1,Known Attack
50375,53,45862,53,211,110,101,2,30,1,1,allow,0,0,Normal
47102,123,23383,123,184,94,90,2,30,1,1,allow,0,0,Normal
56765,53,52447,53,194,102,92,2,30,1,1,allow,0,0,Normal
53530,8999,1234,8999,70,70,0,1,5,1,0,allow,1,0,Potential Threat
64741,53,9431,53,715,94,621,2,29,1,1,allow,0,0,Normal
56686,443,39990,443,7941,1952,5989,20,16,11,9,allow,1,0,Potential Threat
55619,445,0,0,70,70,0,1,0,1,0,drop,0,1,Known Attack
53135,14297,19034,14297,70,70,0,2,8,2,0,allow,1,0,Potential Threat
57648,443,58910,443,35696,3196,32500,48,121,19,29,allow,1,0,Potential Threat
49777,445,0,0,66,66,0,1,0,1,0,drop,0,1,Known Attack
57837,64147,0,0,66,66,0,1,0,1,0,deny,1,1,High Risk
55497,53,23337,53,184,102,82,2,29,1,1,allow,0,0,Normal
50257,53,50801,53,199,102,97,2,29,1,1,allow,0,0,Normal
60587,445,0,0,70,70,0,1,0,1,0,drop,0,1,Known Attack
55495,53,27673,53,210,110,100,2,30,1,1,allow,0,0,Normal
64923,25174,0,0,66,66,0,1,0,1,0,deny,0,1,Known Attack
51885,64546,64002,64546,70,70,0,2,8,2,0,allow,1,0,Potential Threat
55273,53,3281,53,764,99,665,2,31,1,1,allow,0,0,Normal
60891,445,0,0,66,66,0,1,0,1,0,drop,0,1,Known Attack
59645,53,23128,53,263,94,169,2,30,1,1,allow,0,0,Normal
58181,445,0,0,66,66,0,1,0,1,0,drop,0,1,Known Attack
56274,53,38501,53,177,94,83,2,30,1,1,allow,0,0,Normal
65273,53,64303,53,226,102,124,2,30,1,1,allow,1,0,Potential Threat
49730,445,0,0,70,70,0,1,0,1,0,drop,0,1,Known Attack
60563,445,0,0,70,70,0,1,0,1,0,drop,0,1,Known Attack
55853,53,55965,53,197,102,95,2,30,1,1,allow,0,0,Normal
49648,80,25450,80,318,192,126,6,41,4,2,allow,0,0,Normal
58263,5223,22492,5223,3721,1173,2548,18,20,11,7,allow,1,0,Potential Threat
55842,80,22065,80,1151,711,440,10,15,5,5,allow,0,0,Normal
38892,443,57044,443,83444,15305,68139,121,148,51,70,allow,1,0,Potential Threat
56698,443,19362,443,106055,8460,97595,168,26,79,89,allow,1,0,Potential Threat
53744,443,46972,443,499,425,74,4,0,3,1,allow,0,0,Normal
64985,27037,29129,27037,734,462,272,2,30,1,1,allow,1,0,Potential Threat
55264,53,44429,53,177,94,83,2,30,1,1,allow,0,0,Normal
4781,443,51838,443,1191,692,499,12,40,7,5,allow,1,0,Potential Threat
64124,443,56676,443,1411,852,559,13,25,7,6,allow,1,0,Potential Threat
32900,443,53581,443,14739,1296,13443,30,306,9,21,allow,1,0,Potential Threat
52668,51221,0,0,66,66,0,1,0,1,0,deny,0,1,Known Attack
35268,81,0,0,60,60,0,1,0,1,0,deny,0,1,Known Attack
57334,53,43556,53,210,110,100,2,30,1,1,allow,0,0,Normal
55704,53,24414,53,170,87,83,2,30,1,1,allow,0,0,Normal
56462,37965,0,0,62,62,0,1,0,1,0,deny,0,1,Known Attack
52095,443,20736,443,325846,10609,315237,326,38,106,220,allow,1,0,Potential Threat
60186,445,0,0,70,70,0,1,0,1,0,drop,0,1,Known Attack
43584,24748,0,0,156,156,0,1,0,1,0,deny,1,1,High Risk
49159,53,33263,53,733,86,647,2,31,1,1,allow,0,0,Normal
62568,445,0,0,70,70,0,1,0,1,0,drop,0,1,Known Attack
54926,445,0,0,66,66,0,1,0,1,0,drop,0,1,Known Attack
63813,53455,10491,53455,70,70,0,1,5,1,0,allow,1,0,Potential Threat
46518,44847,0,0,146,146,0,1,0,1,0,deny,1,1,High Risk
49446,53,1735,53,403,142,261,2,30,1,1,allow,0,0,Normal
54666,36237,0,0,66,66,0,1,0,1,0,deny,0,1,Known Attack
43235,23,0,0,60,60,0,1,0,1,0,deny,0,1,Known Attack
60093,443,46965,443,2090,1218,872,15,140,8,7,allow,1,0,Potential Threat
50293,53,25447,53,740,93,647,2,31,1,1,allow,0,0,Normal
57054,53,38199,53,164,78,86,2,30,1,1,allow,0,0,Normal
49552,53,59587,53,188,96,92,2,30,1,1,allow,0,0,Normal
10166,80,10166,80,450,246,204,8,24,5,3,allow,1,0,Potential Threat
63567,445,0,0,70,70,0,1,0,1,0,drop,0,1,Known Attack
56636,53,8907,53,168,86,82,2,30,1,1,allow,0,0,Normal
52184,57262,17429,57262,66,66,0,1,5,1,0,allow,1,0,Potential Threat
57107,64147,0,0,66,66,0,1,0,1,0,deny,1,1,High Risk
44032,161,0,0,4491,2143,2348,24,30,12,12,allow,1,0,Potential Threat
56658,53,26187,53,193,102,91,2,30,1,1,allow,0,0,Normal
9244,80,12299,80,318,192,126,6,26,4,2,allow,1,0,Potential Threat
43056,11119,0,0,146,146,0,1,0,1,0,deny,0,1,Known Attack
42478,80,42478,80,1913,1464,449,10,19,6,4,allow,1,0,Potential Threat
60411,80,48309,80,1589,941,648,11,121,6,5,allow,1,0,Potential Threat
35120,26467,0,0,62,62,0,1,0,1,0,deny,0,1,Known Attack
65143,53,4098,53,184,94,90,2,31,1,1,allow,0,0,Normal
62109,445,0,0,66,66,0,1,0,1,0,drop,0,1,Known Attack
46398,443,65303,443,12982,7168,5814,50,165,23,27,allow,1,0,Potential Threat
62242,44512,0,0,66,66,0,1,0,1,0,deny,0,1,Known Attack
50620,443,5914,443,1277,851,426,12,92,7,5,allow,1,0,Potential Threat
57054,80,1820,80,25138,16043,9095,79,2410,53,26,allow,1,0,Potential Threat
58276,43890,0,0,66,66,0,1,0,1,0,deny,0,1,Known Attack
49514,443,49514,443,234110,36300,197810,309,66,160,149,allow,1,0,Potential Threat
55221,443,37010,443,12954,2333,10621,20,120,9,11,allow,1,0,Potential Threat
65326,445,0,0,66,66,0,1,0,1,0,drop,0,1,Known Attack
50391,80,25680,80,2837,582,2255,12,17,7,5,allow,0,0,Normal
49750,443,8728,443,7370,1474,5896,19,128,10,9,allow,1,0,Potential Threat
60748,445,0,0,66,66,0,1,0,1,0,drop,0,1,Known Attack
55548,53,2209,53,197,102,95,2,29,1,1,allow,0,0,Normal
35849,30188,0,0,62,62,0,1,0,1,0,deny,0,1,Known Attack
64149,53,35596,53,301,108,193,4,50,2,2,allow,0,0,Normal
51432,443,60618,443,194,70,124,3,11,1,2,allow,0,0,Normal
55320,22114,0,0,146,146,0,1,0,1,0,deny,1,1,High Risk
65451,53,45725,53,178,94,84,2,30,1,1,allow,0,0,Normal
52088,35605,28933,35605,70,70,0,2,8,2,0,allow,1,0,Potential Threat
51325,445,0,0,70,70,0,1,0,1,0,drop,0,1,Known Attack
65028,53,41163,53,265,94,171,2,30,1,1,allow,0,0,Normal
52014,80,24294,80,30427,2131,28296,66,32,25,41,allow,1,0,Potential Threat
37965,25180,40858,25180,858,858,0,14,1199,14,0,allow,1,0,Potential Threat
52107,53,0,0,621,77,544,2,29,1,1,allow,0,0,Normal
55933,445,0,0,66,66,0,1,0,1,0,drop,0,1,Known Attack
49886,53,51424,53,311,102,209,2,30,1,1,allow,0,0,Normal
62415,57470,0,0,66,66,0,1,0,1,0,deny,1,1,High Risk
60390,56494,54167,56494,70,70,0,1,5,1,0,allow,1,0,Potential Threat
5938,49414,0,0,60,60,0,1,90,1,0,allow,1,0,Potential Threat
49893,25174,0,0,66,66,0,1,0,1,0,deny,0,1,Known Attack
49750,445,0,0,70,70,0,1,0,1,0,drop,0,1,Known Attack
49910,445,0,0,70,70,0,1,0,1,0,drop,0,1,Known Attack
58638,5900,0,0,62,62,0,1,0,1,0,deny,0,1,Known Attack
50710,445,0,0,70,70,0,1,0,1,0,drop,0,1,Known Attack
60226,445,0,0,66,66,0,1,0,1,0,drop,0,1,Known Attack
56328,36237,0,0,66,66,0,1,0,1,0,deny,0,1,Known Attack
65172,53,25157,53,306,110,196,2,30,1,1,allow,0,0,Normal
50564,443,39683,443,8182,1488,6694,23,133,13,10,allow,1,0,Potential Threat
17002,22114,0,0,62,62,0,1,0,1,0,deny,0,1,Known Attack
10381,22114,0,0,62,62,0,1,0,1,0,deny,0,1,Known Attack
52650,36237,0,0,62,62,0,1,0,1,0,deny,0,1,Known Attack
58638,5900,0,0,62,62,0,1,0,1,0,deny,0,1,Known Attack
61114,445,0,0,70,70,0,1,0,1,0,drop,0,1,Known Attack
62392,15503,0,0,146,146,0,1,0,1,0,deny,1,1,High Risk
34932,38608,0,0,62,62,0,1,0,1,0,deny,0,1,Known Attack
63607,53,63607,53,643,88,555,2,30,1,1,allow,1,0,Potential Threat
48756,80,48756,80,560,264,296,9,44,5,4,allow,0,0,Normal
53264,443,4162,443,41321,1491,39830,52,41,15,37,allow,1,0,Potential Threat
49568,53,17593,53,214,102,112,2,30,1,1,allow,0,0,Normal
65005,53,2818,53,239,94,145,2,30,1,1,allow,0,0,Normal
55724,445,0,0,70,70,0,1,0,1,0,drop,0,1,Known Attack
52212,445,0,0,66,66,0,1,0,1,0,drop,0,1,Known Attack
56392,445,0,0,66,66,0,1,0,1,0,drop,0,1,Known Attack
56086,445,0,0,70,70,0,1,0,1,0,drop,0,1,Known Attack
58049,445,0,0,70,70,0,1,0,1,0,drop,0,1,Known Attack
56834,53,36228,53,172,88,84,2,30,1,1,allow,0,0,Normal
22274,53,9607,53,278,78,200,2,30,1,1,allow,0,0,Normal
37624,443,54201,443,471102,14016,457086,503,25,191,312,allow,1,0,Potential Threat
16387,22272,0,0,60,60,0,1,0,1,0,deny,0,1,Known Attack
64753,443,41377,443,145226,5591,139635,164,120,58,106,allow,1,0,Potential Threat
55806,445,0,0,66,66,0,1,0,1,0,drop,0,1,Known Attack
50485,445,0,0,70,70,0,1,0,1,0,drop,0,1,Known Attack
58171,80,42934,80,1651,550,1101,13,15,7,6,allow,0,0,Normal
58147,443,65421,443,8365,2826,5539,27,693,15,12,allow,1,0,Potential Threat
60838,445,0,0,70,70,0,1,0,1,0,drop,0,1,Known Attack
55921,443,24781,443,4348,1536,2812,14,121,6,8,allow,1,0,Potential Threat
62064,22114,0,0,66,66,0,1,0,1,0,deny,0,1,Known Attack
65186,27126,54671,27126,268,78,190,2,30,1,1,allow,1,0,Potential Threat
63709,21989,3950,21989,696,508,188,10,16,7,3,allow,1,0,Potential Threat
55403,53,28747,53,211,102,109,2,30,1,1,allow,0,0,Normal
50207,53,12070,53,189,102,87,2,31,1,1,allow,0,0,Normal
64911,53,46196,53,209,110,99,2,31,1,1,allow,0,0,Normal
63717,37965,0,0,62,62,0,1,0,1,0,deny,0,1,Known Attack
9146,443,17435,443,10056,2310,7746,27,36,14,13,allow,1,0,Potential Threat
63213,57866,0,0,62,62,0,1,0,1,0,deny,1,1,High Risk
58564,50432,0,0,66,66,0,1,0,1,0,deny,0,1,Known Attack
52142,443,7937,443,9911,2041,7870,34,120,17,17,allow,1,0,Potential Threat
65489,443,61860,443,92240,4799,87441,107,16,43,64,allow,1,0,Potential Threat
55314,53,61384,53,279,110,169,2,30,1,1,allow,0,0,Normal
33941,37807,0,0,62,62,0,1,0,1,0,deny,0,1,Known Attack
49236,53,51973,53,377,94,283,2,30,1,1,allow,0,0,Normal
49163,53,24237,53,166,85,81,2,30,1,1,allow,0,0,Normal
42112,443,17056,443,11459,2165,9294,29,259,11,18,allow,1,0,Potential Threat
64967,27051,5112,27051,1020,462,558,4,29,2,2,allow,1,0,Potential Threat
55184,53,41873,53,183,94,89,2,31,1,1,allow,0,0,Normal
56358,445,0,0,70,70,0,1,0,1,0,drop,0,1,Known Attack
39380,49903,0,0,146,146,0,1,0,1,0,deny,1,1,High Risk
33954,53,7602,53,168,78,90,2,29,1,1,allow,0,0,Normal
49598,445,0,0,66,66,0,1,0,1,0,drop,0,1,Known Attack
57472,44847,0,0,66,66,0,1,0,1,0,deny,0,1,Known Attack
51840,445,0,0,66,66,0,1,0,1,0,drop,0,1,Known Attack
63438,445,0,0,66,66,0,1,0,1,0,drop,0,1,Known Attack
51216,445,0,0,70,70,0,1,0,1,0,drop,0,1,Known Attack
57470,27232,13855,27232,4212,2724,1488,57,2411,33,24,allow,1,0,Potential Threat
49741,53,44929,53,177,94,83,2,30,1,1,allow,0,0,Normal
61033,39004,0,0,66,66,0,1,0,1,0,deny,0,1,Known Attack
58331,445,0,0,70,70,0,1,0,1,0,drop,0,1,Known Attack
36936,443,13188,443,490,210,280,8,131,4,4,allow,1,0,Potential Threat
55330,445,0,0,70,70,0,1,0,1,0,drop,0,1,Known Attack
61147,445,0,0,70,70,0,1,0,1,0,drop,0,1,Known Attack
64605,53,57757,53,183,94,89,2,29,1,1,allow,0,0,Normal
12969,55777,0,0,66,66,0,1,0,1,0,deny,1,1,High Risk
60878,443,39667,443,31315,6036,25279,65,49,32,33,allow,1,0,Potential Threat
55176,80,55176,80,374,240,134,7,15,5,2,allow,0,0,Normal
63042,443,30142,443,512,166,346,2,30,1,1,allow,0,0,Normal
64910,53,52147,53,259,86,173,2,30,1,1,allow,0,0,Normal
3691,80,6351,80,6826,1214,5612,20,105,12,8,allow,1,0,Potential Threat
58127,445,0,0,70,70,0,1,0,1,0,drop,0,1,Known Attack
57028,445,0,0,70,70,0,1,0,1,0,drop,0,1,Known Attack
64326,53,28923,53,192,98,94,2,31,1,1,allow,0,0,Normal
53282,443,7574,443,604924,37384,567540,846,154,315,531,allow,1,0,Potential Threat
55494,80,14370,80,188544,9826,178718,241,32,113,128,allow,1,0,Potential Threat
62408,3478,24308,3478,140,140,0,1,30,1,0,allow,1,0,Potential Threat
49743,445,0,0,70,70,0,1,0,1,0,drop,0,1,Known Attack
54120,445,0,0,70,70,0,1,0,1,0,drop,0,1,Known Attack
64313,53,9214,53,226,110,116,2,30,1,1,allow,0,0,Normal
65521,445,0,0,66,66,0,1,0,1,0,drop,0,1,Known Attack
51636,445,0,0,70,70,0,1,0,1,0,drop,0,1,Known Attack
57385,53,34809,53,197,102,95,2,30,1,1,allow,0,0,Normal
12346,53,12346,53,216,98,118,2,30,1,1,allow,0,0,Normal
50047,445,0,0,66,66,0,1,0,1,0,drop,0,1,Known Attack
30960,45684,7454,45684,330,330,0,6,3609,6,0,allow,1,0,Potential Threat
55567,445,0,0,70,70,0,1,0,1,0,drop,0,1,Known Attack
57470,39608,19893,39608,330,330,0,6,1199,6,0,allow,1,0,Potential Threat
31539,37965,0,0,62,62,0,1,0,1,0,deny,0,1,Known Attack
49757,53,9163,53,177,94,83,2,30,1,1,allow,0,0,Normal
65386,445,0,0,70,70,0,1,0,1,0,drop,0,1,Known Attack
58131,30228,0,0,146,146,0,1,0,1,0,deny,1,1,High Risk
32299,40019,4671,40019,148,86,62,2,30,1,1,allow,1,0,Potential Threat
57665,53,28556,53,168,78,90,2,30,1,1,allow,0,0,Normal
44839,443,23952,443,3188,2056,1132,23,121,13,10,allow,1,0,Potential Threat
50543,445,0,0,70,70,0,1,0,1,0,drop,0,1,Known Attack
55330,53,4334,53,216,102,114,2,30,1,1,allow,0,0,Normal
50253,445,0,0,70,70,0,1,0,1,0,drop,0,1,Known Attack
59321,445,0,0,70,70,0,1,0,1,0,drop,0,1,Known Attack
55545,53,34965,53,196,100,96,3,33,2,1,allow,0,0,Normal
64359,53,62943,53,196,102,94,2,30,1,1,allow,1,0,Potential Threat
49486,53,40876,53,177,94,83,2,31,1,1,allow,0,0,Normal
64365,53,27467,53,341,110,231,2,29,1,1,allow,0,0,Normal
60740,445,0,0,70,70,0,1,0,1,0,drop,0,1,Known Attack
42298,40007,25770,40007,206,84,122,4,29,2,2,allow,1,0,Potential Threat
60513,47094,45469,47094,320,140,180,6,7,3,3,allow,1,0,Potential Threat
50939,445,0,0,66,66,0,1,0,1,0,drop,0,1,Known Attack
37570,443,52731,443,130,64,66,3,6,2,1,allow,0,0,Normal
59029,445,0,0,70,70,0,1,0,1,0,drop,0,1,Known Attack
57839,445,0,0,70,70,0,1,0,1,0,drop,0,1,Known Attack
61574,445,0,0,70,70,0,1,0,1,0,drop,0,1,Known Attack
52216,8848,22408,8848,136,136,0,3,11,3,0,allow,1,0,Potential Threat
56725,53,48111,53,180,94,86,2,31,1,1,allow,0,0,Normal
64461,53,10856,53,170,87,83,2,30,1,1,allow,0,0,Normal
56600,80,32176,80,234,234,0,4,12,4,0,allow,0,0,Normal
56259,445,0,0,70,70,0,1,0,1,0,drop,0,1,Known Attack
57470,56250,44821,56250,330,330,0,6,1199,6,0,allow,1,0,Potential Threat
49286,53,40231,53,184,94,90,2,31,1,1,allow,0,0,Normal
49173,27402,64212,27402,70,70,0,1,5,1,0,allow,1,0,Potential Threat
64198,445,0,0,70,70,0,1,0,1,0,drop,0,1,Known Attack
28124,8497,0,0,148,148,0,1,0,1,0,deny,1,1,High Risk
55040,443,46427,443,62,62,0,1,4,1,0,allow,0,0,Normal
49931,25174,0,0,66,66,0,1,0,1,0,deny,0,1,Known Attack
56589,53,29602,53,199,102,97,2,30,1,1,allow,0,0,Normal
49420,443,10802,443,4932,1046,3886,21,173,10,11,allow,1,0,Potential Threat
56648,53,16460,53,199,102,97,2,31,1,1,allow,0,0,Normal
50474,445,0,0,66,66,0,1,0,1,0,drop,0,1,Known Attack
64059,445,0,0,70,70,0,1,0,1,0,drop,0,1,Known Attack
0,0,0,0,156,156,0,2,0,2,0,allow,1,1,High Risk
55020,445,0,0,70,70,0,1,0,1,0,drop,0,1,Known Attack
50054,445,0,0,70,70,0,1,0,1,0,drop,0,1,Known Attack
55889,53,49760,53,198,101,97,2,31,1,1,allow,0,0,Normal
35163,30188,0,0,66,66,0,1,0,1,0,deny,0,1,Known Attack
1024,9319,0,0,62,62,0,1,0,1,0,deny,1,1,High Risk
56215,53,45300,53,168,78,90,2,29,1,1,allow,0,0,Normal
63952,53,14655,53,211,110,101,2,30,1,1,allow,0,0,Normal
50994,445,0,0,66,66,0,1,0,1,0,drop,0,1,Known Attack
65176,53,64926,53,183,94,89,2,29,1,1,allow,1,0,Potential Threat
55059,443,19056,443,32852,17447,15405,61,64,32,29,allow,1,0,Potential Threat
56740,53,17032,53,716,95,621,2,30,1,1,allow,0,0,Normal
65329,445,0,0,70,70,0,1,0,1,0,drop,0,1,Known Attack
56314,53,18925,53,733,86,647,2,31,1,1,allow,0,0,Normal
39681,37965,0,0,66,66,0,1,0,1,0,deny,0,1,Known Attack
443,56858,0,0,85,85,0,1,0,1,0,deny,1,1,High Risk
62780,35440,0,0,66,66,0,1,0,1,0,deny,0,1,Known Attack
16387,29288,0,0,60,60,0,1,61,1,0,allow,1,0,Potential Threat
53015,64147,0,0,145,145,0,1,0,1,0,deny,1,1,High Risk
6881,6881,56597,6881,231,111,120,2,1200,1,1,allow,1,0,Potential Threat
47052,80,21524,80,1217,486,731,8,43,5,3,allow,0,0,Normal
9518,443,46388,443,3613,433,3180,11,16,6,5,allow,1,0,Potential Threat
49369,53,54778,53,183,94,89,2,30,1,1,allow,0,0,Normal
49370,11392,0,0,62,62,0,1,0,1,0,deny,0,1,Known Attack
55914,53,21562,53,212,102,110,2,30,1,1,allow,0,0,Normal
6247,51221,0,0,78,78,0,1,0,1,0,deny,1,1,High Risk
60648,445,0,0,66,66,0,1,0,1,0,drop,0,1,Known Attack
26900,27017,15895,27017,254,82,172,4,30,2,2,allow,1,0,Potential Threat
63964,53,46604,53,190,97,93,2,31,1,1,allow,0,0,Normal
49289,445,0,0,70,70,0,1,0,1,0,drop,0,1,Known Attack
64037,445,0,0,70,70,0,1,0,1,0,drop,0,1,Known Attack
4545,1900,0,0,136,136,0,1,0,1,0,deny,1,1,High Risk
6881,26296,0,0,146,146,0,1,0,1,0,deny,1,1,High Risk
65366,443,3510,443,4319,2473,1846,24,85,10,14,allow,1,0,Potential Threat
56638,64147,0,0,62,62,0,1,0,1,0,deny,1,1,High Risk
43303,443,47473,443,6448,1982,4466,22,16,11,11,allow,1,0,Potential Threat
53151,445,0,0,66,66,0,1,0,1,0,drop,0,1,Known Attack
1227,56205,0,0,66,66,0,1,0,1,0,deny,1,1,High Risk
61341,445,0,0,66,66,0,1,0,1,0,drop,0,1,Known Attack
51126,445,0,0,66,66,0,1,0,1,0,drop,0,1,Known Attack
1404,51180,0,0,145,145,0,1,0,1,0,deny,1,1,High Risk
56715,445,0,0,70,70,0,1,0,1,0,drop,0,1,Known Attack
49233,8080,49233,8080,2602,846,1756,13,136,7,6,allow,1,0,Potential Threat
64617,445,0,0,66,66,0,1,0,1,0,drop,0,1,Known Attack
57134,53,41374,53,195,102,93,2,30,1,1,allow,0,0,Normal
54104,443,3216,443,190,70,120,4,15,2,2,allow,0,0,Normal
58993,445,0,0,70,70,0,1,0,1,0,drop,0,1,Known Attack
27005,27016,3846,27016,889,126,763,2,30,1,1,allow,1,0,Potential Threat
55415,53,7035,53,183,94,89,2,30,1,1,allow,0,0,Normal
49577,57470,0,0,66,66,0,1,0,1,0,deny,0,1,Known Attack
62235,445,0,0,70,70,0,1,0,1,0,drop,0,1,Known Attack
59592,37965,0,0,62,62,0,1,0,1,0,deny,0,1,Known Attack
42981,44847,0,0,62,62,0,1,0,1,0,deny,0,1,Known Attack
50088,1604,0,0,84,84,0,1,0,1,0,deny,0,1,Known Attack
49418,27015,40892,27015,250,78,172,2,30,1,1,allow,1,0,Potential Threat
59257,445,0,0,70,70,0,1,0,1,0,drop,0,1,Known Attack
80,9918,0,0,60,60,0,1,0,1,0,deny,1,1,High Risk
65131,445,0,0,66,66,0,1,0,1,0,drop,0,1,Known Attack
60777,443,22998,443,10417,2617,7800,32,15,17,15,allow,1,0,Potential Threat
56762,53,10998,53,168,86,82,2,30,1,1,allow,0,0,Normal
49622,443,38378,443,11139,3031,8108,30,176,14,16,allow,1,0,Potential Threat
60046,445,0,0,66,66,0,1,0,1,0,drop,0,1,Known Attack
53789,53,48550,53,168,78,90,2,30,1,1,allow,0,0,Normal
63719,445,0,0,70,70,0,1,0,1,0,drop,0,1,Known Attack
39487,80,41504,80,1403,651,752,10,15,6,4,allow,1,0,Potential Threat
34360,25174,0,0,66,66,0,1,0,1,0,deny,0,1,Known Attack
55033,443,56054,443,13944,2069,11875,28,30,15,13,allow,1,0,Potential Threat
40544,53,0,0,82,82,0,1,30,1,0,allow,0,0,Normal
26253,53,26253,53,414,268,146,3,33,2,1,allow,1,0,Potential Threat
57772,50584,0,0,66,66,0,1,0,1,0,deny,0,1,Known Attack
57301,53,40888,53,177,94,83,2,29,1,1,allow,0,0,Normal
61589,443,61589,443,4672,1765,2907,19,28,11,8,allow,1,0,Potential Threat
58638,5900,0,0,62,62,0,1,0,1,0,deny,0,1,Known Attack
64012,40642,36772,40642,66,66,0,2,8,2,0,allow,1,0,Potential Threat
59750,445,0,0,70,70,0,1,0,1,0,drop,0,1,Known Attack
39704,53,39704,53,398,255,143,3,33,2,1,allow,0,0,Normal
64190,2767,0,0,66,66,0,1,0,1,0,deny,0,1,Known Attack
65209,57866,0,0,66,66,0,1,0,1,0,deny,1,1,High Risk
52085,445,0,0,66,66,0,1,0,1,0,drop,0,1,Known Attack
65338,53,10255,53,314,88,226,4,44,2,2,allow,0,0,Normal
52929,1433,0,0,60,60,0,1,0,1,0,deny,0,1,Known Attack
34529,443,30445,443,62652,30891,31761,158,381,67,91,allow,1,0,Potential Threat
50742,445,0,0,70,70,0,1,0,1,0,drop,0,1,Known Attack
53105,61310,38041,61310,70,70,0,1,5,1,0,allow,1,0,Potential Threat
21534,42246,0,0,66,66,0,1,0,1,0,deny,1,1,High Risk
53931,445,0,0,66,66,0,1,0,1,0,drop,0,1,Known Attack
60375,53,25105,53,226,94,132,2,31,1,1,allow,0,0,Normal
50938,445,0,0,66,66,0,1,0,1,0,drop,0,1,Known Attack
40784,443,40784,443,4378,1471,2907,19,25,11,8,allow,1,0,Potential Threat
51209,443,1552,443,11983,2674,9309,51,17,29,22,allow,1,0,Potential Threat
48553,443,14731,443,49428,2702,46726,70,136,30,40,allow,1,0,Potential Threat
65216,53,8359,53,775,102,673,2,30,1,1,allow,0,0,Normal
58536,53,15925,53,177,86,91,2,30,1,1,allow,0,0,Normal
54121,443,19391,443,26357358,863775,25493583,27347,208,8650,18697,allow,1,0,Potential Threat
49453,53,64414,53,227,110,117,2,31,1,1,allow,1,0,Potential Threat
5688,44847,0,0,66,66,0,1,0,1,0,deny,1,1,High Risk
57470,14806,59723,14806,132,132,0,3,1199,3,0,allow,1,0,Potential Threat
61275,445,0,0,70,70,0,1,0,1,0,drop,0,1,Known Attack
56720,443,57174,443,7941,1952,5989,20,15,11,9,allow,1,0,Potential Threat
49689,443,55526,443,1179,655,524,13,56,7,6,allow,1,0,Potential Threat
49420,53,47944,53,183,94,89,2,30,1,1,allow,0,0,Normal
49204,54530,41547,54530,316,136,180,6,6,3,3,allow,1,0,Potential Threat
53563,17355,37621,17355,320,140,180,6,5,3,3,allow,1,0,Potential Threat
49349,445,0,0,66,66,0,1,0,1,0,drop,0,1,Known Attack
43931,53,36161,53,168,78,90,2,31,1,1,allow,0,0,Normal
51797,80,9284,80,1929,796,1133,21,135,11,10,allow,1,0,Potential Threat
49332,53,38516,53,281,98,183,4,57,2,2,allow,0,0,Normal
3478,61463,0,0,1162,1162,0,1,0,1,0,deny,1,1,High Risk
49408,443,34465,443,7967,2176,5791,27,125,14,13,allow,1,0,Potential Threat
62668,445,0,0,66,66,0,1,0,1,0,drop,0,1,Known Attack
50098,53,35550,53,199,102,97,2,31,1,1,allow,0,0,Normal
58868,443,58939,443,239435,36478,202957,319,111,133,186,allow,1,0,Potential Threat
35699,443,53038,443,2060,1106,954,17,150,10,7,allow,1,0,Potential Threat
63854,53,30633,53,578,286,292,9,15,5,4,allow,1,0,Potential Threat
24812,44847,0,0,146,146,0,1,0,1,0,deny,1,1,High Risk
64747,53,25665,53,167,78,89,2,30,1,1,allow,0,0,Normal
59991,443,45209,443,5108,2834,2274,21,143,10,11,allow,1,0,Potential Threat
55417,53,4838,53,199,102,97,2,30,1,1,allow,0,0,Normal
53771,53,15804,53,168,78,90,2,30,1,1,allow,0,0,Normal
3478,61463,0,0,1275,1275,0,1,0,1,0,deny,1,1,High Risk
33896,57470,0,0,74,74,0,1,0,1,0,deny,1,1,High Risk
64403,53,2916,53,193,102,91,2,29,1,1,allow,0,0,Normal
58154,445,0,0,70,70,0,1,0,1,0,drop,0,1,Known Attack
48742,443,35072,443,5378,1423,3955,19,49,11,8,allow,1,0,Potential Threat
36770,56205,0,0,62,62,0,1,0,1,0,deny,1,1,High Risk
56846,445,0,0,66,66,0,1,0,1,0,drop,0,1,Known Attack
80,9918,0,0,60,60,0,1,0,1,0,deny,1,1,High Risk
55286,445,0,0,70,70,0,1,0,1,0,drop,0,1,Known Attack
56529,53,10690,53,378,94,284,2,30,1,1,allow,0,0,Normal
56423,53,58524,53,168,86,82,2,30,1,1,allow,0,0,Normal
54938,445,0,0,70,70,0,1,0,1,0,drop,0,1,Known Attack
58543,445,0,0,70,70,0,1,0,1,0,drop,0,1,Known Attack
53373,64147,0,0,66,66,0,1,0,1,0,deny,1,1,High Risk
51166,443,54384,443,13072,4708,8364,47,130,24,23,allow,1,0,Potential Threat
60855,443,10736,443,598135,40549,557586,873,251,326,547,allow,1,0,Potential Threat
59758,445,0,0,70,70,0,1,0,1,0,drop,0,1,Known Attack
32137,44512,0,0,62,62,0,1,0,1,0,deny,1,1,High Risk
49245,53,3951,53,190,97,93,2,31,1,1,allow,0,0,Normal
44385,53,19261,53,212,78,134,2,30,1,1,allow,0,0,Normal
49847,23,0,0,60,60,0,1,0,1,0,deny,0,1,Known Attack
26900,27017,43419,27017,422,164,258,6,30,3,3,allow,1,0,Potential Threat
53197,445,0,0,70,70,0,1,0,1,0,drop,0,1,Known Attack
36034,35440,0,0,62,62,0,1,0,1,0,deny,0,1,Known Attack
52182,443,53611,443,10422,1313,9109,23,75,12,11,allow,1,0,Potential Threat
53256,443,33969,443,6181,1040,5141,22,65,11,11,allow,1,0,Potential Threat
60488,27615,36232,27615,70,70,0,2,8,2,0,allow,1,0,Potential Threat
37008,42707,0,0,62,62,0,1,0,1,0,deny,0,1,Known Attack
53553,2297,50955,2297,70,70,0,1,4,1,0,allow,0,0,Normal
63235,443,19696,443,1373,734,639,17,96,10,7,allow,1,0,Potential Threat
51886,35965,55520,35965,66,66,0,1,5,1,0,allow,1,0,Potential Threat
49867,53,63133,53,177,94,83,2,30,1,1,allow,1,0,Potential Threat
50198,445,0,0,66,66,0,1,0,1,0,drop,0,1,Known Attack
46102,80,6915,80,70,70,0,2,5,2,0,allow,0,0,Normal
56746,443,25716,443,8006,1986,6020,20,15,11,9,allow,1,0,Potential Threat
443,62732,0,0,60,60,0,1,0,1,0,deny,1,1,High Risk
49965,445,0,0,70,70,0,1,0,1,0,drop,0,1,Known Attack
62802,445,0,0,66,66,0,1,0,1,0,drop,0,1,Known Attack
55833,53,34904,53,177,94,83,2,30,1,1,allow,0,0,Normal
49949,53,15582,53,193,102,91,2,30,1,1,allow,0,0,Normal
51295,445,0,0,66,66,0,1,0,1,0,drop,0,1,Known Attack
7561,43890,0,0,62,62,0,1,0,1,0,deny,1,1,High Risk
65445,53,54616,53,199,102,97,2,30,1,1,allow,0,0,Normal
63640,445,0,0,70,70,0,1,0,1,0,drop,0,1,Known Attack
58091,51505,0,0,66,66,0,1,0,1,0,deny,0,1,Known Attack
53385,445,0,0,70,70,0,1,0,1,0,drop,0,1,Known Attack
56757,443,9849,443,8057,2037,6020,20,15,11,9,allow,1,0,Potential Threat
64911,53,61645,53,202,103,99,2,31,1,1,allow,1,0,Potential Threat
55505,53,61786,53,198,101,97,2,1,1,1,allow,0,0,Normal
58993,443,55872,443,416,210,206,7,26,4,3,allow,0,0,Normal
53416,445,0,0,70,70,0,1,0,1,0,drop,0,1,Known Attack
0,0,0,0,156,156,0,2,0,2,0,allow,1,1,High Risk
40840,21247,0,0,62,62,0,1,0,1,0,deny,0,1,Known Attack
55979,445,0,0,70,70,0,1,0,1,0,drop,0,1,Known Attack
36762,443,46444,443,560,280,280,9,25,5,4,allow,1,0,Potential Threat
55966,57866,0,0,66,66,0,1,0,1,0,deny,0,1,Known Attack
51553,445,0,0,66,66,0,1,0,1,0,drop,0,1,Known Attack
64324,445,0,0,70,70,0,1,0,1,0,drop,0,1,Known Attack
60222,443,18964,443,4308,1658,2650,14,16,7,7,allow,1,0,Potential Threat
60796,53,60796,53,248,106,142,2,30,1,1,allow,0,0,Normal
49604,53,54196,53,179,94,85,2,29,1,1,allow,0,0,Normal
1821,64147,0,0,66,66,0,1,0,1,0,deny,1,1,High Risk
49831,53,24463,53,364,102,262,2,30,1,1,allow,0,0,Normal
54318,445,0,0,66,66,0,1,0,1,0,drop,0,1,Known Attack
59449,445,0,0,70,70,0,1,0,1,0,drop,0,1,Known Attack
30188,58770,26804,58770,14172,5733,8439,79,1531,37,42,allow,1,0,Potential Threat
37658,16385,25619,16385,130,70,60,2,30,1,1,allow,1,0,Potential Threat
57911,445,0,0,66,66,0,1,0,1,0,drop,0,1,Known Attack
9659,81,0,0,60,60,0,1,0,1,0,deny,0,1,Known Attack
49267,53,55947,53,184,94,90,2,30,1,1,allow,0,0,Normal
60257,445,0,0,66,66,0,1,0,1,0,drop,0,1,Known Attack
55310,445,0,0,66,66,0,1,0,1,0,drop,0,1,Known Attack
50593,443,49390,443,6292,1492,4800,22,16,11,11,allow,1,0,Potential Threat
52146,443,52659,443,774806,25835,748971,772,52,253,519,allow,1,0,Potential Threat
64554,53,27674,53,199,102,97,2,30,1,1,allow,0,0,Normal
56098,55442,0,0,66,66,0,1,0,1,0,deny,0,1,Known Attack
37007,22114,0,0,146,146,0,1,0,1,0,deny,1,1,High Risk
52349,445,0,0,70,70,0,1,0,1,0,drop,0,1,Known Attack
31727,57470,0,0,62,62,0,1,0,1,0,deny,1,1,High Risk
58568,445,0,0,66,66,0,1,0,1,0,drop,0,1,Known Attack
6889,25975,0,0,143,143,0,1,0,1,0,deny,1,1,High Risk
49900,443,21992,443,6896,2139,4757,31,33,15,16,allow,1,0,Potential Threat
57415,445,0,0,70,70,0,1,0,1,0,drop,0,1,Known Attack
56939,53,27310,53,216,110,106,2,30,1,1,allow,0,0,Normal
56456,445,0,0,70,70,0,1,0,1,0,drop,0,1,Known Attack
68,67,0,0,346,346,0,1,0,1,0,deny,1,1,High Risk
48706,23393,0,0,60,60,0,1,0,1,0,deny,0,1,Known Attack
40204,40003,21367,40003,156,94,62,2,30,1,1,allow,1,0,Potential Threat
50258,5228,5532,5228,6764,1575,5189,25,157,14,11,allow,1,0,Potential Threat
19962,53,19962,53,832,106,726,2,30,1,1,allow,1,0,Potential Threat
52056,445,0,0,70,70,0,1,0,1,0,drop,0,1,Known Attack
62550,51505,0,0,62,62,0,1,0,1,0,deny,1,1,High Risk
54922,445,0,0,70,70,0,1,0,1,0,drop,0,1,Known Attack
42298,40026,9867,40026,212,90,122,4,30,2,2,allow,1,0,Potential Threat
51434,53,0,0,202,93,109,2,30,1,1,allow,0,0,Normal
43129,20220,0,0,62,62,0,1,0,1,0,deny,0,1,Known Attack
30765,56205,0,0,66,66,0,1,0,1,0,deny,1,1,High Risk
42128,54532,0,0,60,60,0,1,0,1,0,deny,1,1,High Risk
58844,443,8325,443,5167,700,4467,16,15,7,9,allow,1,0,Potential Threat
56713,443,29098,443,373053,9725,363328,374,45,129,245,allow,1,0,Potential Threat
59875,443,3172,443,12357,5182,7175,30,108,13,17,allow,1,0,Potential Threat
54071,50265,0,0,62,62,0,1,0,1,0,deny,0,1,Known Attack
38211,123,28193,123,184,94,90,2,29,1,1,allow,0,0,Normal
58638,5900,0,0,62,62,0,1,0,1,0,deny,0,1,Known Attack
58638,5900,0,0,62,62,0,1,0,1,0,deny,0,1,Known Attack
57565,443,12958,443,3586,1074,2512,17,137,8,9,allow,1,0,Potential Threat
55336,53,13699,53,295,101,194,4,31,2,2,allow,0,0,Normal
53141,8595,63363,8595,70,70,0,2,8,2,0,allow,1,0,Potential Threat
49849,53,61078,53,196,102,94,2,31,1,1,allow,0,0,Normal
56292,53,4815,53,197,102,95,2,30,1,1,allow,0,0,Normal
53591,443,53591,443,1468,763,705,16,181,8,8,allow,1,0,Potential Threat
443,35385,0,0,130,130,0,1,0,1,0,deny,1,1,High Risk
48889,443,65230,443,87648,6895,80753,131,364,66,65,allow,1,0,Potential Threat
56413,51221,0,0,66,66,0,1,0,1,0,deny,0,1,Known Attack
57131,8055,0,0,145,145,0,1,0,1,0,deny,0,1,Known Attack
54977,445,0,0,70,70,0,1,0,1,0,drop,0,1,Known Attack
55972,53,35969,53,193,102,91,2,29,1,1,allow,0,0,Normal
53394,53,24735,53,86,86,0,1,30,1,0,allow,0,0,Normal
7660,443,7660,443,5640,2394,3246,25,82,13,12,allow,1,0,Potential Threat
55643,53,36774,53,183,94,89,2,30,1,1,allow,0,0,Normal
53035,5228,40515,5228,2725,1610,1115,20,3600,10,10,allow,1,0,Potential Threat
52126,56057,8315,56057,70,70,0,1,5,1,0,allow,1,0,Potential Threat
9494,23,0,0,60,60,0,1,0,1,0,deny,0,1,Known Attack
54503,443,54503,443,157452,26878,130574,213,214,111,102,allow,1,0,Potential Threat
51932,443,23132,443,3207,2430,777,21,26,11,10,allow,0,0,Normal
49307,53,61453,53,210,102,108,2,29,1,1,allow,0,0,Normal
54239,443,8377,443,499,425,74,4,0,3,1,allow,0,0,Normal
54423,445,0,0,70,70,0,1,0,1,0,drop,0,1,Known Attack
52697,445,0,0,70,70,0,1,0,1,0,drop,0,1,Known Attack
43916,21,0,0,60,60,0,1,0,1,0,deny,0,1,Known Attack
18125,53,18125,53,235,90,145,2,33,1,1,allow,0,0,Normal
49305,445,0,0,70,70,0,1,0,1,0,drop,0,1,Known Attack
51001,445,0,0,70,70,0,1,0,1,0,drop,0,1,Known Attack
38629,25174,0,0,66,66,0,1,0,1,0,deny,0,1,Known Attack
29706,50584,0,0,66,66,0,1,0,1,0,deny,1,1,High Risk
50337,80,47050,80,1083,653,430,8,16,5,3,allow,0,0,Normal
17009,53733,0,0,62,62,0,1,0,1,0,deny,1,1,High Risk
49846,443,49846,443,4693,1786,2907,19,27,11,8,allow,1,0,Potential Threat
6881,6881,0,0,146,146,0,1,0,1,0,deny,1,1,High Risk
50584,6881,48204,6881,161,161,0,1,1200,1,0,allow,1,0,Potential Threat
55294,53,55276,53,199,102,97,2,30,1,1,allow,0,0,Normal
60043,443,26610,443,1015,572,443,11,142,6,5,allow,1,0,Potential Threat
16387,20045,0,0,60,60,0,1,0,1,0,deny,0,1,Known Attack
59517,443,5605,443,6285,1545,4740,22,17,12,10,allow,1,0,Potential Threat
64288,53,10803,53,182,93,89,2,31,1,1,allow,0,0,Normal
63964,53,52901,53,196,94,102,2,30,1,1,allow,0,0,Normal
0,0,0,0,600,306,294,6,0,3,3,allow,1,0,Potential Threat
52052,445,0,0,70,70,0,1,0,1,0,drop,0,1,Known Attack
50584,28020,62483,28020,1302,300,1002,6,1200,3,3,allow,1,0,Potential Threat
56422,53,35743,53,190,97,93,2,31,1,1,allow,0,0,Normal
64550,53,62266,53,221,94,127,2,29,1,1,allow,1,0,Potential Threat
59988,443,59988,443,8589,2809,5780,30,16,15,15,allow,1,0,Potential Threat
38475,11392,0,0,66,66,0,1,0,1,0,deny,0,1,Known Attack
64033,445,0,0,66,66,0,1,0,1,0,drop,0,1,Known Attack
42207,443,33313,443,7870,2945,4925,19,136,9,10,allow,1,0,Potential Threat
54598,37965,0,0,62,62,0,1,0,1,0,deny,0,1,Known Attack
59400,22114,0,0,66,66,0,1,0,1,0,deny,0,1,Known Attack
57487,443,43988,443,1786,172,1614,7,121,3,4,allow,1,0,Potential Threat
38723,37838,0,0,146,146,0,1,0,1,0,deny,1,1,High Risk
55122,53,17738,53,173,94,79,2,30,1,1,allow,0,0,Normal
64410,53,61695,53,196,102,94,2,30,1,1,allow,1,0,Potential Threat
58638,5900,0,0,62,62,0,1,0,1,0,deny,0,1,Known Attack
57471,62413,0,0,66,66,0,1,0,1,0,deny,1,1,High Risk
65014,53,11511,53,718,94,624,2,29,1,1,allow,0,0,Normal
34993,15503,0,0,62,62,0,1,0,1,0,deny,0,1,Known Attack
49522,80,55749,80,6908,1652,5256,26,225,12,14,allow,1,0,Potential Threat
53752,443,21616,443,499,425,74,4,0,3,1,allow,0,0,Normal
50151,53,24855,53,177,94,83,2,30,1,1,allow,0,0,Normal
57304,53,49312,53,228,110,118,2,31,1,1,allow,0,0,Normal
56727,53,55377,53,250,86,164,4,52,2,2,allow,0,0,Normal
57331,53,59568,53,172,88,84,2,30,1,1,allow,0,0,Normal
57316,443,30855,443,5613,733,4880,16,15,9,7,allow,1,0,Potential Threat
61980,53,64563,53,374,104,270,4,50,2,2,allow,1,0,Potential Threat
41472,53,41472,53,218,90,128,2,30,1,1,allow,0,0,Normal
56548,53,18583,53,199,102,97,2,30,1,1,allow,0,0,Normal
60866,443,47757,443,14519,9445,5074,35,15,20,15,allow,1,0,Potential Threat
54967,445,0,0,70,70,0,1,0,1,0,drop,0,1,Known Attack
53240,443,16717,443,1296713,27754,1268959,1253,118,366,887,allow,1,0,Potential Threat
56298,445,0,0,70,70,0,1,0,1,0,drop,0,1,Known Attack
58791,15503,0,0,66,66,0,1,0,1,0,deny,0,1,Known Attack
60000,443,1189,443,34450,1943,32507,47,144,16,31,allow,1,0,Potential Threat
50340,53,17641,53,189,102,87,2,31,1,1,allow,0,0,Normal
65513,445,0,0,66,66,0,1,0,1,0,drop,0,1,Known Attack
27869,51221,0,0,66,66,0,1,0,1,0,deny,1,1,High Risk
58638,5900,0,0,62,62,0,1,0,1,0,deny,0,1,Known Attack
64589,53,29733,53,742,88,654,2,30,1,1,allow,0,0,Normal
52354,443,50559,443,10417,5338,5079,22,135,11,11,allow,1,0,Potential Threat
56409,443,57180,443,25302,1733,23569,35,121,16,19,allow,1,0,Potential Threat
58638,5900,0,0,62,62,0,1,0,1,0,deny,0,1,Known Attack
38581,22114,0,0,62,62,0,1,0,1,0,deny,0,1,Known Attack
57060,50584,0,0,62,62,0,1,0,1,0,deny,0,1,Known Attack
32879,443,46058,443,8137,2110,6027,29,394,10,19,allow,1,0,Potential Threat
61353,443,57410,443,4401,1654,2747,10,120,5,5,allow,1,0,Potential Threat
50899,80,62536,80,13974043,173337,13800706,11715,134,2429,9286,allow,1,0,Potential Threat
26459,80,26459,80,490,264,226,8,32,5,3,allow,1,0,Potential Threat
63956,38211,0,0,62,62,0,1,0,1,0,deny,0,1,Known Attack
60047,443,35596,443,1350,689,661,14,44,8,6,allow,1,0,Potential Threat
51342,445,0,0,70,70,0,1,0,1,0,drop,0,1,Known Attack
64279,23718,0,0,62,62,0,1,0,1,0,deny,0,1,Known Attack
51221,27417,45430,27417,481,150,331,2,1200,1,1,allow,1,0,Potential Threat
53770,443,15341,443,499,425,74,4,0,3,1,allow,0,0,Normal
27005,27216,33781,27216,872,126,746,2,30,1,1,allow,1,0,Potential Threat
64628,53,26706,53,753,93,660,2,30,1,1,allow,0,0,Normal
43260,41615,0,0,145,145,0,1,0,1,0,deny,1,1,High Risk
56621,53,42291,53,170,87,83,2,30,1,1,allow,0,0,Normal
43563,53,1876,53,164,78,86,2,30,1,1,allow,0,0,Normal
49931,443,64224,443,92352,5699,86653,105,134,35,70,allow,1,0,Potential Threat
64680,22114,0,0,146,146,0,1,0,1,0,deny,1,1,High Risk
64959,53,12342,53,209,110,99,2,30,1,1,allow,0,0,Normal
3407,57866,0,0,66,66,0,1,0,1,0,deny,1,1,High Risk
63112,443,43251,443,3695,2713,982,21,82,12,9,allow,1,0,Potential Threat
55549,53,31074,53,202,103,99,2,31,1,1,allow,0,0,Normal
63948,53,52448,53,366,102,264,4,60,2,2,allow,0,0,Normal
55420,445,0,0,66,66,0,1,0,1,0,drop,0,1,Known Attack
64765,445,0,0,66,66,0,1,0,1,0,drop,0,1,Known Attack
58632,445,0,0,66,66,0,1,0,1,0,drop,0,1,Known Attack
35610,37965,0,0,62,62,0,1,0,1,0,deny,0,1,Known Attack
52207,80,29595,80,372,246,126,6,27,4,2,allow,0,0,Normal
57352,53,29825,53,196,102,94,2,31,1,1,allow,0,0,Normal
54583,443,25809,443,11307,7633,3674,25,163,18,7,allow,1,0,Potential Threat
50036,445,0,0,70,70,0,1,0,1,0,drop,0,1,Known Attack
55373,1,0,0,66,66,0,1,0,1,0,deny,0,1,Known Attack
54246,80,56298,80,506,292,214,8,16,5,3,allow,0,0,Normal
58248,50584,0,0,66,66,0,1,0,1,0,deny,0,1,Known Attack
56497,53,27099,53,177,94,83,2,30,1,1,allow,0,0,Normal
55144,53,47771,53,209,102,107,2,30,1,1,allow,0,0,Normal
49625,53,64446,53,251,102,149,2,30,1,1,allow,1,0,Potential Threat
55032,62413,0,0,66,66,0,1,0,1,0,deny,1,1,High Risk
38194,53,38194,53,210,98,112,2,29,1,1,allow,0,0,Normal
47326,443,40388,443,6318,1025,5293,17,33,9,8,allow,1,0,Potential Threat
57944,445,0,0,70,70,0,1,0,1,0,drop,0,1,Known Attack
12107,22114,0,0,66,66,0,1,0,1,0,deny,0,1,Known Attack
50460,443,12819,443,1346,918,428,10,31,6,4,allow,0,0,Normal
56714,443,11426,443,579769,15036,564733,578,61,199,379,allow,1,0,Potential Threat
21492,51505,0,0,62,62,0,1,0,1,0,deny,1,1,High Risk
52973,57470,0,0,74,74,0,1,0,1,0,deny,1,1,High Risk
29263,50939,0,0,148,148,0,1,0,1,0,deny,1,1,High Risk
56153,53,6546,53,742,88,654,2,31,1,1,allow,0,0,Normal
62310,445,0,0,70,70,0,1,0,1,0,drop,0,1,Known Attack
63117,7000,63117,7000,4067,1750,2317,16,15,9,7,allow,1,0,Potential Threat
49160,34021,0,0,146,146,0,1,0,1,0,reset-both,1,1,High Risk
50908,80,37284,80,14077960,171956,13906004,11755,133,2437,9318,allow,1,0,Potential Threat
56697,443,50660,443,3593,2749,844,18,22,11,7,allow,1,0,Potential Threat
52885,445,0,0,66,66,0,1,0,1,0,drop,0,1,Known Attack
58024,80,1081,80,318,192,126,6,20,4,2,allow,0,0,Normal
63580,443,12197,443,5759,1721,4038,20,78,11,9,allow,1,0,Potential Threat
54458,64147,0,0,62,62,0,1,0,1,0,deny,1,1,High Risk
53795,22719,46314,22719,164,70,94,2,6,1,1,allow,1,0,Potential Threat
56717,53,57782,53,183,94,89,2,29,1,1,allow,0,0,Normal
51414,22,0,0,60,60,0,1,0,1,0,deny,0,1,Known Attack
50331,80,36568,80,1677,862,815,10,15,5,5,allow,0,0,Normal
59200,53,0,0,82,82,0,1,30,1,0,allow,0,0,Normal
56710,80,31559,80,30614,1926,28688,44,45,23,21,allow,1,0,Potential Threat
50689,443,64099,443,180,60,120,4,15,2,2,allow,1,0,Potential Threat
52925,3389,0,0,60,60,0,1,0,1,0,deny,0,1,Known Attack
55884,445,0,0,66,66,0,1,0,1,0,drop,0,1,Known Attack
48734,443,7322,443,256887,11565,245322,293,56,112,181,allow,1,0,Potential Threat
61637,25174,0,0,66,66,0,1,0,1,0,deny,0,1,Known Attack
26110,2310,0,0,148,148,0,1,0,1,0,deny,0,1,Known Attack
64346,445,0,0,70,70,0,1,0,1,0,drop,0,1,Known Attack
58876,57470,0,0,66,66,0,1,0,1,0,deny,1,1,High Risk
40180,443,53378,443,1310,649,661,13,184,7,6,allow,1,0,Potential Threat
54610,443,15531,443,19810,7047,12763,54,438,28,26,allow,1,0,Potential Threat
64619,53,62516,53,229,94,135,2,30,1,1,allow,1,0,Potential Threat
58638,5900,58638,5900,156,62,94,2,10,1,1,allow,1,0,Potential Threat
44612,25174,0,0,66,66,0,1,0,1,0,deny,0,1,Known Attack
62299,53,62299,53,259,108,151,2,31,1,1,allow,1,0,Potential Threat
54586,445,0,0,66,66,0,1,0,1,0,drop,0,1,Known Attack
49455,53,42395,53,1750,184,1566,6,85,3,3,allow,0,0,Normal
27005,27015,35469,27015,886,126,760,2,30,1,1,allow,1,0,Potential Threat
64055,53,52345,53,181,94,87,2,29,1,1,allow,0,0,Normal
59143,445,0,0,70,70,0,1,0,1,0,drop,0,1,Known Attack
64127,53,25934,53,177,94,83,2,30,1,1,allow,0,0,Normal
49845,53,33096,53,194,102,92,2,30,1,1,allow,0,0,Normal
64380,53,5955,53,193,102,91,2,30,1,1,allow,0,0,Normal
64606,53,40619,53,278,118,160,2,30,1,1,allow,0,0,Normal
443,4205,0,0,320,320,0,1,0,1,0,deny,1,1,High Risk
53353,26467,0,0,62,62,0,1,0,1,0,deny,0,1,Known Attack
35817,443,2802,443,3120,1862,1258,18,15,11,7,allow,1,0,Potential Threat
1330,53567,0,0,146,146,0,1,0,1,0,deny,1,1,High Risk
54202,443,43752,443,499,425,74,4,0,3,1,allow,0,0,Normal
59885,443,10109,443,1401,864,537,12,28,6,6,allow,1,0,Potential Threat
62265,445,0,0,70,70,0,1,0,1,0,drop,0,1,Known Attack
56403,51505,0,0,66,66,0,1,0,1,0,deny,0,1,Known Attack
46963,443,17005,443,70,70,0,1,5,1,0,allow,0,0,Normal
51140,445,0,0,70,70,0,1,0,1,0,drop,0,1,Known Attack
53639,445,0,0,66,66,0,1,0,1,0,drop,0,1,Known Attack
49832,445,0,0,70,70,0,1,0,1,0,drop,0,1,Known Attack
55463,445,0,0,70,70,0,1,0,1,0,drop,0,1,Known Attack
56890,443,61166,443,6935,1415,5520,22,186,12,10,allow,1,0,Potential Threat
62938,445,0,0,70,70,0,1,0,1,0,drop,0,1,Known Attack
51972,445,0,0,70,70,0,1,0,1,0,drop,0,1,Known Attack
60241,445,0,0,70,70,0,1,0,1,0,drop,0,1,Known Attack
57470,1337,56441,1337,792,792,0,13,1199,13,0,allow,1,0,Potential Threat
53520,445,0,0,70,70,0,1,0,1,0,drop,0,1,Known Attack
60869,48817,0,0,66,66,0,1,0,1,0,deny,0,1,Known Attack
59685,445,0,0,70,70,0,1,0,1,0,drop,0,1,Known Attack
37026,80,28562,80,2849,1631,1218,9,721,5,4,allow,1,0,Potential Threat
46455,53,32632,53,168,78,90,2,30,1,1,allow,0,0,Normal
64598,445,0,0,70,70,0,1,0,1,0,drop,0,1,Known Attack
55718,445,0,0,70,70,0,1,0,1,0,drop,0,1,Known Attack
34891,53,37025,53,396,257,139,3,30,2,1,allow,0,0,Normal
54125,443,54125,443,65572,14874,50698,92,84,48,44,allow,1,0,Potential Threat
52024,47600,3124,47600,70,70,0,1,4,1,0,allow,1,0,Potential Threat
59876,44847,0,0,62,62,0,1,0,1,0,deny,0,1,Known Attack
55928,443,33892,443,5433,3275,2158,16,135,8,8,allow,1,0,Potential Threat
56744,443,27482,443,8008,1988,6020,20,15,11,9,allow,1,0,Potential Threat
60312,57470,0,0,74,74,0,1,0,1,0,deny,1,1,High Risk
51114,445,0,0,66,66,0,1,0,1,0,drop,0,1,Known Attack
62741,445,0,0,66,66,0,1,0,1,0,drop,0,1,Known Attack
37334,443,47156,443,6592,1735,4857,23,360,11,12,allow,1,0,Potential Threat
65366,53,60695,53,198,101,97,2,31,1,1,allow,0,0,Normal
65437,53,48894,53,1386,85,1301,4,53,2,2,allow,1,0,Potential Threat
49176,53,17276,53,264,110,154,2,30,1,1,allow,0,0,Normal
51615,25174,0,0,66,66,0,1,0,1,0,deny,0,1,Known Attack
46025,80,38311,80,5037,1911,3126,18,86,10,8,allow,1,0,Potential Threat
65081,445,0,0,70,70,0,1,0,1,0,drop,0,1,Known Attack
58853,443,20470,443,155516,6298,149218,174,107,49,125,allow,1,0,Potential Threat
58638,5900,0,0,62,62,0,1,0,1,0,deny,0,1,Known Attack
1024,64147,0,0,62,62,0,1,0,1,0,deny,1,1,High Risk
13973,50584,0,0,146,146,0,1,0,1,0,deny,1,1,High Risk
65212,53,35167,53,192,98,94,2,31,1,1,allow,0,0,Normal
43934,53,43934,53,310,94,216,2,30,1,1,allow,0,0,Normal
58638,5900,0,0,62,62,0,1,0,1,0,deny,0,1,Known Attack
51628,443,50977,443,5678,3121,2557,39,256,18,21,allow,1,0,Potential Threat
51779,49525,20031,49525,70,70,0,1,5,1,0,allow,1,0,Potential Threat
62213,445,0,0,70,70,0,1,0,1,0,drop,0,1,Known Attack
59988,64147,0,0,66,66,0,1,0,1,0,deny,1,1,High Risk
2226,443,2226,443,46743,4890,41853,69,23,35,34,allow,1,0,Potential Threat
61365,445,0,0,70,70,0,1,0,1,0,drop,0,1,Known Attack
57470,17690,10017,17690,1818,1188,630,26,2804,19,7,allow,1,0,Potential Threat
58761,443,45887,443,318,192,126,6,26,4,2,allow,0,0,Normal
64477,53,60345,53,211,102,109,2,29,1,1,allow,0,0,Normal
49397,53,28669,53,365,94,271,2,30,1,1,allow,0,0,Normal
62872,50584,0,0,66,66,0,1,0,1,0,deny,1,1,High Risk
58263,445,0,0,70,70,0,1,0,1,0,drop,0,1,Known Attack
62549,53733,0,0,66,66,0,1,0,1,0,deny,1,1,High Risk
51855,7700,11959,7700,12087,9521,2566,76,32,38,38,allow,1,0,Potential Threat
1024,64147,0,0,62,62,0,1,0,1,0,deny,1,1,High Risk
32012,500,63361,500,879,462,417,2,600,1,1,allow,1,0,Potential Threat
54991,36829,0,0,66,66,0,1,0,1,0,deny,0,1,Known Attack
64649,53,32892,53,807,94,713,2,30,1,1,allow,0,0,Normal
59559,443,47582,443,3255,1089,2166,10,122,5,5,allow,1,0,Potential Threat
50308,445,0,0,70,70,0,1,0,1,0,drop,0,1,Known Attack
54063,80,60737,80,2545,515,2030,12,17,6,6,allow,1,0,Potential Threat
26900,27017,12522,27017,422,164,258,6,30,3,3,allow,1,0,Potential Threat
53294,445,0,0,70,70,0,1,0,1,0,drop,0,1,Known Attack
0,0,0,0,185,185,0,1,0,1,0,deny,1,1,High Risk
49381,53,1330,53,209,110,99,2,30,1,1,allow,0,0,Normal
49706,443,36455,443,32941,1850,31091,46,131,19,27,allow,1,0,Potential Threat
54664,443,18558,443,8263,1279,6984,15,136,7,8,allow,1,0,Potential Threat
55568,443,60113,443,8979,5057,3922,89,110,51,38,allow,1,0,Potential Threat
49341,53,47990,53,199,102,97,2,31,1,1,allow,0,0,Normal
63465,56205,0,0,66,66,0,1,0,1,0,deny,1,1,High Risk
64032,445,0,0,70,70,0,1,0,1,0,drop,0,1,Known Attack
64357,53,57507,53,271,85,186,4,30,2,2,allow,0,0,Normal
46989,80,46989,80,82082,3212,78870,90,155,27,63,allow,1,0,Potential Threat
61468,443,50536,443,6265,1185,5080,24,89,14,10,allow,1,0,Potential Threat
63771,445,0,0,66,66,0,1,0,1,0,drop,0,1,Known Attack
51414,50584,0,0,66,66,0,1,0,1,0,deny,0,1,Known Attack
48817,51413,48817,51413,479,152,327,2,1200,1,1,allow,1,0,Potential Threat
28007,443,65025,443,10168,968,9200,19,15,9,10,allow,1,0,Potential Threat
64507,53,28479,53,382,102,280,2,29,1,1,allow,0,0,Normal
65167,445,0,0,70,70,0,1,0,1,0,drop,0,1,Known Attack
59530,53,58720,53,578,286,292,9,15,5,4,allow,1,0,Potential Threat
50921,443,40184,443,9516,1896,7620,21,127,11,10,allow,1,0,Potential Threat
58248,445,0,0,66,66,0,1,0,1,0,drop,0,1,Known Attack
51850,11981,61118,11981,316,136,180,6,7,3,3,allow,1,0,Potential Threat
49904,53,31561,53,217,94,123,2,29,1,1,allow,0,0,Normal
37965,16153,40075,16153,1320,1320,0,21,1682,21,0,allow,1,0,Potential Threat
59131,53,59747,53,70,70,0,1,30,1,0,allow,0,0,Normal
65357,445,0,0,70,70,0,1,0,1,0,drop,0,1,Known Attack
51515,443,8850,443,16287,13303,2984,49,38,26,23,allow,1,0,Potential Threat
52526,30188,0,0,66,66,0,1,0,1,0,deny,0,1,Known Attack
64991,53,47067,53,625,192,433,6,46,3,3,allow,1,0,Potential Threat
65484,443,29745,443,148284,6200,142084,165,16,63,102,allow,1,0,Potential Threat
49708,53,14475,53,185,102,83,2,30,1,1,allow,0,0,Normal
61417,445,0,0,70,70,0,1,0,1,0,drop,0,1,Known Attack
51136,445,0,0,70,70,0,1,0,1,0,drop,0,1,Known Attack
59437,53,35841,53,215,86,129,2,29,1,1,allow,0,0,Normal
22345,80,22345,80,490,264,226,8,30,5,3,allow,1,0,Potential Threat
50470,61463,0,0,86,86,0,1,0,1,0,deny,1,1,High Risk
56568,5228,36431,5228,2387,1435,952,16,3600,8,8,allow,1,0,Potential Threat
51908,80,63314,80,4542,2962,1580,13,28,8,5,allow,1,0,Potential Threat
49474,445,0,0,70,70,0,1,0,1,0,drop,0,1,Known Attack
45511,443,41466,443,130,70,60,2,15,1,1,allow,0,0,Normal
42156,80,29548,80,891,536,355,10,255,6,4,allow,1,0,Potential Threat
57265,443,12728,443,9633,4368,5265,32,71,18,14,allow,1,0,Potential Threat
59097,2767,0,0,66,66,0,1,0,1,0,deny,0,1,Known Attack
50269,443,40163,443,7543,2533,5010,26,55,14,12,allow,1,0,Potential Threat
54461,443,55522,443,7548,2583,4965,26,362,12,14,allow,1,0,Potential Threat
55222,53,63142,53,181,94,87,2,29,1,1,allow,1,0,Potential Threat
58000,17,58000,17,66,66,0,1,30,1,0,allow,0,0,Normal
52210,51505,0,0,66,66,0,1,0,1,0,deny,0,1,Known Attack
55260,53,35785,53,183,94,89,2,30,1,1,allow,0,0,Normal
49248,80,49248,80,163556,12140,151416,207,22,97,110,allow,1,0,Potential Threat
35991,443,1116,443,10857,4247,6610,27,121,13,14,allow,1,0,Potential Threat
56997,53,44658,53,168,86,82,2,30,1,1,allow,0,0,Normal
64493,53,42355,53,199,102,97,2,29,1,1,allow,0,0,Normal
63397,26467,0,0,66,66,0,1,0,1,0,deny,0,1,Known Attack
55025,53,42219,53,183,94,89,2,30,1,1,allow,0,0,Normal
2432,11392,0,0,62,62,0,1,0,1,0,deny,1,1,High Risk
27179,53,27179,53,398,255,143,3,34,2,1,allow,1,0,Potential Threat
51578,44847,0,0,66,66,0,1,0,1,0,deny,0,1,Known Attack
48733,443,64638,443,316457,19287,297170,382,80,157,225,allow,1,0,Potential Threat
59164,445,0,0,70,70,0,1,0,1,0,drop,0,1,Known Attack
50165,80,3536,80,17387,9304,8083,30,56,19,11,allow,1,0,Potential Threat
56413,51221,0,0,66,66,0,1,0,1,0,deny,0,1,Known Attack
49326,443,59214,443,5514,3341,2173,31,75,15,16,allow,1,0,Potential Threat
48282,8080,0,0,184,78,106,3,9,2,1,allow,0,0,Normal
43260,41615,0,0,145,145,0,1,0,1,0,deny,1,1,High Risk
14618,6881,0,0,66,66,0,1,0,1,0,deny,0,1,Known Attack
46544,443,31614,443,332590,15084,317506,341,139,89,252,allow,1,0,Potential Threat
59220,445,0,0,70,70,0,1,0,1,0,drop,0,1,Known Attack
58638,5900,0,0,62,62,0,1,0,1,0,deny,0,1,Known Attack
42298,40005,47580,40005,211,89,122,4,29,2,2,allow,1,0,Potential Threat
55838,445,0,0,70,70,0,1,0,1,0,drop,0,1,Known Attack
54210,64097,0,0,66,66,0,1,0,1,0,deny,1,1,High Risk
56472,53,13780,53,167,86,81,2,31,1,1,allow,0,0,Normal
58814,443,65401,443,6508,4230,2278,22,16,12,10,allow,1,0,Potential Threat
60927,445,0,0,70,70,0,1,0,1,0,drop,0,1,Known Attack
63194,50265,0,0,62,62,0,1,0,1,0,deny,1,1,High Risk
65244,445,0,0,66,66,0,1,0,1,0,drop,0,1,Known Attack
57429,445,0,0,70,70,0,1,0,1,0,drop,0,1,Known Attack
51499,443,54241,443,1610,1073,537,14,15,8,6,allow,1,0,Potential Threat
49228,443,49228,443,32952,11546,21406,60,71,36,24,allow,1,0,Potential Threat
63436,445,0,0,66,66,0,1,0,1,0,drop,0,1,Known Attack
56688,443,60189,443,7942,1953,5989,20,15,11,9,allow,1,0,Potential Threat
54828,53,54828,53,404,259,145,3,33,2,1,allow,0,0,Normal
64765,445,0,0,70,70,0,1,0,1,0,drop,0,1,Known Attack
52110,35411,30183,35411,66,66,0,1,5,1,0,allow,1,0,Potential Threat
48018,443,52238,443,1429,1295,134,10,29,8,2,allow,1,0,Potential Threat
52311,445,0,0,70,70,0,1,0,1,0,drop,0,1,Known Attack
6713,2222,0,0,60,60,0,1,0,1,0,deny,0,1,Known Attack
64260,53,40725,53,230,86,144,2,30,1,1,allow,0,0,Normal
64605,25174,0,0,66,66,0,1,0,1,0,deny,0,1,Known Attack
52145,80,50375,80,366,240,126,7,32,5,2,allow,0,0,Normal
59191,443,56618,443,4489,2046,2443,23,121,11,12,allow,1,0,Potential Threat
64591,445,0,0,70,70,0,1,0,1,0,drop,0,1,Known Attack
62529,445,0,0,70,70,0,1,0,1,0,drop,0,1,Known Attack
64540,445,0,0,70,70,0,1,0,1,0,drop,0,1,Known Attack
62051,11392,0,0,62,62,0,1,0,1,0,deny,0,1,Known Attack
7686,25174,0,0,146,146,0,1,0,1,0,deny,1,1,High Risk
60650,445,0,0,70,70,0,1,0,1,0,drop,0,1,Known Attack
63542,15503,0,0,66,66,0,1,0,1,0,deny,0,1,Known Attack
52934,26467,0,0,66,66,0,1,0,1,0,deny,0,1,Known Attack
56676,37965,0,0,66,66,0,1,0,1,0,deny,0,1,Known Attack
50692,80,35406,80,57678,29714,27964,241,175,120,121,allow,1,0,Potential Threat
55261,53,52795,53,183,94,89,2,30,1,1,allow,0,0,Normal
57515,445,0,0,70,70,0,1,0,1,0,drop,0,1,Known Attack
53895,36849,56387,36849,70,70,0,2,7,2,0,allow,1,0,Potential Threat
62748,445,0,0,70,70,0,1,0,1,0,drop,0,1,Known Attack
56111,53,49193,53,179,94,85,2,31,1,1,allow,0,0,Normal
56697,53,16898,53,198,102,96,2,29,1,1,allow,0,0,Normal
49932,53,49932,53,404,259,145,3,32,2,1,allow,0,0,Normal
56438,3389,56438,3389,3425,1470,1955,16,17,8,8,allow,1,0,Potential Threat
55972,53,37415,53,699,438,261,2,30,1,1,allow,0,0,Normal
61455,445,0,0,70,70,0,1,0,1,0,drop,0,1,Known Attack
50106,30317,0,0,62,62,0,1,0,1,0,deny,0,1,Known Attack
57444,53,35555,53,177,94,83,2,29,1,1,allow,0,0,Normal
60354,445,0,0,70,70,0,1,0,1,0,drop,0,1,Known Attack
55505,53,51745,53,199,102,97,2,31,1,1,allow,0,0,Normal
34765,5222,48630,5222,10109,3480,6629,72,615,38,34,allow,1,0,Potential Threat
58851,443,38942,443,5166,700,4466,16,15,7,9,allow,1,0,Potential Threat
49824,53,9699,53,172,88,84,2,31,1,1,allow,0,0,Normal
58343,445,0,0,70,70,0,1,0,1,0,drop,0,1,Known Attack
63966,42532,21022,42532,66,66,0,2,7,2,0,allow,1,0,Potential Threat
59447,445,0,0,70,70,0,1,0,1,0,drop,0,1,Known Attack
51796,48779,32373,48779,70,70,0,1,5,1,0,allow,1,0,Potential Threat
2876,35440,0,0,62,62,0,1,0,1,0,deny,1,1,High Risk
60415,40829,46260,40829,70,70,0,1,5,1,0,allow,1,0,Potential Threat
6889,55108,0,0,143,143,0,1,0,1,0,deny,1,1,High Risk
49873,80,19431,80,9540,2954,6586,18,88,8,10,allow,1,0,Potential Threat
51736,34343,51970,34343,70,70,0,1,5,1,0,allow,1,0,Potential Threat
53818,15337,26034,15337,164,70,94,2,4,1,1,allow,1,0,Potential Threat
57095,53,44244,53,170,87,83,2,30,1,1,allow,0,0,Normal
55611,445,0,0,70,70,0,1,0,1,0,drop,0,1,Known Attack
55319,443,12527,443,6210,2720,3490,15,121,7,8,allow,1,0,Potential Threat
60104,80,20513,80,18480,7940,10540,48,71,27,21,allow,1,0,Potential Threat
59637,53,37515,53,273,94,179,2,30,1,1,allow,0,0,Normal
56748,53,37401,53,184,94,90,2,30,1,1,allow,0,0,Normal
39850,53,3565,53,199,94,105,2,29,1,1,allow,0,0,Normal
55730,8060,62180,8060,70,70,0,2,7,2,0,allow,1,0,Potential Threat
57017,53,22107,53,177,94,83,2,30,1,1,allow,0,0,Normal
27617,51505,0,0,146,146,0,1,0,1,0,deny,1,1,High Risk
49709,445,0,0,70,70,0,1,0,1,0,drop,0,1,Known Attack
56478,53,58747,53,200,102,98,2,31,1,1,allow,0,0,Normal
61358,3389,61358,3389,3488,1774,1714,17,33,9,8,allow,1,0,Potential Threat
54324,27016,3441,27016,924,924,0,3,30,3,0,allow,1,0,Potential Threat
1594,44847,0,0,62,62,0,1,0,1,0,deny,1,1,High Risk
51920,80,17031,80,5069,4443,626,11,30,6,5,allow,1,0,Potential Threat
52741,443,63085,443,85011,4398,80613,113,26,52,61,allow,1,0,Potential Threat
14350,56205,0,0,62,62,0,1,0,1,0,deny,1,1,High Risk
49282,53,14515,53,178,94,84,2,30,1,1,allow,0,0,Normal
50455,80,38947,80,4395,3599,796,15,34,8,7,allow,1,0,Potential Threat
49531,26467,0,0,62,62,0,1,0,1,0,deny,0,1,Known Attack
52272,37105,49502,37105,316,136,180,6,6,3,3,allow,1,0,Potential Threat
3697,80,55800,80,6688,1208,5480,20,104,12,8,allow,1,0,Potential Threat
22724,9822,0,0,66,66,0,1,0,1,0,deny,0,1,Known Attack
37567,443,17651,443,499,425,74,4,0,3,1,allow,0,0,Normal
53958,80,17834,80,23134,15926,7208,53,541,32,21,allow,1,0,Potential Threat
50631,443,5471,443,4158,1021,3137,15,26,8,7,allow,1,0,Potential Threat
41320,443,41281,443,1743946,54876,1689070,1870,360,678,1192,allow,1,0,Potential Threat
64831,53,59275,53,216,110,106,2,30,1,1,allow,0,0,Normal
57090,51505,0,0,66,66,0,1,0,1,0,deny,0,1,Known Attack
50040,445,0,0,66,66,0,1,0,1,0,drop,0,1,Known Attack
56853,443,46609,443,7092,1795,5297,25,32,14,11,allow,1,0,Potential Threat
49249,80,49249,80,265842,14126,251716,311,22,136,175,allow,1,0,Potential Threat
56387,53,9036,53,182,93,89,2,31,1,1,allow,0,0,Normal
49560,80,60008,80,318,192,126,6,45,4,2,allow,0,0,Normal
50359,445,0,0,70,70,0,1,0,1,0,drop,0,1,Known Attack
55310,53,54071,53,180,94,86,2,30,1,1,allow,0,0,Normal
49759,53,54195,53,164,84,80,2,31,1,1,allow,0,0,Normal
50477,80,50477,80,20873,1203,19670,30,21,13,17,allow,1,0,Potential Threat
64976,53,22301,53,186,95,91,2,31,1,1,allow,0,0,Normal
49782,80,45830,80,130,70,60,2,15,1,1,allow,0,0,Normal
26406,37965,0,0,66,66,0,1,0,1,0,deny,0,1,Known Attack
57957,80,26267,80,3524,1945,1579,32,131,17,15,allow,1,0,Potential Threat
53531,445,0,0,70,70,0,1,0,1,0,drop,0,1,Known Attack
57344,53,65328,53,177,94,83,2,30,1,1,allow,1,0,Potential Threat
61336,443,63223,443,34919,6979,27940,68,247,27,41,allow,1,0,Potential Threat
50054,53,65410,53,775,103,672,2,31,1,1,allow,1,0,Potential Threat
50352,445,0,0,66,66,0,1,0,1,0,drop,0,1,Known Attack
53023,445,0,0,70,70,0,1,0,1,0,drop,0,1,Known Attack
30303,30303,0,0,181,181,0,1,0,1,0,deny,1,1,High Risk
54912,64147,0,0,66,66,0,1,0,1,0,deny,1,1,High Risk
65191,445,0,0,66,66,0,1,0,1,0,drop,0,1,Known Attack
51904,445,0,0,70,70,0,1,0,1,0,drop,0,1,Known Attack
59752,443,12592,443,304,86,218,2,30,1,1,allow,0,0,Normal
25342,8168,0,0,62,62,0,1,0,1,0,deny,0,1,Known Attack
41620,53,41620,53,257,101,156,2,32,1,1,allow,0,0,Normal
49557,53,33015,53,211,102,109,2,30,1,1,allow,0,0,Normal
54385,53,14777,53,168,78,90,2,30,1,1,allow,0,0,Normal
38545,443,54573,443,4961,2148,2813,30,90,13,17,allow,1,0,Potential Threat
49733,80,1914,80,4198,2450,1748,20,148,15,5,allow,1,0,Potential Threat
55650,53,22960,53,179,94,85,2,31,1,1,allow,0,0,Normal
24037,53415,0,0,76,76,0,1,0,1,0,deny,1,1,High Risk
49527,53,19400,53,200,94,106,2,30,1,1,allow,0,0,Normal
10007,443,53248,443,3811,1846,1965,20,330,9,11,allow,1,0,Potential Threat
63075,445,0,0,70,70,0,1,0,1,0,drop,0,1,Known Attack
57281,53,58597,53,711,87,624,2,31,1,1,allow,0,0,Normal
55043,443,31088,443,11681,3607,8074,40,120,20,20,allow,1,0,Potential Threat
49247,80,49247,80,135755,6750,129005,160,22,68,92,allow,1,0,Potential Threat
49773,445,0,0,70,70,0,1,0,1,0,drop,0,1,Known Attack
49845,445,0,0,70,70,0,1,0,1,0,drop,0,1,Known Attack
44187,53,44187,53,233,90,143,2,32,1,1,allow,0,0,Normal
55167,48817,0,0,66,66,0,1,0,1,0,deny,0,1,Known Attack
60811,40010,33835,40010,316,136,180,6,5,3,3,allow,1,0,Potential Threat
57387,70,0,0,60,60,0,1,0,1,0,deny,0,1,Known Attack
57174,53,49887,53,293,86,207,2,29,1,1,allow,0,0,Normal
8508,23,0,0,60,60,0,1,0,1,0,deny,0,1,Known Attack
44145,443,29432,443,8746,2844,5902,26,315,13,13,allow,1,0,Potential Threat
1053,2310,0,0,148,148,0,1,0,1,0,deny,1,1,High Risk
52196,445,0,0,70,70,0,1,0,1,0,drop,0,1,Known Attack
55955,445,0,0,70,70,0,1,0,1,0,drop,0,1,Known Attack
55049,443,10286,443,12851,3808,9043,30,61,16,14,allow,1,0,Potential Threat
60074,445,0,0,70,70,0,1,0,1,0,drop,0,1,Known Attack
10006,40025,40345,40025,284,190,94,2,29,1,1,allow,1,0,Potential Threat
62888,23,0,0,60,60,0,1,0,1,0,deny,0,1,Known Attack
52726,56205,0,0,66,66,0,1,0,1,0,deny,0,1,Known Attack
30434,53,30434,53,197,90,107,2,30,1,1,allow,0,0,Normal
60428,25174,0,0,66,66,0,1,0,1,0,deny,0,1,Known Attack
49324,443,63452,443,6586,3686,2900,35,75,17,18,allow,1,0,Potential Threat
38768,443,45644,443,7380,3474,3906,18,16,10,8,allow,1,0,Potential Threat
65501,26467,0,0,66,66,0,1,0,1,0,deny,0,1,Known Attack
9176,443,40179,443,6331,837,5494,19,28,10,9,allow,1,0,Potential Threat
50631,80,34721,80,14784,7048,7736,31,27,18,13,allow,1,0,Potential Threat
16387,49252,0,0,60,60,0,1,0,1,0,deny,1,1,High Risk
38759,443,24886,443,7878,1531,6347,36,257,16,20,allow,1,0,Potential Threat
55639,53,59060,53,196,102,94,2,30,1,1,allow,0,0,Normal
49686,80,54142,80,2611,1811,800,13,15,7,6,allow,1,0,Potential Threat
61502,445,0,0,66,66,0,1,0,1,0,drop,0,1,Known Attack
65422,26467,0,0,62,62,0,1,0,1,0,deny,0,1,Known Attack
58463,11392,0,0,66,66,0,1,0,1,0,deny,0,1,Known Attack
58649,443,35795,443,7701,2215,5486,28,373,14,14,allow,1,0,Potential Threat
52040,80,54028,80,366,240,126,7,24,5,2,allow,0,0,Normal
49501,443,9020,443,15456,2581,12875,28,31,10,18,allow,1,0,Potential Threat
42732,53,10027,53,86,86,0,1,30,1,0,allow,0,0,Normal
56424,80,11869,80,17135,1507,15628,24,22,9,15,allow,1,0,Potential Threat
48706,23394,0,0,60,60,0,1,0,1,0,deny,0,1,Known Attack
55318,445,0,0,70,70,0,1,0,1,0,drop,0,1,Known Attack
57642,445,0,0,70,70,0,1,0,1,0,drop,0,1,Known Attack
53803,17637,1467,17637,70,70,0,2,8,2,0,allow,1,0,Potential Threat
49495,443,17412,443,12452,10841,1611,26,27,14,12,allow,1,0,Potential Threat
65416,53,1423,53,758,102,656,2,30,1,1,allow,1,0,Potential Threat
50429,445,0,0,70,70,0,1,0,1,0,drop,0,1,Known Attack
53614,443,10121,443,8347,1979,6368,32,19,17,15,allow,1,0,Potential Threat
40379,53,38675,53,168,78,90,2,30,1,1,allow,0,0,Normal
52167,445,0,0,66,66,0,1,0,1,0,drop,0,1,Known Attack
57437,53,57480,53,193,102,91,2,30,1,1,allow,0,0,Normal
26900,27017,64029,27017,422,164,258,6,30,3,3,allow,1,0,Potential Threat
37876,5900,0,0,60,60,0,1,0,1,0,deny,0,1,Known Attack
49622,53,45379,53,185,102,83,2,30,1,1,allow,0,0,Normal
52209,445,0,0,70,70,0,1,0,1,0,drop,0,1,Known Attack
46495,4607,0,0,60,60,0,1,0,1,0,deny,0,1,Known Attack
55517,53,64032,53,179,94,85,2,29,1,1,allow,1,0,Potential Threat
60117,445,0,0,70,70,0,1,0,1,0,drop,0,1,Known Attack
60619,445,0,0,66,66,0,1,0,1,0,drop,0,1,Known Attack
57564,56205,0,0,66,66,0,1,0,1,0,deny,0,1,Known Attack
56925,445,0,0,66,66,0,1,0,1,0,drop,0,1,Known Attack
56899,53,4081,53,258,102,156,2,30,1,1,allow,0,0,Normal
55055,443,60639,443,14492,3190,11302,34,16,19,15,allow,1,0,Potential Threat
58200,445,0,0,70,70,0,1,0,1,0,drop,0,1,Known Attack
0,0,0,0,156,156,0,2,0,2,0,deny,1,1,High Risk
58459,53,37044,53,307,86,221,2,29,1,1,allow,0,0,Normal
2464,50584,0,0,66,66,0,1,0,1,0,deny,1,1,High Risk
50827,445,0,0,66,66,0,1,0,1,0,drop,0,1,Known Attack
65251,53,54208,53,183,98,85,3,36,2,1,allow,0,0,Normal
49199,8106,41963,8106,370,190,180,6,15,3,3,allow,1,0,Potential Threat
56200,445,0,0,70,70,0,1,0,1,0,drop,0,1,Known Attack
3512,23,0,0,60,60,0,1,0,1,0,deny,1,1,High Risk
51870,445,0,0,66,66,0,1,0,1,0,drop,0,1,Known Attack
57264,53,9791,53,214,102,112,2,30,1,1,allow,0,0,Normal
59368,53,55998,53,241,118,123,2,29,1,1,allow,0,0,Normal
57745,15000,1994,15000,130,70,60,2,5,1,1,allow,1,0,Potential Threat
61059,32480,0,0,146,146,0,1,0,1,0,deny,1,1,High Risk
49296,53,29013,53,186,95,91,2,31,1,1,allow,0,0,Normal
11252,23,0,0,60,60,0,1,0,1,0,deny,0,1,Known Attack
42094,35440,0,0,62,62,0,1,0,1,0,deny,0,1,Known Attack
10072,25174,0,0,146,146,0,1,0,1,0,deny,1,1,High Risk
42727,443,63558,443,4813,970,3843,12,135,6,6,allow,1,0,Potential Threat
64049,1029,38472,1029,66,66,0,2,7,2,0,allow,1,0,Potential Threat
38280,443,38280,443,3333,2072,1261,21,148,12,9,allow,1,0,Potential Threat
49418,27015,24624,27015,78,78,0,1,30,1,0,allow,1,0,Potential Threat
55913,53,2700,53,177,94,83,2,30,1,1,allow,0,0,Normal
63662,445,0,0,70,70,0,1,0,1,0,drop,0,1,Known Attack
49828,53,40540,53,578,286,292,9,15,5,4,allow,0,0,Normal
4447,35440,0,0,66,66,0,1,0,1,0,deny,1,1,High Risk
50065,80,29478,80,4709,4006,703,11,25,6,5,allow,1,0,Potential Threat
18743,53,18743,53,235,90,145,2,31,1,1,allow,0,0,Normal
55591,445,0,0,70,70,0,1,0,1,0,drop,0,1,Known Attack
49556,443,19377,443,198375,6279,192096,205,153,69,136,allow,1,0,Potential Threat
52154,4635,6285,4635,66,66,0,1,5,1,0,allow,0,0,Normal
55484,443,18380,443,782,428,354,12,25,7,5,allow,0,0,Normal
50304,443,23238,443,3565,1947,1618,19,15,9,10,allow,0,0,Normal
56754,53,42272,53,209,110,99,2,30,1,1,allow,0,0,Normal
56558,443,56558,443,4656,1749,2907,19,27,11,8,allow,1,0,Potential Threat
55849,53,3530,53,889,404,485,10,30,5,5,allow,1,0,Potential Threat
63757,51413,7176,51413,66,66,0,2,7,2,0,allow,1,0,Potential Threat
58306,443,59387,443,864,436,428,13,29,7,6,allow,1,0,Potential Threat
44710,443,12033,443,13320,3575,9745,38,26,19,19,allow,1,0,Potential Threat
60114,445,0,0,66,66,0,1,0,1,0,drop,0,1,Known Attack
49998,443,24613,443,24410,6698,17712,32,16,13,19,allow,1,0,Potential Threat
58643,443,8549,443,4801,2506,2295,12,121,6,6,allow,1,0,Potential Threat
47089,15000,57898,15000,138,78,60,2,5,1,1,allow,1,0,Potential Threat
59986,53,15041,53,186,86,100,2,30,1,1,allow,0,0,Normal
64659,445,0,0,70,70,0,1,0,1,0,drop,0,1,Known Attack
55660,443,55660,443,51312,5706,45606,77,48,38,39,allow,1,0,Potential Threat
53819,9472,3134,9472,70,70,0,1,5,1,0,allow,1,0,Potential Threat
49690,53,31414,53,216,110,106,2,30,1,1,allow,0,0,Normal
57594,445,0,0,70,70,0,1,0,1,0,drop,0,1,Known Attack
59352,37965,0,0,66,66,0,1,0,1,0,deny,0,1,Known Attack
59115,445,0,0,70,70,0,1,0,1,0,drop,0,1,Known Attack
5111,53,5111,53,235,90,145,2,33,1,1,allow,1,0,Potential Threat
10532,26672,0,0,60,60,0,1,0,1,0,deny,1,1,High Risk
54994,53,62711,53,209,110,99,2,30,1,1,allow,0,0,Normal
60381,80,60381,80,448865,6437,442428,380,151,67,313,allow,1,0,Potential Threat
60405,443,60867,443,6570,1988,4582,19,57,10,9,allow,1,0,Potential Threat
65507,53,47508,53,167,86,81,2,30,1,1,allow,0,0,Normal
55975,53,49618,53,711,87,624,2,30,1,1,allow,0,0,Normal
57906,443,49224,443,9316,3279,6037,39,186,20,19,allow,1,0,Potential Threat
52288,443,59643,443,38314,11683,26631,76,34,38,38,allow,1,0,Potential Threat
65408,53,49701,53,817,98,719,2,30,1,1,allow,0,0,Normal
25772,7302,0,0,66,66,0,1,0,1,0,deny,0,1,Known Attack
55864,445,0,0,66,66,0,1,0,1,0,drop,0,1,Known Attack
64885,53,64870,53,753,93,660,2,31,1,1,allow,1,0,Potential Threat
57917,44847,0,0,62,62,0,1,0,1,0,deny,0,1,Known Attack
53355,23117,0,0,66,66,0,1,0,1,0,deny,0,1,Known Attack
65239,53,57855,53,489,185,304,6,73,3,3,allow,1,0,Potential Threat
49256,53,11555,53,179,94,85,2,30,1,1,allow,0,0,Normal
46292,42873,0,0,72,72,0,1,0,1,0,deny,0,1,Known Attack
60037,443,34987,443,376301,13445,362856,452,102,198,254,allow,1,0,Potential Threat
56690,445,0,0,66,66,0,1,0,1,0,drop,0,1,Known Attack
55445,53,39762,53,192,192,0,3,46,3,0,allow,0,0,Normal
57470,35988,31535,35988,132,132,0,3,1199,3,0,allow,1,0,Potential Threat
57834,445,0,0,70,70,0,1,0,1,0,drop,0,1,Known Attack
51767,80,59527,80,2169,1263,906,13,75,8,5,allow,1,0,Potential Threat
61386,445,0,0,66,66,0,1,0,1,0,drop,0,1,Known Attack
20741,64147,0,0,62,62,0,1,0,1,0,deny,1,1,High Risk
12318,41864,0,0,139,139,0,1,0,1,0,deny,1,1,High Risk
11777,37965,0,0,62,62,0,1,0,1,0,deny,1,1,High Risk
61299,25174,0,0,146,146,0,1,0,1,0,deny,1,1,High Risk
50478,80,50478,80,2086,1637,449,10,19,6,4,allow,1,0,Potential Threat
28999,37807,0,0,62,62,0,1,0,1,0,deny,0,1,Known Attack
51216,22,51216,22,5806,2153,3653,33,24,18,15,allow,1,0,Potential Threat
51112,445,0,0,66,66,0,1,0,1,0,drop,0,1,Known Attack
53220,80,25607,80,17976,840,17136,21,16,6,15,allow,1,0,Potential Threat
53932,27258,53010,27258,70,70,0,1,5,1,0,allow,1,0,Potential Threat
60471,445,0,0,70,70,0,1,0,1,0,drop,0,1,Known Attack
19747,37965,0,0,62,62,0,1,0,1,0,deny,1,1,High Risk
50738,445,0,0,70,70,0,1,0,1,0,drop,0,1,Known Attack
37513,443,37513,443,4347,1440,2907,19,30,11,8,allow,1,0,Potential Threat
45964,2666,0,0,60,60,0,1,0,1,0,deny,0,1,Known Attack
63904,445,0,0,66,66,0,1,0,1,0,drop,0,1,Known Attack
55072,53,31850,53,168,86,82,2,31,1,1,allow,0,0,Normal
55671,17758,7518,17758,422,140,282,6,15,3,3,allow,1,0,Potential Threat
64808,62413,0,0,62,62,0,1,0,1,0,deny,1,1,High Risk
33534,443,30363,443,4640,1416,3224,18,121,9,9,allow,1,0,Potential Threat
49749,53,60642,53,200,102,98,2,30,1,1,allow,0,0,Normal
53438,443,53438,443,2511,1465,1046,21,102,10,11,allow,1,0,Potential Threat
63888,445,0,0,70,70,0,1,0,1,0,drop,0,1,Known Attack
61148,37965,0,0,66,66,0,1,0,1,0,deny,0,1,Known Attack
60214,80,20902,80,8317,6126,2191,23,151,14,9,allow,1,0,Potential Threat
55311,53,38927,53,298,101,197,4,31,2,2,allow,0,0,Normal
21268,62609,0,0,146,146,0,1,0,1,0,deny,1,1,High Risk
55796,53,36094,53,196,102,94,2,30,1,1,allow,0,0,Normal
26713,64147,0,0,62,62,0,1,0,1,0,deny,1,1,High Risk
27783,57470,0,0,62,62,0,1,0,1,0,deny,1,1,High Risk
49892,53,17000,53,525,110,415,4,43,2,2,allow,0,0,Normal
41840,50584,0,0,66,66,0,1,0,1,0,deny,0,1,Known Attack
58790,445,0,0,70,70,0,1,0,1,0,drop,0,1,Known Attack
59115,443,45739,443,30048,2775,27273,41,137,16,25,allow,1,0,Potential Threat
55933,64097,0,0,62,62,0,1,0,1,0,deny,1,1,High Risk
58686,18375,0,0,66,66,0,1,0,1,0,deny,0,1,Known Attack
51934,443,29764,443,550,310,240,10,35,6,4,allow,0,0,Normal
51592,51505,0,0,62,62,0,1,0,1,0,deny,0,1,Known Attack
54950,445,0,0,70,70,0,1,0,1,0,drop,0,1,Known Attack
35670,443,58907,443,295458,11828,283630,339,185,137,202,allow,1,0,Potential Threat
45314,80,7495,80,72376,2899,69477,79,16,29,50,allow,1,0,Potential Threat
41910,443,63630,443,9358,2304,7054,39,120,20,19,allow,1,0,Potential Threat
50733,445,0,0,66,66,0,1,0,1,0,drop,0,1,Known Attack
65530,445,0,0,66,66,0,1,0,1,0,drop,0,1,Known Attack
443,14591,0,0,131,131,0,1,0,1,0,deny,1,1,High Risk
55596,445,0,0,70,70,0,1,0,1,0,drop,0,1,Known Attack
39799,443,18557,443,5597,3595,2002,42,68,23,19,allow,1,0,Potential Threat
63513,53,63513,53,236,94,142,2,30,1,1,allow,1,0,Potential Threat
49982,37965,0,0,66,66,0,1,0,1,0,deny,0,1,Known Attack
61020,445,0,0,66,66,0,1,0,1,0,drop,0,1,Known Attack
56906,50584,0,0,62,62,0,1,0,1,0,deny,0,1,Known Attack
64636,53,4639,53,325,102,223,2,30,1,1,allow,0,0,Normal
61925,80,57280,80,2418,495,1923,11,125,6,5,allow,1,0,Potential Threat
59897,445,0,0,70,70,0,1,0,1,0,drop,0,1,Known Attack
28221,37965,0,0,62,62,0,1,0,1,0,deny,0,1,Known Attack
1024,44847,0,0,62,62,0,1,0,1,0,deny,1,1,High Risk
29577,64147,0,0,62,62,0,1,0,1,0,deny,1,1,High Risk
55485,53,55524,53,720,94,626,2,29,1,1,allow,0,0,Normal
44893,53,32339,53,199,94,105,2,30,1,1,allow,0,0,Normal
53546,46824,0,0,66,66,0,1,0,1,0,deny,0,1,Known Attack
50971,443,37029,443,469,403,66,4,0,3,1,allow,0,0,Normal
5683,44847,0,0,66,66,0,1,0,1,0,deny,1,1,High Risk
59270,445,0,0,66,66,0,1,0,1,0,drop,0,1,Known Attack
61640,445,0,0,66,66,0,1,0,1,0,drop,0,1,Known Attack
64793,80,12166,80,508,256,252,9,77,5,4,allow,1,0,Potential Threat
61256,445,0,0,66,66,0,1,0,1,0,drop,0,1,Known Attack
53074,445,0,0,70,70,0,1,0,1,0,drop,0,1,Known Attack
49750,80,55648,80,1788,628,1160,11,15,6,5,allow,0,0,Normal
56062,53,55161,53,537,98,439,4,40,2,2,allow,0,0,Normal
64937,445,0,0,66,66,0,1,0,1,0,drop,0,1,Known Attack
64853,53,39005,53,199,102,97,2,30,1,1,allow,0,0,Normal
27005,33035,34801,33035,864,126,738,2,31,1,1,allow,1,0,Potential Threat
51754,445,0,0,70,70,0,1,0,1,0,drop,0,1,Known Attack
63424,445,0,0,70,70,0,1,0,1,0,drop,0,1,Known Attack
35202,443,16914,443,10848,4083,6765,37,16,21,16,allow,1,0,Potential Threat
35377,443,51737,443,15771,2037,13734,39,187,20,19,allow,1,0,Potential Threat
61455,64147,0,0,66,66,0,1,0,1,0,deny,1,1,High Risk
56754,53,65237,53,183,94,89,2,30,1,1,allow,1,0,Potential Threat
56349,53,42172,53,216,110,106,2,29,1,1,allow,0,0,Normal
37168,443,5501,443,4871,923,3948,19,360,10,9,allow,1,0,Potential Threat
56845,445,0,0,70,70,0,1,0,1,0,drop,0,1,Known Attack
60943,445,0,0,70,70,0,1,0,1,0,drop,0,1,Known Attack
59972,443,22705,443,7152,1299,5853,22,16,12,10,allow,1,0,Potential Threat
49893,25174,0,0,66,66,0,1,0,1,0,deny,0,1,Known Attack
51656,80,3808,80,318,192,126,6,37,4,2,allow,0,0,Normal
50180,445,0,0,70,70,0,1,0,1,0,drop,0,1,Known Attack
63596,445,0,0,66,66,0,1,0,1,0,drop,0,1,Known Attack
12338,64147,0,0,66,66,0,1,0,1,0,deny,1,1,High Risk
55144,443,5039,443,3522,869,2653,13,121,6,7,allow,1,0,Potential Threat
49177,53,24852,53,184,94,90,2,30,1,1,allow,0,0,Normal
54684,37965,0,0,62,62,0,1,0,1,0,deny,0,1,Known Attack
44861,443,26247,443,1053,566,487,10,47,6,4,allow,0,0,Normal
63603,445,0,0,70,70,0,1,0,1,0,drop,0,1,Known Attack
53465,443,55749,443,3166,2245,921,15,15,8,7,allow,1,0,Potential Threat
50779,443,64325,443,3247,1630,1617,8,120,4,4,allow,1,0,Potential Threat
33027,161,0,0,15505,6180,9325,50,30,25,25,allow,1,0,Potential Threat
33654,443,14790,443,8628,2898,5730,20,144,9,11,allow,1,0,Potential Threat
50002,443,45848,443,25358,6778,18580,31,16,13,18,allow,1,0,Potential Threat
58457,445,0,0,70,70,0,1,0,1,0,drop,0,1,Known Attack
49234,53,23533,53,206,97,109,2,30,1,1,allow,0,0,Normal
58672,43890,0,0,66,66,0,1,0,1,0,deny,0,1,Known Attack
58638,5900,0,0,62,62,0,1,0,1,0,deny,0,1,Known Attack
64711,53,44473,53,206,105,101,2,31,1,1,allow,0,0,Normal
56804,33375,39167,33375,70,70,0,2,8,2,0,allow,1,0,Potential Threat
61004,445,0,0,66,66,0,1,0,1,0,drop,0,1,Known Attack
34349,25174,0,0,146,146,0,1,0,1,0,deny,1,1,High Risk
12060,37965,0,0,66,66,0,1,0,1,0,deny,1,1,High Risk
50052,65008,0,0,60,60,0,1,0,1,0,deny,1,1,High Risk
36538,64147,0,0,62,62,0,1,0,1,0,deny,1,1,High Risk
57364,53,42885,53,177,94,83,2,29,1,1,allow,0,0,Normal
54446,445,0,0,66,66,0,1,0,1,0,drop,0,1,Known Attack
49160,33586,34033,33586,1377,300,1077,6,1200,3,3,allow,1,0,Potential Threat
50607,445,0,0,66,66,0,1,0,1,0,drop,0,1,Known Attack
59579,445,0,0,66,66,0,1,0,1,0,drop,0,1,Known Attack
39823,36237,0,0,62,62,0,1,0,1,0,deny,0,1,Known Attack
26900,27017,60597,27017,422,164,258,6,31,3,3,allow,1,0,Potential Threat
27005,27015,62179,27015,889,126,763,2,30,1,1,allow,1,0,Potential Threat
55457,53,65037,53,372,126,246,2,29,1,1,allow,1,0,Potential Threat
56496,445,0,0,70,70,0,1,0,1,0,drop,0,1,Known Attack
59877,443,61626,443,9024,1533,7491,25,110,11,14,allow,1,0,Potential Threat
58305,18375,0,0,62,62,0,1,0,1,0,deny,0,1,Known Attack
53453,443,41566,443,6824,2097,4727,19,15,11,8,allow,1,0,Potential Threat
60617,445,0,0,66,66,0,1,0,1,0,drop,0,1,Known Attack
50035,445,0,0,70,70,0,1,0,1,0,drop,0,1,Known Attack
58413,443,5177,443,9371,1936,7435,26,29,14,12,allow,1,0,Potential Threat
51443,443,42123,443,322,262,60,2,15,1,1,allow,0,0,Normal
61355,445,0,0,70,70,0,1,0,1,0,drop,0,1,Known Attack
33948,15503,0,0,146,146,0,1,0,1,0,deny,1,1,High Risk
53857,443,11803,443,499,425,74,4,1,3,1,allow,0,0,Normal
53262,443,28483,443,4385,2869,1516,32,19,18,14,allow,1,0,Potential Threat
55786,53,63117,53,177,94,83,2,29,1,1,allow,1,0,Potential Threat
64196,53,65372,53,262,94,168,2,30,1,1,allow,1,0,Potential Threat
29363,443,29363,443,29861,6027,23834,65,37,34,31,allow,1,0,Potential Threat
1943,48817,0,0,66,66,0,1,0,1,0,deny,1,1,High Risk
50049,445,0,0,70,70,0,1,0,1,0,drop,0,1,Known Attack
1117,37965,0,0,62,62,0,1,0,1,0,deny,1,1,High Risk
61148,445,0,0,66,66,0,1,0,1,0,drop,0,1,Known Attack
44695,53,44695,53,198,89,109,2,30,1,1,allow,0,0,Normal
64999,53,33322,53,178,94,84,2,29,1,1,allow,0,0,Normal
27018,61508,0,0,753,753,0,1,0,1,0,deny,1,1,High Risk
36448,53,11652,53,199,94,105,2,30,1,1,allow,0,0,Normal
13525,51505,0,0,62,62,0,1,0,1,0,deny,1,1,High Risk
35011,37965,0,0,62,62,0,1,0,1,0,deny,0,1,Known Attack
27005,27015,27369,27015,889,126,763,2,30,1,1,allow,1,0,Potential Threat
55027,53,14460,53,177,94,83,2,29,1,1,allow,0,0,Normal
48617,443,54481,443,10802,2841,7961,29,21,14,15,allow,1,0,Potential Threat
54752,31573,0,0,66,66,0,1,0,1,0,deny,0,1,Known Attack
49183,53,38350,53,177,94,83,2,30,1,1,allow,0,0,Normal
49552,53,40374,53,760,97,663,2,31,1,1,allow,0,0,Normal
45987,443,65054,443,3160640,65300,3095340,2786,144,547,2239,allow,1,0,Potential Threat
19394,44847,0,0,66,66,0,1,0,1,0,deny,1,1,High Risk
57431,53,32621,53,178,91,87,2,31,1,1,allow,0,0,Normal
57038,53,2434,53,186,102,84,2,30,1,1,allow,0,0,Normal
37556,16385,7205,16385,432,192,240,8,30,4,4,allow,1,0,Potential Threat
64988,445,0,0,66,66,0,1,0,1,0,drop,0,1,Known Attack
22633,53,0,0,300,90,210,2,30,1,1,allow,0,0,Normal
56094,445,0,0,70,70,0,1,0,1,0,drop,0,1,Known Attack
36696,25174,0,0,62,62,0,1,0,1,0,deny,0,1,Known Attack
49558,53,38507,53,193,102,91,2,29,1,1,allow,0,0,Normal
50390,53,29650,53,772,103,669,2,30,1,1,allow,0,0,Normal
53546,443,23696,443,7268,3166,4102,19,136,10,9,allow,1,0,Potential Threat
45939,5228,13443,5228,7528,1416,6112,29,811,11,18,allow,1,0,Potential Threat
37310,443,2394,443,3950,2949,1001,26,69,15,11,allow,1,0,Potential Threat
38460,443,18587,443,14768,3347,11421,69,1902,32,37,allow,1,0,Potential Threat
54943,443,33087,443,7118,2618,4500,21,30,12,9,allow,1,0,Potential Threat
7347,56205,0,0,66,66,0,1,0,1,0,deny,1,1,High Risk
60752,445,0,0,66,66,0,1,0,1,0,drop,0,1,Known Attack
26180,35440,0,0,66,66,0,1,0,1,0,deny,1,1,High Risk
44319,443,43736,443,13919,3349,10570,46,120,25,21,allow,1,0,Potential Threat
65331,53,63156,53,816,102,714,2,30,1,1,allow,1,0,Potential Threat
20576,37965,0,0,62,62,0,1,0,1,0,deny,1,1,High Risk
56986,53,21320,53,177,94,83,2,31,1,1,allow,0,0,Normal
63262,445,0,0,70,70,0,1,0,1,0,drop,0,1,Known Attack
52772,445,0,0,70,70,0,1,0,1,0,drop,0,1,Known Attack
58844,51505,0,0,66,66,0,1,0,1,0,deny,0,1,Known Attack
64257,53,2954,53,168,86,82,2,30,1,1,allow,0,0,Normal
36631,443,36631,443,4568,1661,2907,19,29,11,8,allow,1,0,Potential Threat
55804,445,0,0,66,66,0,1,0,1,0,drop,0,1,Known Attack
52035,80,61330,80,4185,3462,723,14,15,7,7,allow,1,0,Potential Threat
57470,59216,60669,59216,594,594,0,10,1200,10,0,allow,1,0,Potential Threat
64067,53,26067,53,331,102,229,2,30,1,1,allow,0,0,Normal
55652,443,55652,443,141647,19296,122351,203,55,102,101,allow,1,0,Potential Threat
39672,443,58171,443,6540,5046,1494,19,115,12,7,allow,1,0,Potential Threat
46822,3389,46822,3389,3457,1568,1889,17,21,10,7,allow,1,0,Potential Threat
55538,53,14832,53,195,102,93,2,30,1,1,allow,0,0,Normal
56397,26467,0,0,66,66,0,1,0,1,0,deny,0,1,Known Attack
10775,35440,0,0,62,62,0,1,0,1,0,deny,1,1,High Risk
54889,443,50379,443,4600,2214,2386,13,134,7,6,allow,1,0,Potential Threat
53813,39832,19071,39832,320,140,180,6,5,3,3,allow,1,0,Potential Threat
55396,26467,0,0,62,62,0,1,0,1,0,deny,0,1,Known Attack
61846,445,0,0,70,70,0,1,0,1,0,drop,0,1,Known Attack
51244,16474,0,0,100,100,0,1,0,1,0,deny,0,1,Known Attack
55224,53,26209,53,711,87,624,2,31,1,1,allow,0,0,Normal
56491,443,52771,443,6066,1016,5050,20,26,11,9,allow,1,0,Potential Threat
48206,53,48206,53,253,99,154,2,30,1,1,allow,0,0,Normal
56072,53,60907,53,198,101,97,2,31,1,1,allow,0,0,Normal
64947,53,18048,53,275,96,179,4,41,2,2,allow,0,0,Normal
56282,3389,56282,3389,3425,1470,1955,16,16,8,8,allow,1,0,Potential Threat
53252,443,50911,443,6899,2368,4531,27,27,14,13,allow,1,0,Potential Threat
49520,53,55540,53,229,102,127,2,30,1,1,allow,0,0,Normal
51056,445,0,0,66,66,0,1,0,1,0,drop,0,1,Known Attack
65341,53,7483,53,200,102,98,2,30,1,1,allow,0,0,Normal
49218,445,0,0,70,70,0,1,0,1,0,drop,0,1,Known Attack
47758,443,3505,443,299614,32024,267590,587,115,304,283,allow,1,0,Potential Threat
55871,53,4127,53,177,94,83,2,30,1,1,allow,0,0,Normal
50909,80,20271,80,12826704,145724,12680980,10558,133,2024,8534,allow,1,0,Potential Threat
3117,37965,0,0,62,62,0,1,0,1,0,deny,1,1,High Risk
9120,80,19755,80,326320,11951,314369,346,36,122,224,allow,1,0,Potential Threat
56290,53,40983,53,716,95,621,2,31,1,1,allow,0,0,Normal
56199,53,15227,53,256,93,163,2,31,1,1,allow,0,0,Normal
50652,445,0,0,70,70,0,1,0,1,0,drop,0,1,Known Attack
49445,53,33858,53,770,101,669,2,30,1,1,allow,0,0,Normal
62617,445,0,0,70,70,0,1,0,1,0,drop,0,1,Known Attack
34129,11045,0,0,62,62,0,1,0,1,0,deny,0,1,Known Attack
53725,64147,0,0,66,66,0,1,0,1,0,deny,1,1,High Risk
47828,443,4397,443,512466,48982,463484,912,124,446,466,allow,1,0,Potential Threat
62217,37807,0,0,66,66,0,1,0,1,0,deny,0,1,Known Attack
54601,443,45945,443,28386,15864,12522,59,471,31,28,allow,1,0,Potential Threat
58404,445,0,0,70,70,0,1,0,1,0,drop,0,1,Known Attack
49255,80,49255,80,8453,961,7492,18,20,9,9,allow,1,0,Potential Threat
65260,53,28900,53,184,94,90,2,30,1,1,allow,0,0,Normal
39145,443,40241,443,4602,1305,3297,27,183,12,15,allow,1,0,Potential Threat
56753,80,58241,80,1462,703,759,8,16,5,3,allow,1,0,Potential Threat
62438,445,0,0,70,70,0,1,0,1,0,drop,0,1,Known Attack
62619,3389,62619,3389,3504,1790,1714,17,34,9,8,allow,1,0,Potential Threat
53208,18375,0,0,62,62,0,1,0,1,0,deny,0,1,Known Attack
55678,53,49821,53,270,88,182,4,54,2,2,allow,0,0,Normal
55965,53,22177,53,184,94,90,2,30,1,1,allow,0,0,Normal
52925,443,23150,443,5582,1388,4194,19,15,9,10,allow,0,0,Normal
50375,80,22563,80,350,210,140,6,15,4,2,allow,0,0,Normal
54518,445,0,0,66,66,0,1,0,1,0,drop,0,1,Known Attack
56960,53,22344,53,192,98,94,2,31,1,1,allow,0,0,Normal
59193,445,0,0,70,70,0,1,0,1,0,drop,0,1,Known Attack
64462,53,14604,53,179,94,85,2,29,1,1,allow,0,0,Normal
50584,54321,2526,54321,1275,300,975,6,1200,3,3,allow,1,0,Potential Threat
58923,445,0,0,70,70,0,1,0,1,0,drop,0,1,Known Attack
52703,445,0,0,70,70,0,1,0,1,0,drop,0,1,Known Attack
58016,445,0,0,66,66,0,1,0,1,0,drop,0,1,Known Attack
51320,44847,0,0,66,66,0,1,0,1,0,deny,0,1,Known Attack
51986,445,0,0,66,66,0,1,0,1,0,drop,0,1,Known Attack
65031,53,50837,53,184,94,90,2,30,1,1,allow,0,0,Normal
58638,5900,58638,5900,66,66,0,1,4,1,0,allow,1,0,Potential Threat
62377,443,62377,443,4378,1471,2907,19,27,11,8,allow,1,0,Potential Threat
62394,80,62394,80,29401,10036,19365,49,28,24,25,allow,1,0,Potential Threat
49676,53,40519,53,197,102,95,2,30,1,1,allow,0,0,Normal
50664,445,0,0,70,70,0,1,0,1,0,drop,0,1,Known Attack
64438,53,9645,53,184,94,90,2,29,1,1,allow,0,0,Normal
57340,53,3053,53,747,92,655,2,31,1,1,allow,0,0,Normal
52164,42271,30250,42271,70,70,0,2,8,2,0,allow,1,0,Potential Threat
49896,443,43604,443,5996,976,5020,19,35,10,9,allow,1,0,Potential Threat
29159,39004,0,0,62,62,0,1,0,1,0,deny,1,1,High Risk
49418,27015,41865,27015,242,71,171,2,31,1,1,allow,1,0,Potential Threat
46730,443,28358,443,7648,1671,5977,25,31,13,12,allow,1,0,Potential Threat
53852,443,26865,443,499,425,74,4,0,3,1,allow,0,0,Normal
14397,37965,0,0,62,62,0,1,0,1,0,deny,1,1,High Risk
58343,23718,0,0,66,66,0,1,0,1,0,deny,0,1,Known Attack
32746,50584,0,0,146,146,0,1,0,1,0,deny,1,1,High Risk
63891,51350,44570,51350,312,132,180,6,7,3,3,allow,1,0,Potential Threat
58567,445,0,0,66,66,0,1,0,1,0,drop,0,1,Known Attack
49308,53,35422,53,320,97,223,4,50,2,2,allow,0,0,Normal
62343,445,0,0,70,70,0,1,0,1,0,drop,0,1,Known Attack
56765,443,7248,443,7940,1951,5989,20,15,11,9,allow,1,0,Potential Threat
49650,445,0,0,70,70,0,1,0,1,0,drop,0,1,Known Attack
27321,25174,0,0,62,62,0,1,0,1,0,deny,0,1,Known Attack
42459,22114,0,0,62,62,0,1,0,1,0,deny,0,1,Known Attack
51007,445,0,0,66,66,0,1,0,1,0,drop,0,1,Known Attack
50109,53,42164,53,198,110,88,2,30,1,1,allow,0,0,Normal
64980,53,3433,53,200,102,98,2,30,1,1,allow,0,0,Normal
57140,445,0,0,66,66,0,1,0,1,0,drop,0,1,Known Attack
52018,57866,0,0,66,66,0,1,0,1,0,deny,0,1,Known Attack
56106,53,61650,53,816,102,714,2,30,1,1,allow,1,0,Potential Threat
48706,23393,0,0,60,60,0,1,0,1,0,deny,0,1,Known Attack
63550,80,63550,80,1232,481,751,10,15,5,5,allow,1,0,Potential Threat
80,37649,0,0,60,60,0,1,0,1,0,deny,1,1,High Risk
50470,445,0,0,70,70,0,1,0,1,0,drop,0,1,Known Attack
12299,53,12299,53,229,89,140,2,30,1,1,allow,0,0,Normal
46162,25174,0,0,62,62,0,1,0,1,0,deny,0,1,Known Attack
49257,53,2534,53,198,101,97,2,30,1,1,allow,0,0,Normal
53534,443,20648,443,7639,1831,5808,29,76,15,14,allow,1,0,Potential Threat
55392,53,19876,53,195,102,93,2,31,1,1,allow,0,0,Normal
59162,80,16258,80,1031,314,717,13,175,3,10,allow,1,0,Potential Threat
64614,445,0,0,66,66,0,1,0,1,0,drop,0,1,Known Attack
53863,8999,63067,8999,70,70,0,1,5,1,0,allow,1,0,Potential Threat
63064,445,0,0,70,70,0,1,0,1,0,drop,0,1,Known Attack
55105,53,18912,53,747,93,654,2,31,1,1,allow,0,0,Normal
49323,53,47360,53,196,102,94,2,29,1,1,allow,0,0,Normal
56669,443,61657,443,8058,2038,6020,20,15,11,9,allow,1,0,Potential Threat
54934,445,0,0,70,70,0,1,0,1,0,drop,0,1,Known Attack
63770,24466,46194,24466,312,132,180,6,6,3,3,allow,1,0,Potential Threat
59309,445,0,0,70,70,0,1,0,1,0,drop,0,1,Known Attack
49256,53,12893,53,177,94,83,2,30,1,1,allow,0,0,Normal
54998,53,2972,53,196,100,96,2,31,1,1,allow,0,0,Normal
64980,53,5647,53,200,102,98,2,31,1,1,allow,0,0,Normal
34897,50584,0,0,62,62,0,1,0,1,0,deny,0,1,Known Attack
26752,64147,0,0,62,62,0,1,0,1,0,deny,1,1,High Risk
59404,53,59404,53,237,91,146,2,32,1,1,allow,0,0,Normal
56381,443,16712,443,7236,2290,4946,18,16,11,7,allow,1,0,Potential Threat
1026,64147,0,0,62,62,0,1,0,1,0,deny,1,1,High Risk
62714,445,0,0,70,70,0,1,0,1,0,drop,0,1,Known Attack
49710,53,26259,53,89,89,0,1,30,1,0,allow,0,0,Normal
55083,53,35659,53,216,110,106,2,30,1,1,allow,0,0,Normal
62178,445,0,0,66,66,0,1,0,1,0,drop,0,1,Known Attack
50435,80,28947,80,318,192,126,6,27,4,2,allow,0,0,Normal
53110,8830,31632,8830,70,70,0,2,8,2,0,allow,1,0,Potential Threat
53214,445,0,0,70,70,0,1,0,1,0,drop,0,1,Known Attack
56852,445,0,0,70,70,0,1,0,1,0,drop,0,1,Known Attack
50406,445,0,0,70,70,0,1,0,1,0,drop,0,1,Known Attack
57297,51221,0,0,66,66,0,1,0,1,0,deny,0,1,Known Attack
55868,53,41641,53,177,94,83,2,29,1,1,allow,0,0,Normal
58638,5900,0,0,62,62,0,1,0,1,0,deny,0,1,Known Attack
51787,80,42388,80,26626,1555,25071,36,20,16,20,allow,1,0,Potential Threat
55232,53,8300,53,177,94,83,2,30,1,1,allow,0,0,Normal
59051,27520,0,0,62,62,0,1,0,1,0,deny,0,1,Known Attack
13462,35440,0,0,66,66,0,1,0,1,0,deny,1,1,High Risk
50530,445,0,0,66,66,0,1,0,1,0,drop,0,1,Known Attack
50639,445,0,0,70,70,0,1,0,1,0,drop,0,1,Known Attack
64319,53,34050,53,193,102,91,2,31,1,1,allow,0,0,Normal
53165,18504,45814,18504,70,70,0,2,8,2,0,allow,1,0,Potential Threat
52325,443,52325,443,17806,3169,14637,41,86,18,23,allow,1,0,Potential Threat
50962,53,0,0,229,85,144,2,29,1,1,allow,0,0,Normal
55721,53,57546,53,170,87,83,2,31,1,1,allow,0,0,Normal
44334,26467,0,0,62,62,0,1,0,1,0,deny,0,1,Known Attack
50689,80,50689,80,450,246,204,8,25,5,3,allow,0,0,Normal
6666,138,0,0,60,60,0,1,0,1,0,deny,0,1,Known Attack
28040,64147,0,0,62,62,0,1,0,1,0,deny,1,1,High Risk
62002,445,0,0,70,70,0,1,0,1,0,drop,0,1,Known Attack
49346,53,44128,53,164,78,86,2,31,1,1,allow,0,0,Normal
49632,443,35637,443,5598,1185,4413,24,80,13,11,allow,1,0,Potential Threat
123,123,22929,123,184,94,90,2,29,1,1,allow,1,0,Potential Threat
61148,37965,0,0,66,66,0,1,0,1,0,deny,0,1,Known Attack
49345,443,62638,443,26156,6762,19394,37,16,16,21,allow,1,0,Potential Threat
49499,445,0,0,70,70,0,1,0,1,0,drop,0,1,Known Attack
39599,443,45420,443,1352,691,661,14,18,8,6,allow,1,0,Potential Threat
34316,53,37625,53,168,78,90,2,29,1,1,allow,0,0,Normal
49941,80,49941,80,493003,23995,469008,578,22,246,332,allow,1,0,Potential Threat
54979,53,4787,53,102,102,0,1,59,1,0,allow,0,0,Normal
64034,445,0,0,70,70,0,1,0,1,0,drop,0,1,Known Attack
45944,44847,0,0,62,62,0,1,0,1,0,deny,0,1,Known Attack
60432,80,60432,80,19915,764,19151,23,16,7,16,allow,1,0,Potential Threat
58481,53,42506,53,290,110,180,2,30,1,1,allow,0,0,Normal
64903,53,4073,53,210,110,100,2,30,1,1,allow,0,0,Normal
53986,53,15974,53,102,102,0,1,30,1,0,allow,0,0,Normal
52091,445,0,0,66,66,0,1,0,1,0,drop,0,1,Known Attack
57209,53,54053,53,764,99,665,2,30,1,1,allow,0,0,Normal
52156,445,0,0,66,66,0,1,0,1,0,drop,0,1,Known Attack
443,62451,0,0,199,199,0,1,0,1,0,deny,1,1,High Risk
61563,37807,0,0,62,62,0,1,0,1,0,deny,0,1,Known Attack
55622,33342,63556,33342,70,70,0,2,8,2,0,allow,1,0,Potential Threat
52110,445,0,0,70,70,0,1,0,1,0,drop,0,1,Known Attack
56766,53,15187,53,210,110,100,2,30,1,1,allow,0,0,Normal
50456,53,42563,53,754,94,660,2,30,1,1,allow,0,0,Normal
53734,22051,14778,22051,70,70,0,1,5,1,0,allow,1,0,Potential Threat
65276,445,0,0,66,66,0,1,0,1,0,drop,0,1,Known Attack
64979,53,62369,53,754,94,660,2,30,1,1,allow,1,0,Potential Threat
54539,445,0,0,70,70,0,1,0,1,0,drop,0,1,Known Attack
57470,6889,19938,6889,546,166,380,2,1200,1,1,allow,1,0,Potential Threat
47711,443,57619,443,11793,7188,4605,34,128,17,17,allow,1,0,Potential Threat
64329,53,38742,53,479,111,368,4,50,2,2,allow,0,0,Normal
54633,36237,0,0,66,66,0,1,0,1,0,deny,0,1,Known Attack
65404,53,9178,53,198,110,88,2,30,1,1,allow,0,0,Normal
28498,36237,0,0,62,62,0,1,0,1,0,deny,0,1,Known Attack
57150,53,55226,53,164,84,80,2,30,1,1,allow,0,0,Normal
44129,64147,0,0,145,145,0,1,0,1,0,deny,1,1,High Risk
55715,53,19164,53,168,86,82,2,29,1,1,allow,0,0,Normal
56234,80,56234,80,44817,885,43932,46,15,13,33,allow,1,0,Potential Threat
60412,80,59747,80,958,543,415,11,315,6,5,allow,1,0,Potential Threat
52680,445,0,0,70,70,0,1,0,1,0,drop,0,1,Known Attack
49393,443,42342,443,62,62,0,1,5,1,0,allow,0,0,Normal
50211,445,0,0,70,70,0,1,0,1,0,drop,0,1,Known Attack
51008,445,0,0,70,70,0,1,0,1,0,drop,0,1,Known Attack
61256,443,47931,443,2680,255,2425,9,120,4,5,allow,1,0,Potential Threat
54874,445,0,0,70,70,0,1,0,1,0,drop,0,1,Known Attack
53844,22114,0,0,66,66,0,1,0,1,0,deny,0,1,Known Attack
55767,443,58129,443,1786,172,1614,7,122,3,4,allow,1,0,Potential Threat
52792,445,0,0,70,70,0,1,0,1,0,drop,0,1,Known Attack
49797,53,55138,53,767,102,665,2,31,1,1,allow,0,0,Normal
65406,53,1627,53,102,102,0,1,60,1,0,allow,0,0,Normal
50137,1433,0,0,60,60,0,1,0,1,0,deny,0,1,Known Attack
50378,53,11083,53,199,102,97,2,29,1,1,allow,0,0,Normal
42377,443,33699,443,1622,1137,485,11,26,7,4,allow,1,0,Potential Threat
64644,445,0,0,70,70,0,1,0,1,0,drop,0,1,Known Attack
41170,443,30807,443,8837,1938,6899,21,17,12,9,allow,1,0,Potential Threat
50744,443,22315,443,6854,1380,5474,18,161,9,9,allow,1,0,Potential Threat
53221,445,0,0,66,66,0,1,0,1,0,drop,0,1,Known Attack
65075,53,49710,53,278,100,178,4,30,2,2,allow,0,0,Normal
51283,80,60981,80,1114,534,580,12,16,7,5,allow,1,0,Potential Threat
63278,445,0,0,70,70,0,1,0,1,0,drop,0,1,Known Attack
56219,53,57925,53,177,94,83,2,30,1,1,allow,0,0,Normal
63128,445,0,0,66,66,0,1,0,1,0,drop,0,1,Known Attack
59876,44847,0,0,66,66,0,1,0,1,0,deny,0,1,Known Attack
28742,53,28742,53,365,233,132,3,32,2,1,allow,1,0,Potential Threat
56151,53,10029,53,194,102,92,2,30,1,1,allow,0,0,Normal
19632,37965,0,0,62,62,0,1,0,1,0,deny,1,1,High Risk
65003,57470,0,0,78,78,0,1,0,1,0,deny,1,1,High Risk
34424,443,13536,443,8277,2394,5883,31,316,16,15,allow,1,0,Potential Threat
56080,443,20631,443,3970,1726,2244,13,135,6,7,allow,1,0,Potential Threat
7619,50584,0,0,62,62,0,1,0,1,0,deny,1,1,High Risk
55955,53,53026,53,184,94,90,2,30,1,1,allow,0,0,Normal
55467,53,6293,53,320,95,225,4,41,2,2,allow,0,0,Normal
49671,53,2651,53,166,86,80,2,31,1,1,allow,0,0,Normal
54775,445,0,0,70,70,0,1,0,1,0,drop,0,1,Known Attack
55004,445,0,0,70,70,0,1,0,1,0,drop,0,1,Known Attack
56191,53,1757,53,177,94,83,2,30,1,1,allow,0,0,Normal
23936,41615,0,0,146,146,0,1,0,1,0,deny,1,1,High Risk
49971,53,63730,53,198,102,96,2,30,1,1,allow,1,0,Potential Threat
61523,37807,0,0,66,66,0,1,0,1,0,deny,0,1,Known Attack
1024,50265,0,0,62,62,0,1,0,1,0,deny,1,1,High Risk
38402,443,34859,443,8119,1962,6157,24,360,11,13,allow,1,0,Potential Threat
55490,443,55467,443,3080,1018,2062,10,120,5,5,allow,1,0,Potential Threat
3478,61463,0,0,217,217,0,1,0,1,0,deny,1,1,High Risk
64530,53,55254,53,261,87,174,4,45,2,2,allow,0,0,Normal
58865,443,15727,443,10775,7126,3649,31,17,17,14,allow,1,0,Potential Threat
51094,35440,0,0,62,62,0,1,0,1,0,deny,0,1,Known Attack
51685,57470,0,0,62,62,0,1,0,1,0,deny,0,1,Known Attack
52948,443,49245,443,9629,2119,7510,42,114,20,22,allow,1,0,Potential Threat
60657,445,0,0,70,70,0,1,0,1,0,drop,0,1,Known Attack
60211,443,55686,443,126490514,2726981,123763533,123275,553,41466,81809,allow,1,0,Potential Threat
50562,37965,0,0,62,62,0,1,0,1,0,deny,0,1,Known Attack
64780,53,40708,53,193,102,91,2,31,1,1,allow,0,0,Normal
65115,445,0,0,66,66,0,1,0,1,0,drop,0,1,Known Attack
44808,443,1785,443,22366,9583,12783,50,37,25,25,allow,1,0,Potential Threat
58085,57470,0,0,62,62,0,1,0,1,0,deny,1,1,High Risk
9172,443,4913,443,89362,3092,86270,100,21,37,63,allow,1,0,Potential Threat
55262,53,4967,53,193,102,91,2,30,1,1,allow,0,0,Normal
54989,443,11421,443,34038,16039,17999,79,63,43,36,allow,1,0,Potential Threat
50130,53,10528,53,183,94,89,2,30,1,1,allow,0,0,Normal
39312,443,51370,443,10148,2203,7945,37,120,19,18,allow,1,0,Potential Threat
51802,21555,33946,21555,316,136,180,6,6,3,3,allow,1,0,Potential Threat
50470,80,36047,80,8593,2011,6582,17,23,8,9,allow,1,0,Potential Threat
35554,443,35554,443,4378,1471,2907,19,28,11,8,allow,1,0,Potential Threat
58715,57470,0,0,66,66,0,1,0,1,0,deny,1,1,High Risk
58038,80,30379,80,5029,2608,2421,15,25,9,6,allow,1,0,Potential Threat
30280,37965,0,0,66,66,0,1,0,1,0,deny,0,1,Known Attack
56134,53,19695,53,167,86,81,2,30,1,1,allow,0,0,Normal
45944,443,12806,443,4715,1935,2780,24,183,11,13,allow,1,0,Potential Threat
57862,445,0,0,66,66,0,1,0,1,0,drop,0,1,Known Attack
52132,55014,54625,55014,70,70,0,2,7,2,0,allow,1,0,Potential Threat
48268,443,29893,443,18462,11672,6790,47,63,26,21,allow,1,0,Potential Threat
2704,37,0,0,60,60,0,1,0,1,0,deny,1,1,High Risk
49449,53,11737,53,216,110,106,2,30,1,1,allow,0,0,Normal
59660,445,0,0,70,70,0,1,0,1,0,drop,0,1,Known Attack
49990,445,0,0,66,66,0,1,0,1,0,drop,0,1,Known Attack
22390,19473,0,0,62,62,0,1,0,1,0,deny,0,1,Known Attack
56701,443,57052,443,8007,1987,6020,20,15,11,9,allow,1,0,Potential Threat
63364,57470,0,0,62,62,0,1,0,1,0,deny,1,1,High Risk
42986,25174,0,0,66,66,0,1,0,1,0,deny,0,1,Known Attack
52386,445,0,0,70,70,0,1,0,1,0,drop,0,1,Known Attack
50577,23,0,0,60,60,0,1,0,1,0,deny,0,1,Known Attack
38287,443,17803,443,424,210,214,7,131,4,3,allow,1,0,Potential Threat
62723,445,0,0,70,70,0,1,0,1,0,drop,0,1,Known Attack
56293,53,53120,53,164,84,80,2,31,1,1,allow,0,0,Normal
59287,445,0,0,70,70,0,1,0,1,0,drop,0,1,Known Attack
26900,27017,3690,27017,422,164,258,6,30,3,3,allow,1,0,Potential Threat
49379,53,52143,53,260,102,158,2,30,1,1,allow,0,0,Normal
15345,36829,0,0,62,62,0,1,0,1,0,deny,1,1,High Risk
54325,7000,54325,7000,755529,16895,738634,785,16,264,521,allow,1,0,Potential Threat
65411,53,34611,53,354,102,252,2,30,1,1,allow,0,0,Normal
56968,445,0,0,66,66,0,1,0,1,0,drop,0,1,Known Attack
52514,80,2585,80,3224,2776,448,11,15,7,4,allow,1,0,Potential Threat
64344,53,48570,53,286,102,184,4,46,2,2,allow,0,0,Normal
54489,443,33538,443,4263,2019,2244,14,136,7,7,allow,1,0,Potential Threat
46438,53,32231,53,222,78,144,2,30,1,1,allow,0,0,Normal
47729,443,6419,443,15600,2166,13434,32,205,16,16,allow,1,0,Potential Threat
58922,443,2924,443,14553,9653,4900,38,19,22,16,allow,1,0,Potential Threat
46090,50584,0,0,62,62,0,1,0,1,0,deny,0,1,Known Attack
50124,443,10944,443,48860,5749,43111,91,147,47,44,allow,1,0,Potential Threat
53911,443,57422,443,1346,918,428,10,33,6,4,allow,1,0,Potential Threat
15806,11392,0,0,66,66,0,1,0,1,0,deny,0,1,Known Attack
50046,22114,0,0,66,66,0,1,0,1,0,deny,0,1,Known Attack
55406,25174,0,0,62,62,0,1,0,1,0,deny,0,1,Known Attack
42090,443,46273,443,5041,817,4224,20,373,8,12,allow,1,0,Potential Threat
58151,53,58151,53,241,98,143,2,30,1,1,allow,0,0,Normal
57143,53,42791,53,184,94,90,2,30,1,1,allow,0,0,Normal
42252,33303,0,0,60,60,0,1,0,1,0,deny,0,1,Known Attack
18843,25174,0,0,146,146,0,1,0,1,0,deny,1,1,High Risk
53795,22719,37217,22719,258,70,188,4,8,2,2,allow,1,0,Potential Threat
47256,37807,0,0,62,62,0,1,0,1,0,deny,0,1,Known Attack
56610,80,6975,80,1604,700,904,15,116,7,8,allow,1,0,Potential Threat
22528,25174,0,0,62,62,0,1,0,1,0,deny,0,1,Known Attack
50217,445,0,0,70,70,0,1,0,1,0,drop,0,1,Known Attack
5588,5588,0,0,3498,1872,1626,48,195,24,24,allow,1,0,Potential Threat
9320,443,10901,443,3599,566,3033,15,15,8,7,allow,1,0,Potential Threat
42947,443,14067,443,11377,7703,3674,26,161,19,7,allow,1,0,Potential Threat
64535,53,33577,53,734,86,648,2,31,1,1,allow,0,0,Normal
57237,53,56776,53,701,88,613,2,30,1,1,allow,0,0,Normal
50065,44847,0,0,62,62,0,1,0,1,0,deny,0,1,Known Attack
57444,443,3253,443,9581,3281,6300,36,16,16,20,allow,1,0,Potential Threat
51062,445,0,0,66,66,0,1,0,1,0,drop,0,1,Known Attack
58851,443,28195,443,344,130,214,6,77,3,3,allow,0,0,Normal
50004,443,10108,443,8745,2603,6142,19,15,11,8,allow,1,0,Potential Threat
61418,443,63876,443,7741,1614,6127,21,77,11,10,allow,1,0,Potential Threat
61738,2767,0,0,66,66,0,1,0,1,0,deny,0,1,Known Attack
55126,53,61612,53,193,102,91,2,29,1,1,allow,0,0,Normal
5926,25174,0,0,62,62,0,1,0,1,0,deny,1,1,High Risk
51908,38446,5874,38446,316,136,180,6,6,3,3,allow,1,0,Potential Threat
52117,445,0,0,66,66,0,1,0,1,0,drop,0,1,Known Attack
52329,443,52329,443,4453,1546,2907,21,86,11,10,allow,1,0,Potential Threat
49429,53,19279,53,210,110,100,2,30,1,1,allow,0,0,Normal
51920,443,50819,443,98155,20830,77325,151,103,70,81,allow,1,0,Potential Threat
50341,80,19405,80,306,180,126,6,41,4,2,allow,0,0,Normal
48350,57470,0,0,74,74,0,1,0,1,0,deny,1,1,High Risk
48285,80,8478,80,6713,1736,4977,24,1130,8,16,allow,1,0,Potential Threat
64074,53,3754,53,202,103,99,2,31,1,1,allow,0,0,Normal
58996,445,0,0,70,70,0,1,0,1,0,drop,0,1,Known Attack
57385,53,56308,53,197,102,95,2,30,1,1,allow,0,0,Normal
49418,27015,14560,27015,71,71,0,1,30,1,0,allow,1,0,Potential Threat
56437,53,9819,53,749,94,655,2,30,1,1,allow,0,0,Normal
50542,443,1665,443,5779,1472,4307,22,78,12,10,allow,1,0,Potential Threat
58638,5900,0,0,62,62,0,1,0,1,0,deny,0,1,Known Attack
50830,445,0,0,70,70,0,1,0,1,0,drop,0,1,Known Attack
58014,39004,0,0,62,62,0,1,0,1,0,deny,0,1,Known Attack
38317,443,31937,443,9834,4297,5537,26,326,12,14,allow,1,0,Potential Threat
30578,55783,0,0,145,145,0,1,0,1,0,deny,1,1,High Risk
61987,445,0,0,70,70,0,1,0,1,0,drop,0,1,Known Attack
53589,445,0,0,70,70,0,1,0,1,0,drop,0,1,Known Attack
42380,443,32272,443,1622,1137,485,11,26,7,4,allow,1,0,Potential Threat
49663,445,0,0,70,70,0,1,0,1,0,drop,0,1,Known Attack
58876,443,42159,443,19357,12948,6409,47,18,26,21,allow,1,0,Potential Threat
49907,445,0,0,70,70,0,1,0,1,0,drop,0,1,Known Attack
48785,443,37520,443,6464,1223,5241,25,33,12,13,allow,1,0,Potential Threat
49444,53,27495,53,199,94,105,2,30,1,1,allow,0,0,Normal
49843,53,13877,53,193,102,91,2,30,1,1,allow,0,0,Normal
49161,53,58186,53,168,86,82,2,30,1,1,allow,0,0,Normal
50049,443,21285,443,7912,3269,4643,23,96,12,11,allow,1,0,Potential Threat
50542,443,16831,443,5347,2537,2810,17,120,8,9,allow,1,0,Potential Threat
26698,57470,0,0,62,62,0,1,0,1,0,deny,1,1,High Risk
57572,445,0,0,70,70,0,1,0,1,0,drop,0,1,Known Attack
56192,53,30886,53,177,94,83,2,30,1,1,allow,0,0,Normal
53710,27935,34512,27935,70,70,0,1,4,1,0,allow,1,0,Potential Threat
49117,443,48924,443,9551,2173,7378,33,27,17,16,allow,1,0,Potential Threat
56631,53,31631,53,199,94,105,2,30,1,1,allow,0,0,Normal
52741,24211,0,0,66,66,0,1,0,1,0,deny,0,1,Known Attack
57257,53,41032,53,173,94,79,2,29,1,1,allow,0,0,Normal
50898,445,0,0,70,70,0,1,0,1,0,drop,0,1,Known Attack
54816,53,4342,53,168,78,90,2,30,1,1,allow,0,0,Normal
28331,53,28331,53,213,87,126,2,30,1,1,allow,0,0,Normal
30246,51050,0,0,146,146,0,1,0,1,0,deny,1,1,High Risk
63456,37965,0,0,62,62,0,1,0,1,0,deny,0,1,Known Attack
51923,80,55461,80,60441,6260,54181,79,29,35,44,allow,1,0,Potential Threat
49412,53,45661,53,761,102,659,2,29,1,1,allow,0,0,Normal
44491,50584,0,0,62,62,0,1,0,1,0,deny,0,1,Known Attack
42298,40042,16142,40042,148,86,62,2,30,1,1,allow,1,0,Potential Threat
55594,53,28823,53,168,78,90,2,30,1,1,allow,0,0,Normal
14717,64147,0,0,66,66,0,1,0,1,0,deny,1,1,High Risk
21322,25174,0,0,62,62,0,1,0,1,0,deny,0,1,Known Attack
52361,23718,0,0,66,66,0,1,0,1,0,deny,0,1,Known Attack
55101,53,1606,53,197,102,95,2,30,1,1,allow,0,0,Normal
53243,443,50839,443,242426,7999,234427,277,70,100,177,allow,1,0,Potential Threat
54280,3385,0,0,60,60,0,1,0,1,0,deny,0,1,Known Attack
50037,53,65320,53,195,102,93,2,31,1,1,allow,1,0,Potential Threat
56223,53,26337,53,177,94,83,2,30,1,1,allow,0,0,Normal
53843,443,32315,443,499,425,74,4,0,3,1,allow,0,0,Normal
57172,3389,57172,3389,3347,1458,1889,15,18,8,7,allow,1,0,Potential Threat
64822,53,9057,53,200,94,106,2,30,1,1,allow,0,0,Normal
54621,26296,0,0,145,145,0,1,0,1,0,deny,1,1,High Risk
14082,50584,0,0,62,62,0,1,0,1,0,deny,1,1,High Risk
55232,53,12562,53,177,94,83,2,29,1,1,allow,0,0,Normal
58255,50584,0,0,62,62,0,1,0,1,0,deny,0,1,Known Attack
56953,443,23008,443,66324,17448,48876,86,331,39,47,allow,1,0,Potential Threat
56783,53,7045,53,193,102,91,2,30,1,1,allow,0,0,Normal
64664,53,51475,53,168,86,82,2,34,1,1,allow,0,0,Normal
39054,443,15031,443,7772,4119,3653,31,17,16,15,allow,1,0,Potential Threat
53755,45416,43327,45416,320,140,180,6,6,3,3,allow,1,0,Potential Threat
55600,80,5814,80,70,70,0,1,5,1,0,allow,0,0,Normal
52898,445,0,0,70,70,0,1,0,1,0,drop,0,1,Known Attack
53203,445,0,0,70,70,0,1,0,1,0,drop,0,1,Known Attack
52315,445,0,0,70,70,0,1,0,1,0,drop,0,1,Known Attack
52166,26467,0,0,66,66,0,1,0,1,0,deny,0,1,Known Attack
62405,445,0,0,70,70,0,1,0,1,0,drop,0,1,Known Attack
50246,445,0,0,70,70,0,1,0,1,0,drop,0,1,Known Attack
56637,53,51918,53,214,110,104,2,30,1,1,allow,0,0,Normal
58860,53,53609,53,209,102,107,2,29,1,1,allow,0,0,Normal
8194,21247,0,0,62,62,0,1,0,1,0,deny,0,1,Known Attack
58325,53,35330,53,251,79,172,2,30,1,1,allow,0,0,Normal
61237,445,0,0,70,70,0,1,0,1,0,drop,0,1,Known Attack
3818,37965,0,0,66,66,0,1,0,1,0,deny,1,1,High Risk
49951,80,49951,80,24361943,451235,23910708,22804,63,6533,16271,allow,1,0,Potential Threat
39803,443,33160,443,1701571,69958,1631613,1930,170,782,1148,allow,1,0,Potential Threat
60401,80,25195,80,190,64,126,4,103,2,2,allow,0,0,Normal
56275,53,11893,53,170,87,83,2,30,1,1,allow,0,0,Normal
49625,443,57635,443,4252,726,3526,13,16,7,6,allow,1,0,Potential Threat
53777,445,0,0,70,70,0,1,0,1,0,drop,0,1,Known Attack
34957,80,4367,80,7136,3526,3610,42,1239,21,21,allow,1,0,Potential Threat
38619,443,65221,443,469799,14616,455183,474,129,155,319,allow,1,0,Potential Threat
55033,445,0,0,66,66,0,1,0,1,0,drop,0,1,Known Attack
64770,445,0,0,70,70,0,1,0,1,0,drop,0,1,Known Attack
50557,80,9717,80,318,192,126,6,26,4,2,allow,0,0,Normal
38649,443,32676,443,13463,5427,8036,24,121,11,13,allow,1,0,Potential Threat
51716,445,0,0,70,70,0,1,0,1,0,drop,0,1,Known Attack
37384,443,22279,443,416,210,206,7,29,4,3,allow,0,0,Normal
56317,445,0,0,70,70,0,1,0,1,0,drop,0,1,Known Attack
1024,25174,0,0,62,62,0,1,0,1,0,deny,1,1,High Risk
39313,37965,0,0,62,62,0,1,0,1,0,deny,0,1,Known Attack
61314,23,0,0,60,60,0,1,0,1,0,deny,0,1,Known Attack
61699,445,0,0,70,70,0,1,0,1,0,drop,0,1,Known Attack
56340,53,42393,53,198,102,96,2,30,1,1,allow,0,0,Normal
56738,80,55725,80,1462,703,759,8,16,5,3,allow,0,0,Normal
50516,445,0,0,70,70,0,1,0,1,0,drop,0,1,Known Attack
34391,443,18031,443,80160,3527,76633,98,76,38,60,allow,1,0,Potential Threat
62115,57470,0,0,66,66,0,1,0,1,0,deny,1,1,High Risk
10570,53,10570,53,215,80,135,2,32,1,1,allow,1,0,Potential Threat
55027,53,65292,53,343,86,257,4,58,2,2,allow,1,0,Potential Threat
59855,445,0,0,70,70,0,1,0,1,0,drop,0,1,Known Attack
50372,443,12434,443,456,390,66,4,0,3,1,allow,0,0,Normal
63615,445,0,0,66,66,0,1,0,1,0,drop,0,1,Known Attack
9451,443,45125,443,5699,505,5194,14,15,7,7,allow,1,0,Potential Threat
62736,445,0,0,70,70,0,1,0,1,0,drop,0,1,Known Attack
43584,24748,0,0,156,156,0,1,0,1,0,deny,1,1,High Risk
37330,53,37330,53,237,91,146,2,31,1,1,allow,0,0,Normal
35414,53,44913,53,168,78,90,2,30,1,1,allow,0,0,Normal
53608,445,0,0,66,66,0,1,0,1,0,drop,0,1,Known Attack
49156,53,27997,53,304,118,186,2,30,1,1,allow,0,0,Normal
50039,445,0,0,70,70,0,1,0,1,0,drop,0,1,Known Attack
25237,57470,0,0,62,62,0,1,0,1,0,deny,1,1,High Risk
52190,443,60064,443,570322,21029,549293,569,46,181,388,allow,1,0,Potential Threat
64022,53,64185,53,197,102,95,2,30,1,1,allow,1,0,Potential Threat
53004,80,58597,80,9956,2570,7386,21,335,10,11,allow,1,0,Potential Threat
1024,45129,0,0,145,145,0,1,0,1,0,deny,1,1,High Risk
54458,64147,0,0,62,62,0,1,0,1,0,deny,1,1,High Risk
57643,28189,0,0,60,60,0,1,0,1,0,deny,0,1,Known Attack
56148,37965,0,0,66,66,0,1,0,1,0,deny,0,1,Known Attack
11295,40002,55023,40002,209,85,124,4,54,2,2,allow,1,0,Potential Threat
56901,445,0,0,70,70,0,1,0,1,0,drop,0,1,Known Attack
61230,22114,0,0,66,66,0,1,0,1,0,deny,0,1,Known Attack
60055,445,0,0,70,70,0,1,0,1,0,drop,0,1,Known Attack
12549,50265,0,0,146,146,0,1,0,1,0,deny,1,1,High Risk
57428,443,23700,443,6277,1727,4550,16,75,9,7,allow,1,0,Potential Threat
52952,443,15638,443,9381,3074,6307,47,114,24,23,allow,1,0,Potential Threat
46409,35440,0,0,62,62,0,1,0,1,0,deny,0,1,Known Attack
56822,53,28434,53,184,94,90,2,30,1,1,allow,0,0,Normal
64715,53,60767,53,315,98,217,4,58,2,2,allow,1,0,Potential Threat
65252,53,49878,53,249,102,147,2,30,1,1,allow,0,0,Normal
53832,56005,63005,56005,70,70,0,1,4,1,0,allow,1,0,Potential Threat
51298,57470,0,0,66,66,0,1,0,1,0,deny,0,1,Known Attack
22528,25174,0,0,62,62,0,1,0,1,0,deny,0,1,Known Attack
51731,57470,0,0,78,78,0,1,0,1,0,deny,1,1,High Risk
34531,23117,0,0,62,62,0,1,0,1,0,deny,0,1,Known Attack
54638,36829,0,0,146,146,0,1,0,1,0,deny,1,1,High Risk
64515,53,64413,53,231,86,145,2,30,1,1,allow,1,0,Potential Threat
56715,53,19827,53,184,94,90,2,30,1,1,allow,0,0,Normal
54344,443,13534,443,10015,6047,3968,22,122,12,10,allow,1,0,Potential Threat
56600,445,0,0,70,70,0,1,0,1,0,drop,0,1,Known Attack
60560,445,0,0,70,70,0,1,0,1,0,drop,0,1,Known Attack
56728,443,11785,443,8652,2148,6504,20,15,11,9,allow,1,0,Potential Threat
64814,53,5615,53,243,94,149,2,30,1,1,allow,0,0,Normal
58638,5900,0,0,62,62,0,1,0,1,0,deny,0,1,Known Attack
57662,445,0,0,70,70,0,1,0,1,0,drop,0,1,Known Attack
37651,443,37651,443,4659,1752,2907,19,30,11,8,allow,1,0,Potential Threat
56592,53,24895,53,200,102,98,2,30,1,1,allow,0,0,Normal
40231,443,30990,443,10401,3375,7026,33,22,17,16,allow,1,0,Potential Threat
49420,443,13090,443,5241,1194,4047,19,40,9,10,allow,1,0,Potential Threat
47040,25174,0,0,62,62,0,1,0,1,0,deny,0,1,Known Attack
44603,53,44603,53,229,98,131,2,29,1,1,allow,0,0,Normal
11761,443,11761,443,5626,2487,3139,23,29,14,9,allow,1,0,Potential Threat
49749,80,64733,80,230959,4381,226578,217,91,60,157,allow,1,0,Potential Threat
55201,22114,0,0,66,66,0,1,0,1,0,deny,0,1,Known Attack
33842,53,33842,53,1415,689,726,3,31,2,1,allow,1,0,Potential Threat
49418,27015,10652,27015,224,78,146,2,30,1,1,allow,1,0,Potential Threat
37075,3389,37075,3389,293,223,70,4,1,3,1,reset-both,1,1,High Risk
35667,80,40101,80,1638,1324,314,10,15,5,5,allow,1,0,Potential Threat
33261,443,59567,443,14176,1843,12333,30,201,16,14,allow,1,0,Potential Threat
60000,443,63999,443,1641,730,911,14,18,8,6,allow,1,0,Potential Threat
27005,27015,48788,27015,913,126,787,2,30,1,1,allow,1,0,Potential Threat
60094,445,0,0,70,70,0,1,0,1,0,drop,0,1,Known Attack
51432,80,62424,80,1675,539,1136,8,178,5,3,allow,1,0,Potential Threat
1736,80,1736,80,101959,5508,96451,111,95,41,70,allow,1,0,Potential Threat
51829,36134,0,0,66,66,0,1,0,1,0,deny,0,1,Known Attack
54848,445,0,0,70,70,0,1,0,1,0,drop,0,1,Known Attack
23560,53,25867,53,219,86,133,2,30,1,1,allow,0,0,Normal
53115,445,0,0,66,66,0,1,0,1,0,drop,0,1,Known Attack
50526,445,0,0,66,66,0,1,0,1,0,drop,0,1,Known Attack
60037,443,12655,443,6194,1289,4905,23,66,12,11,allow,1,0,Potential Threat
44839,443,42515,443,308,84,224,4,120,2,2,allow,0,0,Normal
25497,44847,0,0,62,62,0,1,0,1,0,deny,1,1,High Risk
65236,53,36812,53,215,102,113,2,30,1,1,allow,0,0,Normal
55776,53,14354,53,271,93,178,4,31,2,2,allow,0,0,Normal
51839,27256,26214,27256,70,70,0,2,7,2,0,allow,1,0,Potential Threat
53126,443,9290,443,5604,2738,2866,20,325,10,10,allow,1,0,Potential Threat
62232,445,0,0,70,70,0,1,0,1,0,drop,0,1,Known Attack
49903,53,41942,53,194,94,100,2,30,1,1,allow,0,0,Normal
57371,445,0,0,70,70,0,1,0,1,0,drop,0,1,Known Attack
49177,443,60972,443,654956,17062,637894,673,18,244,429,allow,1,0,Potential Threat
61681,443,6029,443,5922,1917,4005,24,18,14,10,allow,1,0,Potential Threat
58771,445,0,0,70,70,0,1,0,1,0,drop,0,1,Known Attack
49464,53,1533,53,213,102,111,2,30,1,1,allow,0,0,Normal
56574,53,4025,53,198,94,104,2,30,1,1,allow,0,0,Normal
55088,445,0,0,70,70,0,1,0,1,0,drop,0,1,Known Attack
56951,53,23495,53,199,102,97,2,30,1,1,allow,0,0,Normal
45401,443,44939,443,9535,3495,6040,18,121,10,8,allow,1,0,Potential Threat
37854,443,37854,443,1452,817,635,16,20,9,7,allow,1,0,Potential Threat
48908,53,48908,53,398,255,143,3,32,2,1,allow,0,0,Normal
55937,53,29379,53,174,89,85,2,0,1,1,allow,0,0,Normal
65298,53,43096,53,246,102,144,2,30,1,1,allow,0,0,Normal
59094,445,0,0,66,66,0,1,0,1,0,drop,0,1,Known Attack
58638,5900,0,0,62,62,0,1,0,1,0,deny,0,1,Known Attack
6881,13929,23344,13929,502,150,352,2,1200,1,1,allow,1,0,Potential Threat
50006,53,55896,53,378,94,284,2,30,1,1,allow,0,0,Normal
59949,80,40471,80,730296,15564,714732,723,57,218,505,allow,1,0,Potential Threat
21064,25174,0,0,146,146,0,1,0,1,0,deny,1,1,High Risk
64926,53,45252,53,257,102,155,2,30,1,1,allow,0,0,Normal
49849,443,49569,443,6117,976,5141,21,72,10,11,allow,1,0,Potential Threat
61375,445,0,0,70,70,0,1,0,1,0,drop,0,1,Known Attack
49954,80,59970,80,10841,821,10020,19,15,9,10,allow,1,0,Potential Threat
49460,445,0,0,66,66,0,1,0,1,0,drop,0,1,Known Attack
49737,443,13001,443,37094,22774,14320,125,27,72,53,allow,1,0,Potential Threat
55038,443,38606,443,30239,8906,21333,61,32,34,27,allow,1,0,Potential Threat
49459,443,42939,443,2572,330,2242,12,135,5,7,allow,1,0,Potential Threat
53234,443,19776,443,21571,8604,12967,38,34,19,19,allow,1,0,Potential Threat
34901,443,15952,443,70,70,0,1,5,1,0,allow,0,0,Normal
19473,20467,44164,20467,480,149,331,2,1200,1,1,allow,1,0,Potential Threat
54316,53,0,0,325,77,248,2,31,1,1,allow,0,0,Normal
56624,53,40354,53,199,102,97,2,29,1,1,allow,0,0,Normal
49355,53,58716,53,193,102,91,2,29,1,1,allow,0,0,Normal
58085,57470,0,0,66,66,0,1,0,1,0,deny,1,1,High Risk
47046,80,21371,80,1114,534,580,12,15,7,5,allow,0,0,Normal
52471,22114,0,0,66,66,0,1,0,1,0,deny,0,1,Known Attack
51313,25174,0,0,62,62,0,1,0,1,0,deny,0,1,Known Attack
60914,53,60914,53,220,100,120,2,31,1,1,allow,0,0,Normal
45551,443,26442,443,7764,1734,6030,23,20,13,10,allow,1,0,Potential Threat
49866,53,19774,53,225,110,115,2,30,1,1,allow,0,0,Normal
58903,80,49363,80,22851,3171,19680,39,147,20,19,allow,1,0,Potential Threat
51801,33531,27515,33531,70,70,0,2,8,2,0,allow,1,0,Potential Threat
64627,53,39841,53,199,102,97,2,31,1,1,allow,0,0,Normal
51505,445,0,0,66,66,0,1,0,1,0,drop,0,1,Known Attack
54894,443,28940,443,9829,2313,7516,37,25,19,18,allow,1,0,Potential Threat
27761,53,27761,53,832,106,726,2,30,1,1,allow,1,0,Potential Threat
57468,57470,0,0,66,66,0,1,0,1,0,deny,1,1,High Risk
1530,62413,0,0,62,62,0,1,0,1,0,deny,1,1,High Risk
61527,443,62594,443,17161,1619,15542,18,143,4,14,allow,1,0,Potential Threat
49415,53,12077,53,313,83,230,4,54,2,2,allow,0,0,Normal
55932,53,12204,53,193,102,91,2,29,1,1,allow,0,0,Normal
57963,445,0,0,70,70,0,1,0,1,0,drop,0,1,Known Attack
55712,53,64759,53,164,86,78,2,30,1,1,allow,1,0,Potential Threat
64145,53,46343,53,177,94,83,2,30,1,1,allow,0,0,Normal
64374,53,45440,53,239,102,137,2,30,1,1,allow,0,0,Normal
42144,30170,0,0,146,146,0,1,0,1,0,deny,1,1,High Risk
50288,445,0,0,66,66,0,1,0,1,0,drop,0,1,Known Attack
57917,443,1119,443,6520,1550,4970,19,54,11,8,allow,1,0,Potential Threat
49479,56205,0,0,66,66,0,1,0,1,0,deny,0,1,Known Attack
50364,445,0,0,70,70,0,1,0,1,0,drop,0,1,Known Attack
443,1340,0,0,85,85,0,1,0,1,0,deny,1,1,High Risk
54051,28793,0,0,66,66,0,1,0,1,0,deny,0,1,Known Attack
30188,49786,29335,49786,502,150,352,2,1200,1,1,allow,1,0,Potential Threat
58267,443,58267,443,4674,1767,2907,19,26,11,8,allow,1,0,Potential Threat
55912,53,3506,53,184,94,90,2,30,1,1,allow,0,0,Normal
52887,37807,0,0,66,66,0,1,0,1,0,deny,0,1,Known Attack
27005,27015,15191,27015,889,126,763,2,30,1,1,allow,1,0,Potential Threat
53246,443,15204,443,134,60,74,3,11,2,1,allow,0,0,Normal
55055,445,0,0,70,70,0,1,0,1,0,drop,0,1,Known Attack
60105,445,0,0,70,70,0,1,0,1,0,drop,0,1,Known Attack
60344,80,63030,80,2005,1094,911,11,87,6,5,allow,1,0,Potential Threat
61745,443,5419,443,8123,5308,2815,18,134,9,9,allow,1,0,Potential Threat
49501,53,44593,53,186,95,91,2,31,1,1,allow,0,0,Normal
49677,25174,0,0,66,66,0,1,0,1,0,deny,0,1,Known Attack
58638,5900,0,0,62,62,0,1,0,1,0,deny,0,1,Known Attack
62971,44847,0,0,66,66,0,1,0,1,0,deny,0,1,Known Attack
56492,53,12334,53,184,94,90,2,29,1,1,allow,0,0,Normal
9412,7302,0,0,66,66,0,1,0,1,0,deny,0,1,Known Attack
52022,445,0,0,66,66,0,1,0,1,0,drop,0,1,Known Attack
62855,445,0,0,70,70,0,1,0,1,0,drop,0,1,Known Attack
55680,23711,23434,23711,70,70,0,2,8,2,0,allow,1,0,Potential Threat
43348,443,43348,443,46356,1595,44761,52,17,15,37,allow,1,0,Potential Threat
3470,53,3470,53,217,82,135,2,32,1,1,allow,1,0,Potential Threat
56023,53,4937,53,338,106,232,4,37,2,2,allow,0,0,Normal
49225,53,59832,53,295,101,194,4,49,2,2,allow,0,0,Normal
60508,55998,14688,55998,70,70,0,2,8,2,0,allow,1,0,Potential Threat
53629,445,0,0,70,70,0,1,0,1,0,drop,0,1,Known Attack
54256,123,0,0,234,234,0,1,0,1,0,deny,0,1,Known Attack
56991,443,56991,443,6305,1352,4953,19,16,10,9,allow,1,0,Potential Threat
54305,26467,0,0,66,66,0,1,0,1,0,deny,0,1,Known Attack
62331,61689,0,0,66,66,0,1,0,1,0,deny,1,1,High Risk
64379,37965,0,0,66,66,0,1,0,1,0,deny,0,1,Known Attack
50667,443,38450,443,8536,2068,6468,36,18,16,20,allow,1,0,Potential Threat
49502,44847,0,0,66,66,0,1,0,1,0,deny,0,1,Known Attack
57947,443,8723,443,2791,1800,991,26,185,15,11,allow,1,0,Potential Threat
1057,57470,0,0,62,62,0,1,0,1,0,deny,1,1,High Risk
58547,445,0,0,70,70,0,1,0,1,0,drop,0,1,Known Attack
52096,445,0,0,70,70,0,1,0,1,0,drop,0,1,Known Attack
52002,80,36032,80,546,300,246,10,24,6,4,allow,0,0,Normal
51185,37965,0,0,66,66,0,1,0,1,0,deny,0,1,Known Attack
59534,53,0,0,627,72,555,2,30,1,1,allow,0,0,Normal
25589,23,0,0,60,60,0,1,0,1,0,deny,0,1,Known Attack
44411,37965,0,0,62,62,0,1,0,1,0,deny,0,1,Known Attack
64981,445,0,0,70,70,0,1,0,1,0,drop,0,1,Known Attack
57993,443,27022,443,8647,1990,6657,23,26,14,9,allow,1,0,Potential Threat
60412,12965,23315,12965,70,70,0,2,8,2,0,allow,1,0,Potential Threat
39839,443,5588,443,5829,1408,4421,21,188,11,10,allow,1,0,Potential Threat
59180,53,28928,53,260,86,174,2,30,1,1,allow,0,0,Normal
64850,53,29250,53,167,86,81,2,30,1,1,allow,0,0,Normal
56459,53,5237,53,177,94,83,2,30,1,1,allow,0,0,Normal
49180,53,37264,53,314,97,217,4,34,2,2,allow,0,0,Normal
42732,57470,0,0,62,62,0,1,0,1,0,deny,0,1,Known Attack
8229,22114,0,0,66,66,0,1,0,1,0,deny,0,1,Known Attack
65518,5710,0,0,62,62,0,1,0,1,0,deny,0,1,Known Attack
56492,53,62080,53,184,94,90,2,30,1,1,allow,0,0,Normal
26953,30317,0,0,62,62,0,1,0,1,0,deny,0,1,Known Attack
56472,80,20215,80,45108,2309,42799,60,134,28,32,allow,1,0,Potential Threat
53437,6057,38097,6057,245,245,0,2,30,2,0,allow,1,0,Potential Threat
55306,53,39881,53,177,94,83,2,30,1,1,allow,0,0,Normal
56406,445,0,0,70,70,0,1,0,1,0,drop,0,1,Known Attack
55348,53,40546,53,184,80,104,2,30,1,1,allow,0,0,Normal
41785,443,3150,443,13183,1682,11501,26,78,12,14,allow,1,0,Potential Threat
64567,53,24261,53,199,102,97,2,30,1,1,allow,0,0,Normal
60419,445,0,0,66,66,0,1,0,1,0,drop,0,1,Known Attack
65334,443,56103,443,3182,1568,1614,8,120,4,4,allow,1,0,Potential Threat
55616,445,0,0,70,70,0,1,0,1,0,drop,0,1,Known Attack
57897,443,36818,443,1865,1226,639,18,176,11,7,allow,1,0,Potential Threat
34209,80,4661,80,1280,586,694,10,14,5,5,allow,1,0,Potential Threat
58638,5900,0,0,62,62,0,1,0,1,0,deny,0,1,Known Attack
54960,53,7818,53,448,184,264,6,30,3,3,allow,0,0,Normal
58783,443,56867,443,5166,700,4466,16,15,7,9,allow,1,0,Potential Threat
58638,5900,0,0,62,62,0,1,0,1,0,deny,0,1,Known Attack
27811,57866,0,0,146,146,0,1,0,1,0,deny,1,1,High Risk
50186,443,57350,443,6363,1073,5290,18,38,10,8,allow,1,0,Potential Threat
54354,443,10906,443,18848,10436,8412,42,33,20,22,allow,1,0,Potential Threat
57448,53,27842,53,177,94,83,2,29,1,1,allow,0,0,Normal
12841,37965,0,0,62,62,0,1,0,1,0,deny,1,1,High Risk
64711,53,52164,53,178,94,84,2,29,1,1,allow,0,0,Normal
49991,80,45821,80,2668,543,2125,12,28,6,6,allow,0,0,Normal
19963,2767,0,0,66,66,0,1,0,1,0,deny,0,1,Known Attack
443,14591,0,0,100,100,0,1,0,1,0,deny,1,1,High Risk
60782,20010,25511,20010,70,70,0,1,5,1,0,allow,1,0,Potential Threat
57470,16414,19962,16414,726,726,0,12,1200,12,0,allow,1,0,Potential Threat
64338,443,59182,443,1786,172,1614,7,120,3,4,allow,1,0,Potential Threat
45767,50584,0,0,146,146,0,1,0,1,0,deny,1,1,High Risk
54973,53,3418,53,308,102,206,2,30,1,1,allow,0,0,Normal
55626,63805,65310,63805,70,70,0,2,8,2,0,allow,1,0,Potential Threat
63590,445,0,0,70,70,0,1,0,1,0,drop,0,1,Known Attack
40781,443,27911,443,362,302,60,2,5,1,1,allow,0,0,Normal
60113,22114,0,0,66,66,0,1,0,1,0,deny,0,1,Known Attack
50472,445,0,0,66,66,0,1,0,1,0,drop,0,1,Known Attack
65077,443,2224,443,6118,5698,420,12,123,6,6,allow,1,0,Potential Threat
29076,53,29076,53,231,90,141,2,31,1,1,allow,0,0,Normal
53591,445,0,0,70,70,0,1,0,1,0,drop,0,1,Known Attack
50137,53,58176,53,183,94,89,2,29,1,1,allow,0,0,Normal
52174,443,52174,443,55503,7279,48224,79,22,32,47,allow,1,0,Potential Threat
57148,445,0,0,66,66,0,1,0,1,0,drop,0,1,Known Attack
50875,445,0,0,66,66,0,1,0,1,0,drop,0,1,Known Attack
64009,53,32252,53,209,110,99,2,30,1,1,allow,0,0,Normal
50697,80,65344,80,318,192,126,6,27,4,2,allow,1,0,Potential Threat
43111,443,29874,443,3117,1867,1250,19,15,9,10,allow,1,0,Potential Threat
59210,8168,0,0,66,66,0,1,0,1,0,deny,0,1,Known Attack
49418,27018,39372,27018,259,71,188,2,31,1,1,allow,1,0,Potential Threat
58597,35440,0,0,66,66,0,1,0,1,0,deny,0,1,Known Attack
52183,443,15080,443,69339,4124,65215,96,22,45,51,allow,1,0,Potential Threat
64530,53,18888,53,261,87,174,4,45,2,2,allow,0,0,Normal
49174,53,58915,53,198,101,97,2,30,1,1,allow,0,0,Normal
51930,443,10848,443,9114,2713,6401,33,82,15,18,allow,1,0,Potential Threat
56185,53,59066,53,216,94,122,2,30,1,1,allow,0,0,Normal
53251,443,53251,443,1404,697,707,17,121,8,9,allow,1,0,Potential Threat
49798,53,59206,53,192,98,94,2,31,1,1,allow,0,0,Normal
51382,56205,0,0,62,62,0,1,0,1,0,deny,0,1,Known Attack
36417,443,45000,443,3579,1914,1665,23,291,8,15,allow,1,0,Potential Threat
54618,445,0,0,70,70,0,1,0,1,0,drop,0,1,Known Attack
55021,445,0,0,70,70,0,1,0,1,0,drop,0,1,Known Attack
49156,443,29780,443,8569,2165,6404,23,34,12,11,allow,1,0,Potential Threat
49214,80,50752,80,2734,1498,1236,21,262,11,10,allow,1,0,Potential Threat
57183,53,6659,53,178,94,84,2,31,1,1,allow,0,0,Normal
55220,53,13554,53,193,102,91,2,30,1,1,allow,0,0,Normal
61287,445,0,0,70,70,0,1,0,1,0,drop,0,1,Known Attack
55461,53,48907,53,198,110,88,2,31,1,1,allow,0,0,Normal
55868,445,0,0,70,70,0,1,0,1,0,drop,0,1,Known Attack
55608,445,0,0,66,66,0,1,0,1,0,drop,0,1,Known Attack
50977,80,25806,80,1111949,11633,1100316,906,37,173,733,allow,1,0,Potential Threat
59877,80,9809,80,1306,557,749,10,25,6,4,allow,1,0,Potential Threat
41485,443,16482,443,29513,23962,5551,40,121,24,16,allow,1,0,Potential Threat
12632,25174,0,0,62,62,0,1,0,1,0,deny,0,1,Known Attack
49992,5900,0,0,60,60,0,1,0,1,0,deny,0,1,Known Attack
60122,445,0,0,66,66,0,1,0,1,0,drop,0,1,Known Attack
44684,443,12133,443,4728,3417,1311,23,35,12,11,allow,1,0,Potential Threat
61261,445,0,0,66,66,0,1,0,1,0,drop,0,1,Known Attack
56465,443,52483,443,6081,844,5237,17,15,9,8,allow,1,0,Potential Threat
55936,53,21289,53,177,94,83,2,30,1,1,allow,0,0,Normal
55222,53,13241,53,181,94,87,2,29,1,1,allow,0,0,Normal
58029,443,3427,443,1312,651,661,13,185,7,6,allow,1,0,Potential Threat
61030,445,0,0,66,66,0,1,0,1,0,drop,0,1,Known Attack
59833,445,0,0,70,70,0,1,0,1,0,drop,0,1,Known Attack
56113,53,45666,53,211,102,109,2,30,1,1,allow,0,0,Normal
49431,53,43013,53,194,102,92,2,30,1,1,allow,0,0,Normal
62961,445,0,0,70,70,0,1,0,1,0,drop,0,1,Known Attack
26053,33720,0,0,160,160,0,1,0,1,0,deny,1,1,High Risk
58856,443,16403,443,4005,1421,2584,14,136,7,7,allow,1,0,Potential Threat
31845,55777,0,0,62,62,0,1,0,1,0,deny,1,1,High Risk
65285,44847,0,0,62,62,0,1,0,1,0,deny,1,1,High Risk
54650,445,0,0,70,70,0,1,0,1,0,drop,0,1,Known Attack
64575,443,61163,443,24686,1935,22751,36,16,17,19,allow,1,0,Potential Threat
56625,443,54912,443,6734,2065,4669,21,16,11,10,allow,1,0,Potential Threat
50016,53,14072,53,766,103,663,4,41,2,2,allow,0,0,Normal
53929,60741,10876,60741,320,140,180,6,6,3,3,allow,1,0,Potential Threat
57689,445,0,0,66,66,0,1,0,1,0,drop,0,1,Known Attack
34228,45129,0,0,148,148,0,1,0,1,0,deny,1,1,High Risk
59486,50584,0,0,62,62,0,1,0,1,0,deny,0,1,Known Attack
37213,36237,0,0,66,66,0,1,0,1,0,deny,0,1,Known Attack
63084,64147,0,0,62,62,0,1,0,1,0,deny,1,1,High Risk
59365,42873,0,0,74,74,0,1,0,1,0,deny,0,1,Known Attack
53282,443,30859,443,1786,172,1614,7,119,3,4,allow,1,0,Potential Threat
60425,80,53766,80,186,64,122,4,28,2,2,allow,0,0,Normal
50255,445,0,0,66,66,0,1,0,1,0,drop,0,1,Known Attack
51426,445,0,0,66,66,0,1,0,1,0,drop,0,1,Known Attack
55708,8060,17338,8060,70,70,0,1,5,1,0,allow,1,0,Potential Threat
64488,445,0,0,66,66,0,1,0,1,0,drop,0,1,Known Attack
46859,50584,0,0,62,62,0,1,0,1,0,deny,0,1,Known Attack
58744,443,27181,443,2576,1549,1027,15,15,7,8,allow,1,0,Potential Threat
53475,3389,0,0,62,62,0,1,0,1,0,deny,0,1,Known Attack
12644,11392,0,0,62,62,0,1,0,1,0,deny,0,1,Known Attack
60800,40010,5284,40010,316,136,180,6,5,3,3,allow,1,0,Potential Threat
5588,5588,0,0,3354,1792,1562,46,192,23,23,allow,1,0,Potential Threat
61836,443,61836,443,132180,4407,127773,146,75,51,95,allow,1,0,Potential Threat
64383,443,47790,443,4017,978,3039,14,53,8,6,allow,1,0,Potential Threat
31727,57470,0,0,62,62,0,1,0,1,0,deny,1,1,High Risk
46713,53,46713,53,217,87,130,2,31,1,1,allow,0,0,Normal
56427,53,59591,53,166,86,80,2,30,1,1,allow,0,0,Normal
32215,22114,0,0,66,66,0,1,0,1,0,deny,0,1,Known Attack
31995,61689,0,0,146,146,0,1,0,1,0,deny,1,1,High Risk
56846,53,22209,53,196,102,94,2,31,1,1,allow,0,0,Normal
13235,44847,0,0,62,62,0,1,0,1,0,deny,1,1,High Risk
54593,445,0,0,66,66,0,1,0,1,0,drop,0,1,Known Attack
50258,445,0,0,70,70,0,1,0,1,0,drop,0,1,Known Attack
50589,53,14237,53,786,110,676,2,30,1,1,allow,0,0,Normal
51514,50584,0,0,62,62,0,1,0,1,0,deny,0,1,Known Attack
33270,80,23251,80,1614,1300,314,10,15,5,5,allow,1,0,Potential Threat
50241,53,50241,53,260,106,154,2,32,1,1,allow,0,0,Normal
63221,53436,0,0,62,62,0,1,0,1,0,deny,1,1,High Risk
64730,53,5756,53,261,94,167,2,30,1,1,allow,0,0,Normal
58897,23,0,0,60,60,0,1,0,1,0,deny,0,1,Known Attack
50950,80,33535,80,942,527,415,11,342,6,5,allow,1,0,Potential Threat
50625,80,24486,80,8688,4248,4440,56,131,34,22,allow,1,0,Potential Threat
12226,37965,0,0,62,62,0,1,0,1,0,deny,1,1,High Risk
51109,11392,0,0,66,66,0,1,0,1,0,deny,0,1,Known Attack
64913,53,45899,53,183,94,89,2,30,1,1,allow,0,0,Normal
63084,53,54059,53,86,86,0,1,30,1,0,allow,0,0,Normal
56367,53,30541,53,194,102,92,2,30,1,1,allow,0,0,Normal
20586,25174,0,0,62,62,0,1,0,1,0,deny,0,1,Known Attack
63228,443,36281,443,3749,2597,1152,25,134,15,10,allow,1,0,Potential Threat
54473,80,28386,80,14035,1381,12654,26,255,14,12,allow,1,0,Potential Threat
52084,30863,64593,30863,70,70,0,2,7,2,0,allow,1,0,Potential Threat
64566,53,50358,53,347,107,240,4,42,2,2,allow,0,0,Normal
43194,32480,0,0,145,145,0,1,0,1,0,deny,1,1,High Risk
58116,445,0,0,66,66,0,1,0,1,0,drop,0,1,Known Attack
62579,57866,0,0,66,66,0,1,0,1,0,deny,1,1,High Risk
56423,443,49453,443,6294,1494,4800,22,17,11,11,allow,1,0,Potential Threat
62749,53,25858,53,184,86,98,2,30,1,1,allow,0,0,Normal
56639,48817,0,0,66,66,0,1,0,1,0,deny,0,1,Known Attack
58997,443,10081,443,70,70,0,1,4,1,0,allow,0,0,Normal
14333,51050,0,0,62,62,0,1,0,1,0,deny,1,1,High Risk
44546,32468,0,0,62,62,0,1,0,1,0,deny,0,1,Known Attack
55391,53,35560,53,210,110,100,2,31,1,1,allow,0,0,Normal
57470,58695,5572,58695,726,726,0,12,1200,12,0,allow,1,0,Potential Threat
56620,53,51991,53,322,110,212,4,30,2,2,allow,0,0,Normal
63982,25174,0,0,66,66,0,1,0,1,0,deny,0,1,Known Attack
54373,26467,0,0,62,62,0,1,0,1,0,deny,0,1,Known Attack
64000,14441,35024,14441,66,66,0,2,7,2,0,allow,1,0,Potential Threat
49320,445,0,0,70,70,0,1,0,1,0,drop,0,1,Known Attack
65024,53,19328,53,199,102,97,2,30,1,1,allow,0,0,Normal
54996,80,15340,80,1979,826,1153,13,17,9,4,allow,0,0,Normal
9445,56205,0,0,66,66,0,1,0,1,0,deny,1,1,High Risk
65174,53,57194,53,214,110,104,2,30,1,1,allow,0,0,Normal
51871,23801,64442,23801,316,136,180,6,6,3,3,allow,1,0,Potential Threat
55445,443,10778,443,1373295,46189,1327106,1448,31,527,921,allow,1,0,Potential Threat
50788,48817,0,0,66,66,0,1,0,1,0,deny,0,1,Known Attack
48817,37028,48817,37028,513,152,361,2,1200,1,1,allow,1,0,Potential Threat
55044,445,0,0,70,70,0,1,0,1,0,drop,0,1,Known Attack
61720,445,0,0,66,66,0,1,0,1,0,drop,0,1,Known Attack
43829,443,59022,443,368,160,208,6,33,3,3,allow,1,0,Potential Threat
56389,53,50951,53,279,93,186,4,32,2,2,allow,0,0,Normal
51881,445,0,0,66,66,0,1,0,1,0,drop,0,1,Known Attack
52975,23718,0,0,66,66,0,1,0,1,0,deny,0,1,Known Attack
51940,445,0,0,66,66,0,1,0,1,0,drop,0,1,Known Attack
57263,53,62100,53,166,85,81,2,30,1,1,allow,0,0,Normal
45470,443,49980,443,1636,827,809,18,43,10,8,allow,1,0,Potential Threat
43032,443,31725,443,6792,3009,3783,20,46,12,8,allow,1,0,Potential Threat
57470,47191,13630,47191,528,528,0,9,1200,9,0,allow,1,0,Potential Threat
25296,51505,0,0,66,66,0,1,0,1,0,deny,1,1,High Risk
63762,41373,27152,41373,70,70,0,1,4,1,0,allow,1,0,Potential Threat
59118,445,0,0,70,70,0,1,0,1,0,drop,0,1,Known Attack
60369,80,60369,80,266818,12375,254443,285,34,107,178,allow,1,0,Potential Threat
65184,53,13116,53,166,86,80,2,30,1,1,allow,0,0,Normal
35722,443,40129,443,13035,2590,10445,27,125,14,13,allow,1,0,Potential Threat
64939,445,0,0,70,70,0,1,0,1,0,drop,0,1,Known Attack
65009,445,0,0,66,66,0,1,0,1,0,drop,0,1,Known Attack
53565,58695,4400,58695,70,70,0,1,5,1,0,allow,1,0,Potential Threat
50810,445,0,0,70,70,0,1,0,1,0,drop,0,1,Known Attack
55049,443,41973,443,5587,3950,1637,26,55,15,11,allow,1,0,Potential Threat
53072,443,53072,443,49826,37097,12729,66,163,40,26,allow,1,0,Potential Threat
59007,443,65066,443,2608,1523,1085,19,15,10,9,allow,1,0,Potential Threat
49622,445,0,0,70,70,0,1,0,1,0,drop,0,1,Known Attack
37965,61282,39357,61282,402,132,270,6,1208,3,3,allow,1,0,Potential Threat
58568,53,2690,53,294,86,208,2,30,1,1,allow,0,0,Normal
56604,443,22617,443,2904,662,2242,13,135,6,7,allow,1,0,Potential Threat
56945,53,12864,53,180,94,86,2,30,1,1,allow,0,0,Normal
45060,37965,0,0,62,62,0,1,0,1,0,deny,0,1,Known Attack
65481,53,28484,53,168,86,82,2,31,1,1,allow,0,0,Normal
59823,443,61551,443,306,180,126,6,29,4,2,allow,1,0,Potential Threat
53939,445,0,0,66,66,0,1,0,1,0,drop,0,1,Known Attack
65073,445,0,0,70,70,0,1,0,1,0,drop,0,1,Known Attack
53233,51221,0,0,66,66,0,1,0,1,0,deny,0,1,Known Attack
49483,53,5607,53,273,94,179,2,30,1,1,allow,0,0,Normal
55859,53,29640,53,210,110,100,2,30,1,1,allow,0,0,Normal
57243,53,64536,53,165,86,79,2,31,1,1,allow,1,0,Potential Threat
49780,53,34638,53,183,94,89,2,29,1,1,allow,0,0,Normal
55479,53,22790,53,184,94,90,2,30,1,1,allow,0,0,Normal
50209,1688,49264,1688,70,70,0,2,8,2,0,allow,0,0,Normal
57389,53,59363,53,186,95,91,2,30,1,1,allow,0,0,Normal
9310,443,7475,443,4458,1022,3436,16,26,9,7,allow,1,0,Potential Threat
53640,25174,0,0,62,62,0,1,0,1,0,deny,0,1,Known Attack
55503,53,54842,53,200,102,98,2,30,1,1,allow,0,0,Normal
47000,53,0,0,82,82,0,1,31,1,0,allow,0,0,Normal
55417,53,13088,53,174,89,85,2,30,1,1,allow,0,0,Normal
63495,50584,0,0,66,66,0,1,0,1,0,deny,1,1,High Risk
38637,22,0,0,60,60,0,1,0,1,0,deny,0,1,Known Attack
63213,445,0,0,70,70,0,1,0,1,0,drop,0,1,Known Attack
26183,22114,0,0,62,62,0,1,0,1,0,deny,0,1,Known Attack
49418,30008,26844,30008,236,78,158,2,30,1,1,allow,1,0,Potential Threat
49706,53,34052,53,296,102,194,4,41,2,2,allow,0,0,Normal
64708,445,0,0,70,70,0,1,0,1,0,drop,0,1,Known Attack
51070,445,0,0,70,70,0,1,0,1,0,drop,0,1,Known Attack
51573,445,0,0,66,66,0,1,0,1,0,drop,0,1,Known Attack
45964,5333,0,0,60,60,0,1,0,1,0,deny,0,1,Known Attack
48286,443,48286,443,4621,1714,2907,19,26,11,8,allow,1,0,Potential Threat
15403,51505,0,0,66,66,0,1,0,1,0,deny,1,1,High Risk
49386,64147,0,0,62,62,0,1,0,1,0,deny,1,1,High Risk
57022,443,20898,443,4228,1470,2758,19,131,9,10,allow,1,0,Potential Threat
53808,443,30751,443,499,425,74,4,0,3,1,allow,0,0,Normal
64876,53,13922,53,718,94,624,2,31,1,1,allow,0,0,Normal
47910,7461,0,0,60,60,0,1,0,1,0,deny,0,1,Known Attack
50527,53,64659,53,969,86,883,2,30,1,1,allow,1,0,Potential Threat
45918,443,28786,443,12351,7584,4767,38,48,22,16,allow,1,0,Potential Threat
64896,53,50820,53,195,94,101,2,30,1,1,allow,0,0,Normal
26450,80,26450,80,642,338,304,10,32,6,4,allow,1,0,Potential Threat
51111,80,8917,80,366,240,126,7,21,5,2,allow,0,0,Normal
52522,445,0,0,66,66,0,1,0,1,0,drop,0,1,Known Attack
53957,35440,0,0,62,62,0,1,0,1,0,deny,0,1,Known Attack
50813,445,0,0,70,70,0,1,0,1,0,drop,0,1,Known Attack
39032,443,17584,443,5819,1571,4248,26,58,14,12,allow,1,0,Potential Threat
47493,53,47493,53,227,92,135,2,31,1,1,allow,0,0,Normal
49897,443,63900,443,113036,13164,99872,191,144,89,102,allow,1,0,Potential Threat
50593,80,24582,80,2365,1068,1297,13,79,7,6,allow,0,0,Normal
53202,443,56977,443,23323,1589,21734,27,85,10,17,allow,1,0,Potential Threat
58610,53,58610,53,244,98,146,2,32,1,1,allow,0,0,Normal
49668,443,64842,443,1288,754,534,13,50,5,8,allow,1,0,Potential Threat
63691,80,13237,80,314,192,122,6,15,4,2,allow,0,0,Normal
64886,445,0,0,70,70,0,1,0,1,0,drop,0,1,Known Attack
51502,80,42285,80,1515,481,1034,11,15,6,5,allow,0,0,Normal
62417,443,4381,443,79513,7480,72033,106,122,39,67,allow,1,0,Potential Threat
59966,37965,0,0,66,66,0,1,0,1,0,deny,0,1,Known Attack
55377,53,45027,53,195,102,93,2,30,1,1,allow,0,0,Normal
59964,443,21876,443,1346200,44765,1301435,1428,128,479,949,allow,1,0,Potential Threat
64482,64147,0,0,66,66,0,1,0,1,0,deny,1,1,High Risk
38922,80,38922,80,20984,1380,19604,34,15,18,16,allow,1,0,Potential Threat
28824,44847,0,0,66,66,0,1,0,1,0,deny,1,1,High Risk
60370,445,0,0,66,66,0,1,0,1,0,drop,0,1,Known Attack
55752,53,35033,53,170,87,83,2,31,1,1,allow,0,0,Normal
50848,445,0,0,66,66,0,1,0,1,0,drop,0,1,Known Attack
50629,443,56409,443,70,70,0,1,5,1,0,allow,0,0,Normal
54367,443,60704,443,5892088,193411,5698677,6287,213,2098,4189,allow,1,0,Potential Threat
64763,53,53321,53,214,110,104,2,30,1,1,allow,0,0,Normal
51313,64147,0,0,62,62,0,1,0,1,0,deny,1,1,High Risk
6843,42873,0,0,62,62,0,1,0,1,0,deny,1,1,High Risk
53427,443,4839,443,9896,2040,7856,34,120,17,17,allow,1,0,Potential Threat
51221,32329,23850,32329,870,330,540,12,1316,6,6,allow,1,0,Potential Threat
55600,22,0,0,60,60,0,1,0,1,0,deny,0,1,Known Attack
64056,51266,3673,51266,66,66,0,1,5,1,0,allow,1,0,Potential Threat
64982,50584,0,0,146,146,0,1,0,1,0,deny,1,1,High Risk
41000,443,2288,443,6237,1811,4426,22,22,12,10,allow,1,0,Potential Threat
55981,80,16434,80,824,469,355,9,360,5,4,allow,1,0,Potential Threat
57032,53,17045,53,166,86,80,2,31,1,1,allow,0,0,Normal
50591,443,54685,443,5611,3452,2159,22,133,13,9,allow,1,0,Potential Threat
53300,443,53300,443,4406,1499,2907,19,30,11,8,allow,1,0,Potential Threat
60466,64337,26945,64337,70,70,0,1,5,1,0,allow,1,0,Potential Threat
61447,445,0,0,70,70,0,1,0,1,0,drop,0,1,Known Attack
6881,6881,30399,6881,238,118,120,2,1199,1,1,allow,1,0,Potential Threat
61222,445,0,0,70,70,0,1,0,1,0,drop,0,1,Known Attack
49884,443,63837,443,5998,978,5020,19,50,10,9,allow,1,0,Potential Threat
58638,5900,0,0,62,62,0,1,0,1,0,deny,0,1,Known Attack
51966,443,48480,443,130,70,60,2,15,1,1,allow,0,0,Normal
49957,80,62910,80,6389,690,5699,16,15,8,8,allow,1,0,Potential Threat
63857,445,0,0,70,70,0,1,0,1,0,drop,0,1,Known Attack
6712,123,0,0,90,90,0,1,0,1,0,deny,0,1,Known Attack
56424,53,21857,53,177,94,83,2,30,1,1,allow,0,0,Normal
64722,53,7575,53,184,94,90,2,30,1,1,allow,0,0,Normal
3964,51505,0,0,62,62,0,1,0,1,0,deny,1,1,High Risk
52439,35894,0,0,70,70,0,1,0,1,0,deny,0,1,Known Attack
58761,445,0,0,66,66,0,1,0,1,0,drop,0,1,Known Attack
60524,64147,0,0,66,66,0,1,0,1,0,deny,1,1,High Risk
51413,443,36557,443,202,70,132,3,11,1,2,allow,0,0,Normal
64934,445,0,0,66,66,0,1,0,1,0,drop,0,1,Known Attack
56366,443,56718,443,7234,4345,2889,27,235,15,12,allow,1,0,Potential Threat
6842,42873,0,0,66,66,0,1,0,1,0,deny,1,1,High Risk
5938,35070,0,0,60,60,0,1,90,1,0,allow,1,0,Potential Threat
35944,23,0,0,60,60,0,1,0,1,0,deny,0,1,Known Attack
64410,445,0,0,70,70,0,1,0,1,0,drop,0,1,Known Attack
51764,33432,19826,33432,70,70,0,2,8,2,0,allow,1,0,Potential Threat
51390,53,51390,53,398,255,143,3,31,2,1,allow,0,0,Normal
54397,445,0,0,70,70,0,1,0,1,0,drop,0,1,Known Attack
49291,443,62267,443,18607,4906,13701,47,255,20,27,allow,1,0,Potential Threat
55715,443,55715,443,4575,1668,2907,19,30,11,8,allow,1,0,Potential Threat
49350,80,49350,80,450,246,204,8,142,5,3,allow,0,0,Normal
55302,445,0,0,70,70,0,1,0,1,0,drop,0,1,Known Attack
50380,443,13367,443,306,180,126,6,25,4,2,allow,0,0,Normal
58553,445,0,0,70,70,0,1,0,1,0,drop,0,1,Known Attack
57068,445,0,0,70,70,0,1,0,1,0,drop,0,1,Known Attack
15503,42638,40530,42638,1367,664,703,16,1200,9,7,allow,1,0,Potential Threat
20892,53,20892,53,825,99,726,2,30,1,1,allow,1,0,Potential Threat
56314,53,21778,53,211,102,109,2,29,1,1,allow,0,0,Normal
42034,28189,0,0,62,62,0,1,0,1,0,deny,0,1,Known Attack
56609,53,42819,53,199,102,97,2,31,1,1,allow,0,0,Normal
64756,11392,0,0,146,146,0,1,0,1,0,deny,0,1,Known Attack
61185,54532,0,0,62,62,0,1,0,1,0,deny,1,1,High Risk
27005,12345,54236,12345,898,126,772,2,30,1,1,allow,1,0,Potential Threat
63978,53,11123,53,212,108,104,2,31,1,1,allow,0,0,Normal
65279,53,57423,53,183,94,89,2,30,1,1,allow,0,0,Normal
39416,443,62311,443,11188,5277,5911,95,587,44,51,allow,1,0,Potential Threat
51414,22,0,0,60,60,0,1,0,1,0,deny,0,1,Known Attack
53828,51354,7216,51354,70,70,0,2,8,2,0,allow,1,0,Potential Threat
56945,53,62206,53,180,94,86,2,30,1,1,allow,0,0,Normal
32342,62413,0,0,66,66,0,1,0,1,0,deny,1,1,High Risk
55384,53,37937,53,188,96,92,2,31,1,1,allow,0,0,Normal
49317,443,8477,443,1486172,26246,1459926,1245,40,266,979,allow,1,0,Potential Threat
59316,443,4398,443,17547,11857,5690,34,159,20,14,allow,1,0,Potential Threat
42776,443,39063,443,4353,687,3666,14,25,8,6,allow,1,0,Potential Threat
60981,445,0,0,70,70,0,1,0,1,0,drop,0,1,Known Attack
59014,443,31435,443,27298,11122,16176,59,31,30,29,allow,1,0,Potential Threat
42490,1433,0,0,60,60,0,1,0,1,0,deny,0,1,Known Attack
60343,80,4297,80,2005,1094,911,11,87,6,5,allow,1,0,Potential Threat
59509,64147,0,0,62,62,0,1,0,1,0,deny,1,1,High Risk
26900,27017,34490,27017,422,164,258,6,30,3,3,allow,1,0,Potential Threat
43704,37965,0,0,66,66,0,1,0,1,0,deny,0,1,Known Attack
29109,11392,0,0,146,146,0,1,0,1,0,deny,1,1,High Risk
46492,50584,0,0,62,62,0,1,0,1,0,deny,0,1,Known Attack
15319,51505,0,0,66,66,0,1,0,1,0,deny,1,1,High Risk
54351,445,0,0,70,70,0,1,0,1,0,drop,0,1,Known Attack
65291,53,53725,53,889,404,485,10,30,5,5,allow,1,0,Potential Threat
60510,445,0,0,70,70,0,1,0,1,0,drop,0,1,Known Attack
60516,445,0,0,66,66,0,1,0,1,0,drop,0,1,Known Attack
57586,445,0,0,66,66,0,1,0,1,0,drop,0,1,Known Attack
52142,54954,50454,54954,70,70,0,2,8,2,0,allow,1,0,Potential Threat
55435,25174,0,0,146,146,0,1,0,1,0,deny,1,1,High Risk
56395,53,34668,53,199,102,97,2,29,1,1,allow,0,0,Normal
55533,80,6176,80,3386,2365,1021,19,39,11,8,allow,1,0,Potential Threat
9473,26467,0,0,66,66,0,1,0,1,0,deny,0,1,Known Attack
51842,27665,50059,27665,70,70,0,1,5,1,0,allow,1,0,Potential Threat
20939,60461,0,0,60,60,0,1,0,1,0,deny,1,1,High Risk
49418,33071,57943,33071,78,78,0,1,30,1,0,allow,1,0,Potential Threat
6882,51508,23505,51508,238,118,120,2,1200,1,1,allow,1,0,Potential Threat
50408,7000,50408,7000,3132,815,2317,14,18,7,7,allow,1,0,Potential Threat
63582,445,0,0,70,70,0,1,0,1,0,drop,0,1,Known Attack
50572,445,0,0,70,70,0,1,0,1,0,drop,0,1,Known Attack
51221,55497,24312,55497,330,330,0,6,1200,6,0,allow,1,0,Potential Threat
65142,53,52457,53,167,86,81,2,30,1,1,allow,0,0,Normal
40360,443,31288,443,3146,766,2380,10,120,5,5,allow,1,0,Potential Threat
9463,443,40374,443,8952,5576,3376,35,38,21,14,allow,1,0,Potential Threat
64554,53,30164,53,94,94,0,1,29,1,0,allow,0,0,Normal
8536,37965,0,0,62,62,0,1,0,1,0,deny,1,1,High Risk
64930,53,64696,53,186,95,91,2,31,1,1,allow,1,0,Potential Threat
5087,22114,0,0,66,66,0,1,0,1,0,deny,1,1,High Risk
50957,445,0,0,70,70,0,1,0,1,0,drop,0,1,Known Attack
49754,445,0,0,70,70,0,1,0,1,0,drop,0,1,Known Attack
50425,53,24348,53,199,102,97,2,30,1,1,allow,0,0,Normal
54013,445,0,0,70,70,0,1,0,1,0,drop,0,1,Known Attack
64886,53,27053,53,295,101,194,4,31,2,2,allow,0,0,Normal
55587,43890,0,0,62,62,0,1,0,1,0,deny,0,1,Known Attack
50210,80,7597,80,1277,460,817,16,71,5,11,allow,1,0,Potential Threat
56192,445,0,0,66,66,0,1,0,1,0,drop,0,1,Known Attack
45238,44847,0,0,62,62,0,1,0,1,0,deny,0,1,Known Attack
32156,51505,0,0,146,146,0,1,0,1,0,deny,1,1,High Risk
55936,53,2278,53,170,87,83,2,30,1,1,allow,0,0,Normal
51968,43622,30970,43622,70,70,0,1,4,1,0,allow,1,0,Potential Threat
46180,1433,0,0,60,60,0,1,0,1,0,deny,0,1,Known Attack
12632,25174,0,0,62,62,0,1,0,1,0,deny,0,1,Known Attack
55688,33958,47150,33958,70,70,0,2,8,2,0,allow,1,0,Potential Threat
6247,51221,0,0,62,62,0,1,0,1,0,deny,1,1,High Risk
39586,22114,0,0,66,66,0,1,0,1,0,deny,0,1,Known Attack
55414,443,59075,443,6053,4104,1949,31,84,17,14,allow,1,0,Potential Threat
58892,443,12440,443,5167,700,4467,16,15,7,9,allow,1,0,Potential Threat
56458,445,0,0,70,70,0,1,0,1,0,drop,0,1,Known Attack
60786,51505,0,0,66,66,0,1,0,1,0,deny,0,1,Known Attack
51320,44847,0,0,66,66,0,1,0,1,0,deny,0,1,Known Attack
64323,53,30451,53,195,102,93,2,31,1,1,allow,0,0,Normal
49418,27015,2773,27015,243,78,165,2,30,1,1,allow,1,0,Potential Threat
50481,443,29111,443,16160,13969,2191,42,80,23,19,allow,1,0,Potential Threat
56079,53,40631,53,199,102,97,2,29,1,1,allow,0,0,Normal
58760,443,37477,443,5927,794,5133,17,25,8,9,allow,1,0,Potential Threat
43024,53,45972,53,198,93,105,2,30,1,1,allow,0,0,Normal
65419,26467,0,0,62,62,0,1,0,1,0,deny,0,1,Known Attack
50222,443,25494,443,178347,31093,147254,290,446,140,150,allow,1,0,Potential Threat
56259,53,56259,53,244,98,146,2,32,1,1,allow,0,0,Normal
54998,53,32757,53,195,102,93,2,29,1,1,allow,0,0,Normal
41876,443,3381,443,55975,2553,53422,72,105,29,43,allow,1,0,Potential Threat
1575,53,0,0,254,86,168,2,30,1,1,allow,1,0,Potential Threat
4752,30188,0,0,62,62,0,1,0,1,0,deny,1,1,High Risk
50672,443,34507,443,6202,1828,4374,25,18,12,13,allow,1,0,Potential Threat
53867,443,58511,443,499,425,74,4,1,3,1,allow,0,0,Normal
44815,443,9189,443,7570,1955,5615,24,1179,12,12,allow,1,0,Potential Threat
59035,445,0,0,66,66,0,1,0,1,0,drop,0,1,Known Attack
56330,53,24669,53,711,87,624,2,30,1,1,allow,0,0,Normal
64862,53,39051,53,211,110,101,2,30,1,1,allow,0,0,Normal
49348,443,47501,443,2879984,113967,2766017,3396,129,1423,1973,allow,1,0,Potential Threat
49355,53,45330,53,184,102,82,2,30,1,1,allow,0,0,Normal
61559,23,0,0,60,60,0,1,0,1,0,deny,0,1,Known Attack
65466,53,26406,53,248,94,154,2,30,1,1,allow,0,0,Normal
27005,27018,60808,27018,881,126,755,2,31,1,1,allow,1,0,Potential Threat
45941,23386,0,0,60,60,0,1,0,1,0,deny,0,1,Known Attack
56167,53,4828,53,178,94,84,2,30,1,1,allow,0,0,Normal
56809,53,56809,53,404,259,145,3,33,2,1,allow,0,0,Normal
52665,445,0,0,66,66,0,1,0,1,0,drop,0,1,Known Attack
62457,7000,62457,7000,3959,1738,2221,15,15,8,7,allow,1,0,Potential Threat
57583,445,0,0,70,70,0,1,0,1,0,drop,0,1,Known Attack
45964,3111,0,0,60,60,0,1,0,1,0,deny,0,1,Known Attack
57297,443,9892,443,5614,733,4881,16,15,9,7,allow,1,0,Potential Threat
47944,50584,0,0,146,146,0,1,0,1,0,deny,1,1,High Risk
51782,10637,45950,10637,66,66,0,1,5,1,0,allow,1,0,Potential Threat
53302,445,0,0,70,70,0,1,0,1,0,drop,0,1,Known Attack
50350,445,0,0,66,66,0,1,0,1,0,drop,0,1,Known Attack
20706,37965,0,0,62,62,0,1,0,1,0,deny,1,1,High Risk
37621,80,10654,80,350,210,140,6,15,4,2,allow,0,0,Normal
48817,49301,48817,49301,490,149,341,2,1200,1,1,allow,1,0,Potential Threat
55760,53,53617,53,180,92,88,2,31,1,1,allow,0,0,Normal
51832,445,0,0,66,66,0,1,0,1,0,drop,0,1,Known Attack
35066,443,6201,443,33823,28233,5590,84,102,47,37,allow,1,0,Potential Threat
27005,37579,44292,37579,886,126,760,2,30,1,1,allow,1,0,Potential Threat
38065,443,63801,443,911697,74083,837614,1247,343,459,788,allow,1,0,Potential Threat
59684,443,44849,443,5173,860,4313,16,15,9,7,allow,1,0,Potential Threat
65017,445,0,0,70,70,0,1,0,1,0,drop,0,1,Known Attack
63321,37807,0,0,66,66,0,1,0,1,0,deny,0,1,Known Attack
62557,445,0,0,70,70,0,1,0,1,0,drop,0,1,Known Attack
52578,445,0,0,70,70,0,1,0,1,0,drop,0,1,Known Attack
26527,25174,0,0,66,66,0,1,0,1,0,deny,0,1,Known Attack
49888,53,39344,53,198,102,96,2,30,1,1,allow,0,0,Normal
62061,53,49325,53,181,78,103,2,30,1,1,allow,0,0,Normal
49567,443,12074,443,6260,3089,3171,27,142,13,14,allow,1,0,Potential Threat
50103,53,21620,53,168,86,82,2,30,1,1,allow,0,0,Normal
49001,22114,0,0,62,62,0,1,0,1,0,deny,0,1,Known Attack
52347,445,0,0,66,66,0,1,0,1,0,drop,0,1,Known Attack
3497,53,3497,53,222,90,132,2,30,1,1,allow,1,0,Potential Threat
46986,443,11457,443,2809,1884,925,19,27,11,8,allow,1,0,Potential Threat
50611,443,62610,443,11152,2086,9066,33,93,17,16,allow,1,0,Potential Threat
49215,53,25508,53,214,102,112,2,30,1,1,allow,0,0,Normal
55300,445,0,0,70,70,0,1,0,1,0,drop,0,1,Known Attack
64287,445,0,0,70,70,0,1,0,1,0,drop,0,1,Known Attack
58007,80,40862,80,318,192,126,6,21,4,2,allow,0,0,Normal
52252,46314,0,0,62,62,0,1,0,1,0,deny,0,1,Known Attack
56927,64147,0,0,145,145,0,1,0,1,0,deny,1,1,High Risk
55272,53,40097,53,599,198,401,6,50,3,3,allow,0,0,Normal
50974,11392,0,0,66,66,0,1,0,1,0,deny,0,1,Known Attack
65245,53,59048,53,193,102,91,2,30,1,1,allow,0,0,Normal
50914,445,0,0,70,70,0,1,0,1,0,drop,0,1,Known Attack
80,61486,0,0,66,66,0,1,0,1,0,deny,1,1,High Risk
9528,44847,0,0,62,62,0,1,0,1,0,deny,1,1,High Risk
34489,35440,0,0,62,62,0,1,0,1,0,deny,0,1,Known Attack
55662,36445,15210,36445,504,318,186,8,17,5,3,allow,1,0,Potential Threat
53660,443,7808,443,9028,3897,5131,24,83,15,9,allow,1,0,Potential Threat
51528,445,0,0,70,70,0,1,0,1,0,drop,0,1,Known Attack
36579,30188,0,0,66,66,0,1,0,1,0,deny,0,1,Known Attack
65085,445,0,0,70,70,0,1,0,1,0,drop,0,1,Known Attack
65463,53,23022,53,177,94,83,2,30,1,1,allow,0,0,Normal
13372,50584,0,0,66,66,0,1,0,1,0,deny,1,1,High Risk
50481,445,0,0,70,70,0,1,0,1,0,drop,0,1,Known Attack
51148,9571,0,0,66,66,0,1,0,1,0,deny,0,1,Known Attack
49218,53,62258,53,190,97,93,2,31,1,1,allow,0,0,Normal
65179,53,56146,53,184,94,90,2,30,1,1,allow,0,0,Normal
61645,443,61645,443,4702,1795,2907,19,28,11,8,allow,1,0,Potential Threat
57040,53,4133,53,810,108,702,2,31,1,1,allow,0,0,Normal
64591,53,55985,53,179,86,93,2,30,1,1,allow,0,0,Normal
52212,51343,6977,51343,70,70,0,2,6,2,0,allow,1,0,Potential Threat
16327,55442,0,0,66,66,0,1,0,1,0,deny,1,1,High Risk
64793,53,25945,53,168,86,82,2,29,1,1,allow,0,0,Normal
52724,80,24269,80,9532,745,8787,18,113,9,9,allow,1,0,Potential Threat
50055,445,0,0,66,66,0,1,0,1,0,drop,0,1,Known Attack
443,9986,0,0,152,152,0,1,0,1,0,deny,1,1,High Risk
56306,15503,0,0,146,146,0,1,0,1,0,deny,0,1,Known Attack
59117,443,59117,443,4659,1752,2907,19,30,11,8,allow,1,0,Potential Threat
34756,443,27102,443,100090,8304,91786,135,127,50,85,allow,1,0,Potential Threat
45844,443,26065,443,44232,11223,33009,97,460,50,47,allow,1,0,Potential Threat
55415,445,0,0,70,70,0,1,0,1,0,drop,0,1,Known Attack
54440,26467,0,0,66,66,0,1,0,1,0,deny,0,1,Known Attack
58638,5900,0,0,62,62,0,1,0,1,0,deny,0,1,Known Attack
45941,23386,0,0,60,60,0,1,0,1,0,deny,0,1,Known Attack
61060,53,61060,53,257,106,151,2,30,1,1,allow,0,0,Normal
57860,445,0,0,70,70,0,1,0,1,0,drop,0,1,Known Attack
3564,57470,0,0,62,62,0,1,0,1,0,deny,1,1,High Risk
54707,445,0,0,70,70,0,1,0,1,0,drop,0,1,Known Attack
60088,443,5059,443,1000,557,443,11,141,6,5,allow,1,0,Potential Threat
64637,53,50285,53,188,96,92,2,30,1,1,allow,0,0,Normal
65308,445,0,0,70,70,0,1,0,1,0,drop,0,1,Known Attack
56528,443,54144,443,8313,3597,4716,16,119,8,8,allow,1,0,Potential Threat
60826,445,0,0,66,66,0,1,0,1,0,drop,0,1,Known Attack
37145,443,8419,443,4578,2334,2244,21,16,12,9,allow,1,0,Potential Threat
57409,53,41368,53,232,94,138,2,30,1,1,allow,0,0,Normal
56780,48298,2043,48298,264,70,194,4,19,1,3,allow,1,0,Potential Threat
56131,53,35553,53,199,94,105,2,29,1,1,allow,0,0,Normal
62453,445,0,0,70,70,0,1,0,1,0,drop,0,1,Known Attack
3478,61463,0,0,1163,1163,0,1,0,1,0,deny,1,1,High Risk
60950,445,0,0,70,70,0,1,0,1,0,drop,0,1,Known Attack
58402,53,52417,53,578,286,292,9,15,5,4,allow,0,0,Normal
60180,31573,0,0,62,62,0,1,0,1,0,deny,0,1,Known Attack
59139,445,0,0,70,70,0,1,0,1,0,drop,0,1,Known Attack
50485,80,52438,80,318,192,126,6,26,4,2,allow,0,0,Normal
57889,443,40826,443,1851,1212,639,18,177,11,7,allow,1,0,Potential Threat
32976,37965,0,0,66,66,0,1,0,1,0,deny,0,1,Known Attack
51897,445,0,0,66,66,0,1,0,1,0,drop,0,1,Known Attack
1972,57470,0,0,78,78,0,1,0,1,0,deny,1,1,High Risk
50090,50265,0,0,62,62,0,1,0,1,0,deny,0,1,Known Attack
58908,443,56510,443,6278402,111931,6166471,5306,1119,732,4574,allow,1,0,Potential Threat
55656,53,48878,53,212,108,104,2,31,1,1,allow,0,0,Normal
51266,16103,36869,16103,70,70,0,1,5,1,0,allow,1,0,Potential Threat
22927,48817,0,0,143,143,0,1,0,1,0,deny,1,1,High Risk
54993,445,0,0,70,70,0,1,0,1,0,drop,0,1,Known Attack
56723,53,3556,53,198,94,104,2,30,1,1,allow,0,0,Normal
64904,53,60868,53,198,101,97,2,31,1,1,allow,0,0,Normal
56229,445,0,0,70,70,0,1,0,1,0,drop,0,1,Known Attack
48150,443,17947,443,502,222,280,8,28,4,4,allow,0,0,Normal
64306,53,34963,53,216,110,106,2,31,1,1,allow,0,0,Normal
26921,37965,0,0,62,62,0,1,0,1,0,deny,0,1,Known Attack
39098,51505,0,0,146,146,0,1,0,1,0,deny,1,1,High Risk
56532,445,0,0,66,66,0,1,0,1,0,drop,0,1,Known Attack
62043,25174,0,0,62,62,0,1,0,1,0,deny,0,1,Known Attack
62189,64147,0,0,62,62,0,1,0,1,0,deny,1,1,High Risk
34070,53,34070,53,250,108,142,2,30,1,1,allow,0,0,Normal
56997,80,45711,80,214,140,74,4,35,3,1,allow,0,0,Normal
37236,53,35776,53,223,78,145,2,30,1,1,allow,0,0,Normal
45941,23386,0,0,60,60,0,1,0,1,0,deny,0,1,Known Attack
5588,5588,0,0,3562,1936,1626,48,195,24,24,allow,1,0,Potential Threat
55685,48407,34505,48407,320,140,180,6,6,3,3,allow,1,0,Potential Threat
49719,443,9783,443,40332,2476,37856,57,130,26,31,allow,1,0,Potential Threat
49506,53,52835,53,200,102,98,2,31,1,1,allow,0,0,Normal
42379,443,23086,443,6598,1506,5092,22,305,12,10,allow,1,0,Potential Threat
55437,445,0,0,66,66,0,1,0,1,0,drop,0,1,Known Attack
11716,37965,0,0,62,62,0,1,0,1,0,deny,1,1,High Risk
52280,44847,0,0,66,66,0,1,0,1,0,deny,0,1,Known Attack
53713,26085,43109,26085,70,70,0,2,7,2,0,allow,1,0,Potential Threat
54986,53,42487,53,214,110,104,2,30,1,1,allow,0,0,Normal
6881,55085,23823,55085,509,150,359,2,1199,1,1,allow,1,0,Potential Threat
49241,53,22091,53,785,110,675,2,30,1,1,allow,0,0,Normal
55806,80,22467,80,1248,755,493,7,81,5,2,allow,1,0,Potential Threat
61791,445,0,0,70,70,0,1,0,1,0,drop,0,1,Known Attack
49687,53,16473,53,197,102,95,2,29,1,1,allow,0,0,Normal
49342,53,2621,53,200,102,98,2,30,1,1,allow,0,0,Normal
58813,80,56191,80,2393,551,1842,10,21,6,4,allow,1,0,Potential Threat
52016,80,9292,80,124703,6134,118569,147,125,64,83,allow,1,0,Potential Threat
3478,61463,0,0,1188,1188,0,1,0,1,0,deny,1,1,High Risk
63068,445,0,0,70,70,0,1,0,1,0,drop,0,1,Known Attack
51090,53,42988,53,164,78,86,2,30,1,1,allow,0,0,Normal
52401,445,0,0,70,70,0,1,0,1,0,drop,0,1,Known Attack
21173,37965,0,0,62,62,0,1,0,1,0,deny,1,1,High Risk
9126,80,52469,80,318,192,126,6,30,4,2,allow,1,0,Potential Threat
26180,35440,0,0,66,66,0,1,0,1,0,deny,1,1,High Risk
51991,56980,61136,56980,316,136,180,6,7,3,3,allow,1,0,Potential Threat
30598,37965,0,0,62,62,0,1,0,1,0,deny,0,1,Known Attack
52154,4635,63801,4635,70,70,0,2,8,2,0,allow,1,0,Potential Threat
50340,445,0,0,70,70,0,1,0,1,0,drop,0,1,Known Attack
36099,443,35934,443,5901,1324,4577,25,50,14,11,allow,1,0,Potential Threat
52956,443,14626,443,15659,3294,12365,60,114,25,35,allow,1,0,Potential Threat
64128,53,32109,53,186,95,91,2,30,1,1,allow,0,0,Normal
52907,80,17763,80,1659,653,1006,10,16,6,4,allow,0,0,Normal
50159,53,16650,53,94,94,0,1,29,1,0,allow,0,0,Normal
9373,80,65080,80,1643,485,1158,10,15,5,5,allow,1,0,Potential Threat
53756,445,0,0,66,66,0,1,0,1,0,drop,0,1,Known Attack
36767,53,36767,53,237,93,144,2,31,1,1,allow,0,0,Normal
53762,53,52593,53,168,78,90,2,30,1,1,allow,0,0,Normal
54627,80,54627,80,12385,1831,10554,20,20,9,11,allow,1,0,Potential Threat
48929,62609,0,0,148,148,0,1,0,1,0,deny,1,1,High Risk
50642,443,51887,443,10981,2295,8686,32,63,16,16,allow,1,0,Potential Threat
52515,80,55752,80,4183,3603,580,14,15,8,6,allow,1,0,Potential Threat
53756,50584,0,0,66,66,0,1,0,1,0,deny,0,1,Known Attack
49603,443,57719,443,11841,1700,10141,37,195,16,21,allow,1,0,Potential Threat
58638,5900,58638,5900,62,62,0,1,5,1,0,allow,1,0,Potential Threat
63820,27441,36322,27441,66,66,0,2,7,2,0,allow,1,0,Potential Threat
49349,80,49349,80,450,246,204,8,141,5,3,allow,0,0,Normal
10151,6881,61137,6881,469,150,319,2,1200,1,1,allow,1,0,Potential Threat
48604,53,57366,53,164,78,86,2,30,1,1,allow,0,0,Normal
53430,443,50940,443,4383,2064,2319,11,120,6,5,allow,1,0,Potential Threat
54981,443,51323,443,36008,2548,33460,55,69,26,29,allow,1,0,Potential Threat
51793,12210,40752,12210,70,70,0,2,8,2,0,allow,1,0,Potential Threat
65249,53,14438,53,1579,94,1485,4,36,2,2,allow,1,0,Potential Threat
41418,443,15753,443,6670,1576,5094,23,200,13,10,allow,1,0,Potential Threat
6881,6881,43994,6881,502,150,352,2,1200,1,1,allow,1,0,Potential Threat
61085,37965,0,0,62,62,0,1,0,1,0,deny,0,1,Known Attack
60290,80,20522,80,1366,785,581,11,145,6,5,allow,1,0,Potential Threat
56792,42155,44462,42155,70,70,0,1,5,1,0,allow,1,0,Potential Threat
8889,33698,0,0,60,60,0,1,0,1,0,deny,1,1,High Risk
58843,445,0,0,66,66,0,1,0,1,0,drop,0,1,Known Attack
42685,51180,0,0,62,62,0,1,0,1,0,deny,0,1,Known Attack
49341,53,21121,53,392,86,306,2,29,1,1,allow,0,0,Normal
53746,36237,0,0,66,66,0,1,0,1,0,deny,0,1,Known Attack
56754,443,40687,443,9868,2027,7841,24,20,12,12,allow,1,0,Potential Threat
56652,443,7084,443,8006,1986,6020,20,15,11,9,allow,1,0,Potential Threat
56940,5900,0,0,60,60,0,1,0,1,0,deny,0,1,Known Attack
34400,39004,0,0,74,74,0,1,0,1,0,deny,0,1,Known Attack
42298,40029,56928,40029,208,86,122,4,29,2,2,allow,1,0,Potential Threat
57639,445,0,0,70,70,0,1,0,1,0,drop,0,1,Known Attack
55600,22,0,0,60,60,0,1,0,1,0,deny,0,1,Known Attack
59847,445,0,0,70,70,0,1,0,1,0,drop,0,1,Known Attack
52141,443,17579,443,15637,4217,11420,42,83,19,23,allow,1,0,Potential Threat
64599,445,0,0,66,66,0,1,0,1,0,drop,0,1,Known Attack
55712,27816,8971,27816,316,190,126,5,16,3,2,allow,1,0,Potential Threat
56410,445,0,0,66,66,0,1,0,1,0,drop,0,1,Known Attack
54894,9571,0,0,66,66,0,1,0,1,0,deny,0,1,Known Attack
10754,28793,0,0,62,62,0,1,0,1,0,deny,1,1,High Risk
49918,53,55343,53,396,88,308,4,59,2,2,allow,0,0,Normal
64537,443,9854,443,3182,1568,1614,8,120,4,4,allow,1,0,Potential Threat
60155,23718,0,0,66,66,0,1,0,1,0,deny,0,1,Known Attack
23274,50584,0,0,146,146,0,1,0,1,0,deny,1,1,High Risk
52258,58792,14441,58792,316,136,180,6,8,3,3,allow,1,0,Potential Threat
52251,443,26101,443,23328780,730794,22597986,24754,320,8113,16641,allow,1,0,Potential Threat
52097,443,17045,443,7246,3017,4229,21,15,11,10,allow,1,0,Potential Threat
21133,6085,5257,6085,481,150,331,2,1199,1,1,allow,1,0,Potential Threat
44411,37965,0,0,62,62,0,1,0,1,0,deny,0,1,Known Attack
50332,53,12740,53,193,102,91,2,29,1,1,allow,0,0,Normal
12545,25174,0,0,62,62,0,1,0,1,0,deny,0,1,Known Attack
55617,53,46139,53,214,110,104,2,30,1,1,allow,0,0,Normal
15319,51505,0,0,62,62,0,1,0,1,0,deny,1,1,High Risk
15503,36501,26789,36501,323,150,173,2,1201,1,1,allow,1,0,Potential Threat
57351,53,48992,53,177,94,83,2,30,1,1,allow,0,0,Normal
53522,24116,50290,24116,70,70,0,1,4,1,0,allow,1,0,Potential Threat
30179,57470,0,0,60,60,0,1,0,1,0,deny,1,1,High Risk
55423,53,61643,53,711,87,624,2,31,1,1,allow,1,0,Potential Threat
55413,37965,0,0,62,62,0,1,0,1,0,deny,0,1,Known Attack
65511,53,22579,53,545,136,409,4,56,2,2,allow,0,0,Normal
49501,53,50538,53,229,110,119,2,30,1,1,allow,0,0,Normal
50411,53,28874,53,86,86,0,1,30,1,0,allow,0,0,Normal
54402,445,0,0,70,70,0,1,0,1,0,drop,0,1,Known Attack
64790,445,0,0,66,66,0,1,0,1,0,drop,0,1,Known Attack
58638,5900,0,0,62,62,0,1,0,1,0,deny,0,1,Known Attack
43477,443,38784,443,20739,7254,13485,97,734,44,53,allow,1,0,Potential Threat
56046,53,22169,53,289,160,129,3,29,2,1,allow,0,0,Normal
63085,445,0,0,70,70,0,1,0,1,0,drop,0,1,Known Attack
50023,443,17571,443,70,70,0,2,5,2,0,allow,0,0,Normal
61644,445,0,0,66,66,0,1,0,1,0,drop,0,1,Known Attack
55317,53,36634,53,711,87,624,2,31,1,1,allow,0,0,Normal
49319,53,39564,53,199,102,97,2,29,1,1,allow,0,0,Normal
38433,443,38484,443,33344,25806,7538,105,130,56,49,allow,1,0,Potential Threat
62277,445,0,0,70,70,0,1,0,1,0,drop,0,1,Known Attack
47836,443,38604,443,36324,2308,34016,55,81,22,33,allow,1,0,Potential Threat
52031,20301,50759,20301,66,66,0,1,5,1,0,allow,1,0,Potential Threat
52077,445,0,0,70,70,0,1,0,1,0,drop,0,1,Known Attack
50102,17546,0,0,66,66,0,1,0,1,0,deny,0,1,Known Attack
49450,53,27588,53,227,94,133,2,29,1,1,allow,0,0,Normal
9136,80,1532,80,908,842,66,7,15,6,1,allow,1,0,Potential Threat
53371,445,0,0,66,66,0,1,0,1,0,drop,0,1,Known Attack
49856,443,13732,443,18685,4528,14157,31,151,13,18,allow,1,0,Potential Threat
57163,443,13914,443,1779,1375,404,11,40,5,6,allow,0,0,Normal
55084,53,64405,53,177,94,83,2,29,1,1,allow,1,0,Potential Threat
55116,445,0,0,66,66,0,1,0,1,0,drop,0,1,Known Attack
22150,6881,0,0,62,62,0,1,0,1,0,deny,0,1,Known Attack
50090,445,0,0,70,70,0,1,0,1,0,drop,0,1,Known Attack
14000,14914,0,0,157,157,0,1,0,1,0,deny,1,1,High Risk
60401,445,0,0,70,70,0,1,0,1,0,drop,0,1,Known Attack
46405,80,41634,80,1213,755,458,10,15,6,4,allow,1,0,Potential Threat
64035,25174,0,0,62,62,0,1,0,1,0,deny,0,1,Known Attack
57325,37965,0,0,62,62,0,1,0,1,0,deny,0,1,Known Attack
25457,25604,0,0,145,145,0,1,0,1,0,deny,1,1,High Risk
52138,445,0,0,70,70,0,1,0,1,0,drop,0,1,Known Attack
11344,42873,0,0,62,62,0,1,0,1,0,deny,1,1,High Risk
63818,19291,22268,19291,70,70,0,1,4,1,0,allow,1,0,Potential Threat
34430,53,54160,53,199,94,105,2,30,1,1,allow,0,0,Normal
60553,443,11360,443,7981,1867,6114,32,313,17,15,allow,1,0,Potential Threat
3478,61463,0,0,455,455,0,1,0,1,0,deny,1,1,High Risk
58036,445,0,0,66,66,0,1,0,1,0,drop,0,1,Known Attack
50078,53,55714,53,177,94,83,2,29,1,1,allow,0,0,Normal
35319,51505,0,0,146,146,0,1,0,1,0,deny,1,1,High Risk
37876,23,0,0,60,60,0,1,0,1,0,deny,0,1,Known Attack
63325,445,0,0,70,70,0,1,0,1,0,drop,0,1,Known Attack
53800,443,21628,443,499,425,74,4,0,3,1,allow,0,0,Normal
3730,17372,0,0,62,62,0,1,0,1,0,deny,1,1,High Risk
38633,443,44108,443,3448,1619,1829,18,18,8,10,allow,1,0,Potential Threat
58596,445,0,0,70,70,0,1,0,1,0,drop,0,1,Known Attack
50910,80,20207,80,14877069,179445,14697624,12450,135,2531,9919,allow,1,0,Potential Threat
64162,53,51950,53,255,118,137,2,29,1,1,allow,0,0,Normal
61286,443,11751,443,8970,5359,3611,22,121,11,11,allow,1,0,Potential Threat
54619,445,0,0,70,70,0,1,0,1,0,drop,0,1,Known Attack
49191,80,25150,80,2807,587,2220,13,16,7,6,allow,0,0,Normal
63582,443,11318,443,6178,1669,4509,19,15,11,8,allow,1,0,Potential Threat
58010,445,0,0,70,70,0,1,0,1,0,drop,0,1,Known Attack
55154,53,39546,53,184,94,90,2,30,1,1,allow,0,0,Normal
55018,53,50628,53,179,94,85,2,30,1,1,allow,0,0,Normal
55725,14704,2998,14704,70,70,0,2,8,2,0,allow,1,0,Potential Threat
16768,53,24708,53,199,94,105,2,30,1,1,allow,0,0,Normal
56755,53,13799,53,184,94,90,2,29,1,1,allow,0,0,Normal
32551,51221,0,0,62,62,0,1,0,1,0,deny,1,1,High Risk
55912,445,0,0,70,70,0,1,0,1,0,drop,0,1,Known Attack
45980,443,15108,443,9611,2412,7199,44,20,22,22,allow,1,0,Potential Threat
56986,53,34763,53,259,87,172,4,36,2,2,allow,0,0,Normal
7946,23,7946,23,130,66,64,2,5,1,1,allow,1,0,Potential Threat
50265,14107,11611,14107,132,132,0,3,1200,3,0,allow,1,0,Potential Threat
49695,445,0,0,66,66,0,1,0,1,0,drop,0,1,Known Attack
42969,8146,0,0,62,62,0,1,0,1,0,deny,0,1,Known Attack
55655,63670,50631,63670,70,70,0,1,5,1,0,allow,1,0,Potential Threat
56896,445,0,0,66,66,0,1,0,1,0,drop,0,1,Known Attack
61211,445,0,0,66,66,0,1,0,1,0,drop,0,1,Known Attack
56439,53,20721,53,177,94,83,2,29,1,1,allow,0,0,Normal
62249,443,58132,443,9251,6353,2898,25,120,13,12,allow,1,0,Potential Threat
59787,443,23637,443,276238,23971,252267,482,138,188,294,allow,1,0,Potential Threat
52842,445,0,0,70,70,0,1,0,1,0,drop,0,1,Known Attack
55760,53,12734,53,182,94,88,2,30,1,1,allow,0,0,Normal
56717,53,10005,53,183,94,89,2,30,1,1,allow,0,0,Normal
53884,445,0,0,66,66,0,1,0,1,0,drop,0,1,Known Attack
50453,445,0,0,66,66,0,1,0,1,0,drop,0,1,Known Attack
53557,39731,46000,39731,70,70,0,2,8,2,0,allow,1,0,Potential Threat
50587,443,51277,443,1198,716,482,12,98,7,5,allow,1,0,Potential Threat
40026,443,36114,443,6058,1749,4309,22,200,13,9,allow,1,0,Potential Threat
53800,59950,39242,59950,1973,1021,952,10,15,6,4,allow,1,0,Potential Threat
46031,443,52828,443,12395,2182,10213,21,122,10,11,allow,1,0,Potential Threat
56937,8200,16885,8200,78,78,0,1,30,1,0,allow,1,0,Potential Threat
0,0,0,0,244,244,0,2,0,2,0,allow,1,0,Potential Threat
13484,37965,0,0,62,62,0,1,0,1,0,deny,1,1,High Risk
53117,37529,38733,37529,70,70,0,1,5,1,0,allow,1,0,Potential Threat
53562,8999,49942,8999,320,140,180,6,6,3,3,allow,1,0,Potential Threat
59982,443,64265,443,7693,1284,6409,24,81,12,12,allow,1,0,Potential Threat
55281,53,41810,53,236,94,142,2,30,1,1,allow,0,0,Normal
58638,5900,0,0,62,62,0,1,0,1,0,deny,0,1,Known Attack
49518,53,34801,53,213,102,111,2,30,1,1,allow,0,0,Normal
55634,445,0,0,70,70,0,1,0,1,0,drop,0,1,Known Attack
40120,23,0,0,60,60,0,1,0,1,0,deny,0,1,Known Attack
50896,445,0,0,70,70,0,1,0,1,0,drop,0,1,Known Attack
37952,80,16690,80,1372,868,504,13,35,8,5,allow,1,0,Potential Threat
52789,445,0,0,70,70,0,1,0,1,0,drop,0,1,Known Attack
33912,443,41888,443,6288,3354,2934,9,122,5,4,allow,1,0,Potential Threat
58394,53,41554,53,274,94,180,2,30,1,1,allow,0,0,Normal
60407,443,16001,443,7298,1737,5561,21,79,11,10,allow,1,0,Potential Threat
46625,80,46625,80,51574,3466,48108,63,156,23,40,allow,1,0,Potential Threat
51646,80,56559,80,378,192,186,7,38,4,3,allow,0,0,Normal
50198,445,0,0,70,70,0,1,0,1,0,drop,0,1,Known Attack
56912,53,3525,53,199,102,97,2,30,1,1,allow,0,0,Normal
53987,445,0,0,70,70,0,1,0,1,0,drop,0,1,Known Attack
64691,25320,0,0,66,66,0,1,0,1,0,deny,0,1,Known Attack
25207,48817,0,0,62,62,0,1,0,1,0,deny,1,1,High Risk
50945,445,0,0,66,66,0,1,0,1,0,drop,0,1,Known Attack
55048,443,61796,443,12799,3662,9137,40,50,22,18,allow,1,0,Potential Threat
55326,53,27995,53,177,94,83,2,30,1,1,allow,0,0,Normal
42732,57470,0,0,62,62,0,1,0,1,0,deny,0,1,Known Attack
50945,445,0,0,66,66,0,1,0,1,0,drop,0,1,Known Attack
58045,80,55044,80,62067,24127,37940,79,34,33,46,allow,1,0,Potential Threat
56611,53,45220,53,177,94,83,2,30,1,1,allow,0,0,Normal
55641,53,38684,53,184,94,90,2,30,1,1,allow,0,0,Normal
64586,53,19634,53,252,94,158,2,31,1,1,allow,0,0,Normal
46186,443,59452,443,10103,3482,6621,59,16,29,30,allow,1,0,Potential Threat
58481,445,0,0,70,70,0,1,0,1,0,drop,0,1,Known Attack
49744,53,14742,53,816,102,714,2,30,1,1,allow,0,0,Normal
49610,53,48262,53,241,94,147,2,30,1,1,allow,0,0,Normal
56304,53,49255,53,184,94,90,2,30,1,1,allow,0,0,Normal
62900,993,6178,993,12900,4980,7920,91,117,51,40,allow,1,0,Potential Threat
64828,53,23782,53,372,94,278,2,30,1,1,allow,0,0,Normal
28020,443,11039,443,5576,1388,4188,19,15,9,10,allow,1,0,Potential Threat
17101,25174,0,0,66,66,0,1,0,1,0,deny,0,1,Known Attack
9518,1,0,0,100,100,0,1,0,1,0,deny,0,1,Known Attack
54079,443,34399,443,6931,1974,4957,24,342,11,13,allow,1,0,Potential Threat
53629,443,53629,443,4620,1713,2907,19,30,11,8,allow,1,0,Potential Threat
49450,443,1753,443,2319947,69322,2250625,2464,70,870,1594,allow,1,0,Potential Threat
42408,443,51647,443,13108,2630,10478,26,120,12,14,allow,1,0,Potential Threat
50828,443,49506,443,6337,1378,4959,19,140,9,10,allow,1,0,Potential Threat
55600,53,4581,53,209,110,99,2,30,1,1,allow,0,0,Normal
56119,46824,0,0,62,62,0,1,0,1,0,deny,0,1,Known Attack
49351,53,56042,53,166,86,80,2,29,1,1,allow,0,0,Normal
50183,445,0,0,70,70,0,1,0,1,0,drop,0,1,Known Attack
61839,445,0,0,70,70,0,1,0,1,0,drop,0,1,Known Attack
52788,64147,0,0,62,62,0,1,0,1,0,deny,1,1,High Risk
55989,443,55989,443,4378,1471,2907,19,29,11,8,allow,1,0,Potential Threat
65518,53,57051,53,198,94,104,2,30,1,1,allow,0,0,Normal
65131,53,4831,53,168,86,82,2,30,1,1,allow,0,0,Normal
54062,31573,0,0,66,66,0,1,0,1,0,deny,0,1,Known Attack
52492,445,0,0,66,66,0,1,0,1,0,drop,0,1,Known Attack
56674,443,44964,443,237,177,60,3,5,2,1,allow,0,0,Normal
55972,53,36064,53,193,102,91,2,30,1,1,allow,0,0,Normal
53318,445,0,0,70,70,0,1,0,1,0,drop,0,1,Known Attack
31123,53,31123,53,231,88,143,2,34,1,1,allow,0,0,Normal
58638,5900,0,0,62,62,0,1,0,1,0,deny,0,1,Known Attack
47262,443,28246,443,4609,763,3846,14,14,8,6,allow,1,0,Potential Threat
55191,445,0,0,66,66,0,1,0,1,0,drop,0,1,Known Attack
54351,53,59901,53,168,78,90,2,29,1,1,allow,0,0,Normal
12266,443,12266,443,18634,3895,14739,48,29,27,21,allow,1,0,Potential Threat
50637,80,48925,80,1742,589,1153,10,87,6,4,allow,0,0,Normal
55984,445,0,0,70,70,0,1,0,1,0,drop,0,1,Known Attack
65091,53,53299,53,212,102,110,2,29,1,1,allow,0,0,Normal
8560,50584,0,0,62,62,0,1,0,1,0,deny,1,1,High Risk
58974,80,55839,80,214,140,74,4,15,3,1,allow,0,0,Normal
57310,445,0,0,66,66,0,1,0,1,0,drop,0,1,Known Attack
60284,80,50056,80,1430,754,676,11,146,6,5,allow,1,0,Potential Threat
1045,36237,0,0,66,66,0,1,0,1,0,deny,1,1,High Risk
5223,32965,0,0,220,220,0,1,0,1,0,deny,1,1,High Risk
62783,443,22003,443,28847,16957,11890,144,293,60,84,allow,1,0,Potential Threat
3478,61463,0,0,944,944,0,1,0,1,0,deny,1,1,High Risk
65451,53,9414,53,178,94,84,2,30,1,1,allow,0,0,Normal
51715,443,60037,443,4887,2346,2541,16,120,8,8,allow,1,0,Potential Threat
19096,64147,0,0,62,62,0,1,0,1,0,deny,1,1,High Risk
9153,443,27123,443,6059,773,5286,17,29,9,8,allow,1,0,Potential Threat
58695,445,0,0,70,70,0,1,0,1,0,drop,0,1,Known Attack
58638,5900,58638,5900,62,62,0,1,5,1,0,allow,1,0,Potential Threat
64380,53,29472,53,186,95,91,2,31,1,1,allow,0,0,Normal
53266,443,29507,443,30264,2794,27470,47,322,19,28,allow,1,0,Potential Threat
52356,55442,0,0,62,62,0,1,0,1,0,deny,0,1,Known Attack
62062,443,17723,443,13499,2333,11166,24,137,10,14,allow,1,0,Potential Threat
63934,53,27798,53,347,103,244,4,46,2,2,allow,0,0,Normal
63910,44847,0,0,66,66,0,1,0,1,0,deny,1,1,High Risk
26929,443,8333,443,7487,2728,4759,25,19,13,12,allow,1,0,Potential Threat
49983,53,19113,53,267,110,157,2,30,1,1,allow,0,0,Normal
57402,9992,42519,9992,47040,13931,33109,428,129,207,221,allow,1,0,Potential Threat
64357,53,36127,53,183,94,89,2,30,1,1,allow,0,0,Normal
49331,443,35944,443,78663,4968,73695,85,47,24,61,allow,1,0,Potential Threat
59430,445,0,0,70,70,0,1,0,1,0,drop,0,1,Known Attack
56663,53,28501,53,215,102,113,2,30,1,1,allow,0,0,Normal
49508,53,17731,53,199,102,97,2,30,1,1,allow,0,0,Normal
57417,443,11340,443,43052,2466,40586,64,18,21,43,allow,1,0,Potential Threat
49480,53,4215,53,168,78,90,2,29,1,1,allow,0,0,Normal
59128,443,26405,443,92207,5395,86812,130,88,58,72,allow,1,0,Potential Threat
65498,53,39980,53,209,110,99,2,30,1,1,allow,0,0,Normal
58625,445,0,0,66,66,0,1,0,1,0,drop,0,1,Known Attack
62041,445,0,0,70,70,0,1,0,1,0,drop,0,1,Known Attack
49449,53,37523,53,216,110,106,2,29,1,1,allow,0,0,Normal
57987,56125,0,0,90,90,0,1,0,1,0,deny,1,1,High Risk
59377,9319,0,0,62,62,0,1,0,1,0,deny,0,1,Known Attack
57470,50321,35732,50321,490,149,341,2,1201,1,1,allow,1,0,Potential Threat
23021,25174,0,0,62,62,0,1,0,1,0,deny,0,1,Known Attack
63310,445,0,0,70,70,0,1,0,1,0,drop,0,1,Known Attack
57314,53,53459,53,195,102,93,2,30,1,1,allow,0,0,Normal
42469,80,53240,80,2169,1419,750,10,15,6,4,allow,1,0,Potential Threat
43166,80,43166,80,26540,1137,25403,36,136,15,21,allow,1,0,Potential Threat
49567,53,36957,53,184,102,82,2,29,1,1,allow,0,0,Normal
56115,53,55783,53,278,96,182,4,54,2,2,allow,0,0,Normal
12934,53,12934,53,237,91,146,2,33,1,1,allow,0,0,Normal
53203,445,0,0,70,70,0,1,0,1,0,drop,0,1,Known Attack
56572,53,56572,53,253,99,154,2,32,1,1,allow,0,0,Normal
55846,53,44796,53,821,102,719,2,29,1,1,allow,0,0,Normal
57867,27019,27516,27019,468,390,78,5,30,4,1,allow,1,0,Potential Threat
50928,445,0,0,70,70,0,1,0,1,0,drop,0,1,Known Attack
30296,53,30296,53,233,90,143,2,33,1,1,allow,0,0,Normal
57102,443,24363,443,17207,7111,10096,44,51,23,21,allow,1,0,Potential Threat
43693,53,25103,53,164,78,86,2,30,1,1,allow,0,0,Normal
55056,53,12643,53,202,103,99,2,31,1,1,allow,0,0,Normal
60281,443,39585,443,63696,4774,58922,83,125,32,51,allow,1,0,Potential Threat
65209,53,43414,53,585,206,379,6,79,3,3,allow,1,0,Potential Threat
58638,5900,0,0,62,62,0,1,0,1,0,deny,0,1,Known Attack
49160,6889,21794,6889,311,311,0,3,1200,3,0,allow,1,0,Potential Threat
58889,15000,32384,15000,138,78,60,2,6,1,1,allow,1,0,Potential Threat
53113,445,0,0,66,66,0,1,0,1,0,drop,0,1,Known Attack
60189,443,11334,443,10816,1112,9704,22,125,10,12,allow,1,0,Potential Threat
49852,80,47954,80,8868,3774,5094,20,89,10,10,allow,1,0,Potential Threat
53677,10657,26875,10657,70,70,0,2,8,2,0,allow,1,0,Potential Threat
56387,53,8885,53,757,98,659,2,31,1,1,allow,0,0,Normal
64299,53,27762,53,164,84,80,2,31,1,1,allow,0,0,Normal
53685,38978,44279,38978,70,70,0,2,8,2,0,allow,1,0,Potential Threat
50822,50584,0,0,66,66,0,1,0,1,0,deny,0,1,Known Attack
60053,443,33088,443,3190,1599,1591,17,142,9,8,allow,1,0,Potential Threat
62499,445,0,0,70,70,0,1,0,1,0,drop,0,1,Known Attack
53513,56205,0,0,62,62,0,1,0,1,0,deny,0,1,Known Attack
6703,21247,0,0,62,62,0,1,0,1,0,deny,1,1,High Risk
44695,443,65027,443,4419,3179,1240,17,17,10,7,allow,1,0,Potential Threat
53461,445,0,0,70,70,0,1,0,1,0,drop,0,1,Known Attack
51870,40490,51955,40490,70,70,0,1,5,1,0,allow,1,0,Potential Threat
56363,443,4827,443,4864,3011,1853,20,234,12,8,allow,1,0,Potential Threat
51773,23728,42323,23728,70,70,0,2,8,2,0,allow,1,0,Potential Threat
10028,25604,0,0,62,62,0,1,0,1,0,deny,0,1,Known Attack
51860,53854,59221,53854,70,70,0,1,5,1,0,allow,1,0,Potential Threat
64733,35440,0,0,62,62,0,1,0,1,0,deny,1,1,High Risk
22220,25174,0,0,62,62,0,1,0,1,0,deny,0,1,Known Attack
37707,53,28750,53,168,78,90,2,30,1,1,allow,0,0,Normal
64677,53,46523,53,195,102,93,2,31,1,1,allow,0,0,Normal
50000,53,56621,53,216,102,114,2,29,1,1,allow,0,0,Normal
64017,53,52336,53,209,110,99,2,30,1,1,allow,0,0,Normal
52680,445,0,0,66,66,0,1,0,1,0,drop,0,1,Known Attack
58638,5900,0,0,62,62,0,1,0,1,0,deny,0,1,Known Attack
50857,3389,50857,3389,3613,1594,2019,19,18,10,9,allow,1,0,Potential Threat
50012,53,43824,53,94,94,0,1,30,1,0,allow,0,0,Normal
64151,445,0,0,70,70,0,1,0,1,0,drop,0,1,Known Attack
49842,7302,0,0,66,66,0,1,0,1,0,deny,0,1,Known Attack
56910,53,22546,53,199,102,97,2,29,1,1,allow,0,0,Normal
65187,53,58684,53,199,102,97,2,31,1,1,allow,0,0,Normal
53706,59208,33732,59208,258,70,188,4,8,2,2,allow,1,0,Potential Threat
48706,23393,0,0,60,60,0,1,0,1,0,deny,0,1,Known Attack
64289,53,24247,53,198,101,97,2,30,1,1,allow,0,0,Normal
11754,25174,0,0,62,62,0,1,0,1,0,deny,0,1,Known Attack
53823,25291,38093,25291,320,140,180,6,6,3,3,allow,1,0,Potential Threat
40103,443,5740,443,416,210,206,7,34,4,3,allow,0,0,Normal
49330,443,4383,443,7913,2091,5822,23,42,11,12,allow,1,0,Potential Threat
55628,13343,19881,13343,634,388,246,10,18,6,4,allow,1,0,Potential Threat
9552,57470,0,0,62,62,0,1,0,1,0,deny,1,1,High Risk
54510,445,0,0,70,70,0,1,0,1,0,drop,0,1,Known Attack
56306,445,0,0,66,66,0,1,0,1,0,drop,0,1,Known Attack
64842,443,46917,443,5467,2738,2729,23,137,11,12,allow,1,0,Potential Threat
64177,445,0,0,70,70,0,1,0,1,0,drop,0,1,Known Attack
53723,443,16354,443,499,425,74,4,0,3,1,allow,0,0,Normal
49555,53,60187,53,578,286,292,9,15,5,4,allow,1,0,Potential Threat
443,64347,0,0,131,131,0,1,0,1,0,deny,1,1,High Risk
80,5101,0,0,78,78,0,1,0,1,0,deny,1,1,High Risk
49215,445,0,0,70,70,0,1,0,1,0,drop,0,1,Known Attack
49952,53,48831,53,195,102,93,2,30,1,1,allow,0,0,Normal
49835,53,35014,53,168,86,82,2,30,1,1,allow,0,0,Normal
59858,443,47016,443,2069,1044,1025,22,44,9,13,allow,1,0,Potential Threat
57416,53,53787,53,193,102,91,2,30,1,1,allow,0,0,Normal
56688,53,38230,53,192,98,94,2,30,1,1,allow,0,0,Normal
63597,443,64564,443,19821,11622,8199,77,135,39,38,allow,1,0,Potential Threat
37233,53,50033,53,198,93,105,2,30,1,1,allow,0,0,Normal
2780,23117,0,0,62,62,0,1,0,1,0,deny,1,1,High Risk
18029,50584,0,0,66,66,0,1,0,1,0,deny,1,1,High Risk
50119,443,44388,443,10557,2063,8494,40,144,22,18,allow,1,0,Potential Threat
2180,63710,0,0,62,62,0,1,0,1,0,deny,1,1,High Risk
28679,3389,28679,3389,3910,1805,2105,20,19,12,8,allow,1,0,Potential Threat
65312,445,0,0,70,70,0,1,0,1,0,drop,0,1,Known Attack
55600,53,36294,53,184,94,90,2,30,1,1,allow,0,0,Normal
49157,53,42050,53,184,94,90,2,29,1,1,allow,0,0,Normal
30960,45694,42221,45694,330,330,0,6,3610,6,0,allow,1,0,Potential Threat
51858,44647,20973,44647,66,66,0,1,5,1,0,allow,1,0,Potential Threat
14567,37965,0,0,62,62,0,1,0,1,0,deny,1,1,High Risk
52596,17372,0,0,66,66,0,1,0,1,0,deny,0,1,Known Attack
44849,46478,0,0,74,74,0,1,0,1,0,deny,0,1,Known Attack
65128,445,0,0,66,66,0,1,0,1,0,drop,0,1,Known Attack
54898,445,0,0,70,70,0,1,0,1,0,drop,0,1,Known Attack
17750,30022,45838,30022,481,150,331,2,1200,1,1,allow,1,0,Potential Threat
6722,80,6722,80,326,186,140,6,29,4,2,allow,1,0,Potential Threat
43231,443,33460,443,56226,4852,51374,71,106,30,41,allow,1,0,Potential Threat
54519,443,53980,443,8413,2503,5910,23,16,13,10,allow,1,0,Potential Threat
46970,443,52704,443,8394,3155,5239,28,271,16,12,allow,1,0,Potential Threat
55220,53,22108,53,193,102,91,2,30,1,1,allow,0,0,Normal
49825,53,42990,53,168,86,82,2,30,1,1,allow,0,0,Normal
49451,443,61379,443,12802,1977,10825,32,25,14,18,allow,1,0,Potential Threat
55172,80,55172,80,268230,8528,259702,292,231,106,186,allow,1,0,Potential Threat
56897,11446,0,0,62,62,0,1,0,1,0,deny,0,1,Known Attack
50450,80,49757,80,26924,4418,22506,34,25,13,21,allow,1,0,Potential Threat
56628,445,0,0,70,70,0,1,0,1,0,drop,0,1,Known Attack
56181,53,54189,53,764,99,665,2,31,1,1,allow,0,0,Normal
58863,443,23250,443,3873,2469,1404,17,16,9,8,allow,1,0,Potential Threat
51711,445,0,0,70,70,0,1,0,1,0,drop,0,1,Known Attack
53034,53,25305,53,238,94,144,2,30,1,1,allow,0,0,Normal
35186,443,1570,443,130,70,60,3,5,2,1,allow,0,0,Normal
56484,53,39719,53,214,110,104,2,30,1,1,allow,0,0,Normal
52064,80,49794,80,2125,709,1416,11,16,5,6,allow,1,0,Potential Threat
65389,26467,0,0,62,62,0,1,0,1,0,deny,0,1,Known Attack
38677,443,24014,443,89883,3417,86466,94,15,30,64,allow,1,0,Potential Threat
18745,64147,0,0,66,66,0,1,0,1,0,deny,1,1,High Risk
50210,1688,10212,1688,70,70,0,1,5,1,0,allow,0,0,Normal
57633,50584,0,0,62,62,0,1,0,1,0,deny,0,1,Known Attack
64157,53,49752,53,370,126,244,2,30,1,1,allow,0,0,Normal
49242,445,0,0,70,70,0,1,0,1,0,drop,0,1,Known Attack
49435,53,45474,53,720,94,626,2,30,1,1,allow,0,0,Normal
40512,57470,0,0,74,74,0,1,0,1,0,deny,1,1,High Risk
65518,445,0,0,66,66,0,1,0,1,0,drop,0,1,Known Attack
56339,53,35770,53,280,78,202,2,30,1,1,allow,0,0,Normal
55933,53,32005,53,177,94,83,2,30,1,1,allow,0,0,Normal
49484,80,60761,80,318,192,126,6,39,4,2,allow,0,0,Normal
55115,443,23390,443,1348,687,661,14,18,8,6,allow,0,0,Normal
57018,53,23896,53,177,94,83,2,31,1,1,allow,0,0,Normal
53841,37965,0,0,66,66,0,1,0,1,0,deny,0,1,Known Attack
60084,445,0,0,70,70,0,1,0,1,0,drop,0,1,Known Attack
64622,36829,0,0,62,62,0,1,0,1,0,deny,1,1,High Risk
55686,445,0,0,70,70,0,1,0,1,0,drop,0,1,Known Attack
53527,5228,55667,5228,9674,1776,7898,29,3764,11,18,allow,1,0,Potential Threat
57430,80,9392,80,4509,2976,1533,13,15,6,7,allow,1,0,Potential Threat
63643,445,0,0,66,66,0,1,0,1,0,drop,0,1,Known Attack
62653,445,0,0,66,66,0,1,0,1,0,drop,0,1,Known Attack
53065,445,0,0,66,66,0,1,0,1,0,drop,0,1,Known Attack
50619,443,52531,443,10483,1021,9462,30,100,11,19,allow,1,0,Potential Threat
56791,443,55063,443,8021,2001,6020,20,15,11,9,allow,1,0,Potential Threat
51685,57470,0,0,66,66,0,1,0,1,0,deny,0,1,Known Attack
51868,30305,49639,30305,70,70,0,2,8,2,0,allow,1,0,Potential Threat
57470,32348,51610,32348,527,166,361,2,1199,1,1,allow,1,0,Potential Threat
51419,445,0,0,70,70,0,1,0,1,0,drop,0,1,Known Attack
61975,445,0,0,66,66,0,1,0,1,0,drop,0,1,Known Attack
50327,1433,0,0,60,60,0,1,0,1,0,deny,0,1,Known Attack
60260,22114,0,0,66,66,0,1,0,1,0,deny,0,1,Known Attack
27005,26258,35412,26258,886,126,760,2,30,1,1,allow,1,0,Potential Threat
63972,53,35839,53,193,102,91,2,30,1,1,allow,0,0,Normal
55194,53,43998,53,195,102,93,2,30,1,1,allow,0,0,Normal
54264,445,0,0,66,66,0,1,0,1,0,drop,0,1,Known Attack
50318,53,54870,53,94,94,0,1,30,1,0,allow,0,0,Normal
62337,445,0,0,70,70,0,1,0,1,0,drop,0,1,Known Attack
57288,53,46993,53,177,94,83,2,30,1,1,allow,0,0,Normal
58213,37807,0,0,66,66,0,1,0,1,0,deny,0,1,Known Attack
50414,445,0,0,66,66,0,1,0,1,0,drop,0,1,Known Attack
50893,445,0,0,70,70,0,1,0,1,0,drop,0,1,Known Attack
54051,28793,0,0,66,66,0,1,0,1,0,deny,0,1,Known Attack
55189,53,54191,53,211,102,109,2,30,1,1,allow,0,0,Normal
61865,35440,0,0,66,66,0,1,0,1,0,deny,0,1,Known Attack
44855,58414,0,0,62,62,0,1,0,1,0,deny,1,1,High Risk
56885,445,0,0,70,70,0,1,0,1,0,drop,0,1,Known Attack
56689,53,22159,53,738,86,652,2,30,1,1,allow,0,0,Normal
57251,37965,0,0,62,62,0,1,0,1,0,deny,0,1,Known Attack
63783,1375,0,0,109,109,0,1,0,1,0,deny,0,1,Known Attack
35080,80,13868,80,71843,2833,69010,83,16,36,47,allow,1,0,Potential Threat
19875,30170,0,0,145,145,0,1,0,1,0,deny,1,1,High Risk
17579,57470,0,0,62,62,0,1,0,1,0,deny,1,1,High Risk
49418,27015,12745,27015,227,78,149,2,30,1,1,allow,1,0,Potential Threat
50966,443,50616,443,17161,1619,15542,18,143,4,14,allow,1,0,Potential Threat
54731,445,0,0,66,66,0,1,0,1,0,drop,0,1,Known Attack
64677,57470,0,0,66,66,0,1,0,1,0,deny,1,1,High Risk
48087,16069,0,0,66,66,0,1,0,1,0,deny,0,1,Known Attack
3564,57470,0,0,62,62,0,1,0,1,0,deny,1,1,High Risk
51289,445,0,0,70,70,0,1,0,1,0,drop,0,1,Known Attack
56319,445,0,0,66,66,0,1,0,1,0,drop,0,1,Known Attack
27005,28015,54917,28015,888,126,762,2,30,1,1,allow,1,0,Potential Threat
57341,53,32411,53,184,94,90,2,31,1,1,allow,0,0,Normal
49152,514,0,0,142,142,0,2,30,2,0,allow,0,0,Normal
50190,53,51481,53,754,94,660,2,30,1,1,allow,0,0,Normal
49939,53,35198,53,231,102,129,2,29,1,1,allow,0,0,Normal
39058,443,50860,443,70,70,0,1,5,1,0,allow,0,0,Normal
51194,445,0,0,66,66,0,1,0,1,0,drop,0,1,Known Attack
49418,27017,6721,27017,300,78,222,2,30,1,1,allow,1,0,Potential Threat
53791,53,58724,53,204,204,0,3,46,3,0,allow,0,0,Normal
60119,445,0,0,70,70,0,1,0,1,0,drop,0,1,Known Attack
65142,53,52775,53,167,86,81,2,29,1,1,allow,0,0,Normal
51439,443,29374,443,396,66,330,7,17,2,5,allow,0,0,Normal
6881,13234,11039,13234,324,150,174,2,1201,1,1,allow,1,0,Potential Threat
56218,43890,0,0,66,66,0,1,0,1,0,deny,0,1,Known Attack
44068,443,30325,443,3947,1744,2203,16,361,8,8,allow,1,0,Potential Threat
53022,443,29069,443,15099,7828,7271,45,92,24,21,allow,1,0,Potential Threat
53113,443,2940,443,11030,4292,6738,32,61,17,15,allow,1,0,Potential Threat
56909,50584,0,0,66,66,0,1,0,1,0,deny,0,1,Known Attack
63497,445,0,0,66,66,0,1,0,1,0,drop,0,1,Known Attack
54533,445,0,0,70,70,0,1,0,1,0,drop,0,1,Known Attack
53450,443,18001,443,5931,1750,4181,24,48,14,10,allow,1,0,Potential Threat
27005,27015,19164,27015,871,126,745,2,31,1,1,allow,1,0,Potential Threat
43329,50584,0,0,146,146,0,1,0,1,0,deny,1,1,High Risk
39714,443,60107,443,922046,41258,880788,1106,218,498,608,allow,1,0,Potential Threat
40662,53,39686,53,223,78,145,2,30,1,1,allow,0,0,Normal
51209,445,0,0,66,66,0,1,0,1,0,drop,0,1,Known Attack
51099,443,34189,443,11482,3696,7786,28,62,15,13,allow,1,0,Potential Threat
57679,443,27474,443,6568,2770,3798,20,121,10,10,allow,1,0,Potential Threat
57095,53,7010,53,177,94,83,2,30,1,1,allow,0,0,Normal
55240,53,36394,53,816,102,714,2,30,1,1,allow,0,0,Normal
64120,443,47176,443,3767437,87322,3680115,3675,52,1230,2445,allow,1,0,Potential Threat
56855,64607,58491,64607,316,136,180,6,6,3,3,allow,1,0,Potential Threat
56691,443,29213,443,7862,1873,5989,20,15,11,9,allow,1,0,Potential Threat
52151,445,0,0,70,70,0,1,0,1,0,drop,0,1,Known Attack
59889,443,31832,443,1576,973,603,14,28,7,7,allow,1,0,Potential Threat
65303,53,28109,53,94,94,0,1,29,1,0,allow,0,0,Normal
65248,53,32569,53,779,86,693,2,30,1,1,allow,0,0,Normal
5612,53,5612,53,227,89,138,2,30,1,1,allow,1,0,Potential Threat
60100,445,0,0,66,66,0,1,0,1,0,drop,0,1,Known Attack
49713,53,39823,53,184,94,90,2,30,1,1,allow,0,0,Normal
50659,445,0,0,66,66,0,1,0,1,0,drop,0,1,Known Attack
45082,17,0,0,60,60,0,1,0,1,0,deny,0,1,Known Attack
3410,17372,0,0,62,62,0,1,0,1,0,deny,1,1,High Risk
59945,443,18013,443,10477,3435,7042,34,20,18,16,allow,1,0,Potential Threat
58654,53,55637,53,168,78,90,2,30,1,1,allow,0,0,Normal
60719,443,32077,443,71523,19991,51532,112,41,59,53,allow,1,0,Potential Threat
20112,64147,0,0,62,62,0,1,0,1,0,deny,1,1,High Risk
60393,443,31011,443,8049,1805,6244,23,81,12,11,allow,1,0,Potential Threat
43969,7000,43969,7000,3370,1595,1775,16,15,9,7,allow,1,0,Potential Threat
53044,445,0,0,70,70,0,1,0,1,0,drop,0,1,Known Attack
9687,57470,0,0,78,78,0,1,0,1,0,deny,1,1,High Risk
52051,29868,56419,29868,70,70,0,2,8,2,0,allow,1,0,Potential Threat
52014,20524,1318,20524,70,70,0,2,8,2,0,allow,1,0,Potential Threat
35123,443,15419,443,17656,4044,13612,30,122,13,17,allow,1,0,Potential Threat
45912,44847,0,0,62,62,0,1,0,1,0,deny,0,1,Known Attack
25469,57470,0,0,62,62,0,1,0,1,0,deny,1,1,High Risk
49812,26467,0,0,62,62,0,1,0,1,0,deny,0,1,Known Attack
50880,445,0,0,70,70,0,1,0,1,0,drop,0,1,Known Attack
51927,445,0,0,70,70,0,1,0,1,0,drop,0,1,Known Attack
54498,443,44231,443,8060,2001,6059,24,19,14,10,allow,1,0,Potential Threat
55269,53,51344,53,193,102,91,2,30,1,1,allow,0,0,Normal
58554,443,5045,443,8626,2156,6470,24,81,14,10,allow,1,0,Potential Threat
50207,53,4187,53,195,102,93,2,29,1,1,allow,0,0,Normal
52140,80,9768,80,3476,1433,2043,26,418,14,12,allow,1,0,Potential Threat
62260,445,0,0,66,66,0,1,0,1,0,drop,0,1,Known Attack
52434,80,48898,80,1647,481,1166,13,15,6,7,allow,0,0,Normal
56970,53,57331,53,428,103,325,4,34,2,2,allow,0,0,Normal
50462,80,37104,80,113965,10014,103951,154,204,65,89,allow,1,0,Potential Threat
51265,63960,52529,63960,70,70,0,2,8,2,0,allow,1,0,Potential Threat
60333,443,9820,443,8945,5766,3179,30,130,18,12,allow,1,0,Potential Threat
50949,443,50949,443,4453,1546,2907,19,29,11,8,allow,1,0,Potential Threat
58638,5900,0,0,62,62,0,1,0,1,0,deny,0,1,Known Attack
52460,445,0,0,70,70,0,1,0,1,0,drop,0,1,Known Attack
56342,445,0,0,70,70,0,1,0,1,0,drop,0,1,Known Attack
60181,445,0,0,66,66,0,1,0,1,0,drop,0,1,Known Attack
443,28417,0,0,82,82,0,1,0,1,0,deny,1,1,High Risk
58736,443,28275,443,7978,1143,6835,19,26,9,10,allow,1,0,Potential Threat
49457,445,0,0,66,66,0,1,0,1,0,drop,0,1,Known Attack
53165,443,14639,443,7434,1695,5739,23,27,12,11,allow,1,0,Potential Threat
6881,6881,0,0,146,146,0,1,0,1,0,deny,1,1,High Risk
49424,53,45939,53,198,102,96,2,32,1,1,allow,0,0,Normal
58956,80,51257,80,2493,1830,663,12,15,6,6,allow,1,0,Potential Threat
65518,5710,0,0,62,62,0,1,0,1,0,deny,0,1,Known Attack
56406,443,10804,443,8328,1391,6937,18,123,10,8,allow,1,0,Potential Threat
37011,25174,0,0,62,62,0,1,0,1,0,deny,0,1,Known Attack
58638,5900,0,0,62,62,0,1,0,1,0,deny,0,1,Known Attack
61250,42873,0,0,66,66,0,1,0,1,0,deny,0,1,Known Attack
13727,13751,0,0,148,148,0,1,0,1,0,deny,1,1,High Risk
64885,53,51711,53,212,102,110,2,31,1,1,allow,0,0,Normal
56033,443,32455,443,3250,1058,2192,13,136,6,7,allow,1,0,Potential Threat
55056,44512,0,0,62,62,0,1,0,1,0,deny,0,1,Known Attack
39570,443,62469,443,70,70,0,1,5,1,0,allow,1,0,Potential Threat
57470,29137,36773,29137,1386,1386,0,22,1610,22,0,allow,1,0,Potential Threat
53288,443,63225,443,4448,1654,2794,13,121,6,7,allow,1,0,Potential Threat
55098,53,22759,53,474,200,274,6,44,3,3,allow,0,0,Normal
64714,53,3550,53,168,86,82,2,31,1,1,allow,0,0,Normal
53321,80,20263,80,3483,2072,1411,21,214,17,4,allow,1,0,Potential Threat
56926,53,27418,53,711,87,624,2,30,1,1,allow,0,0,Normal
49227,53,48621,53,718,94,624,2,30,1,1,allow,0,0,Normal
58638,5900,0,0,62,62,0,1,0,1,0,deny,0,1,Known Attack
64505,53,53732,53,388,134,254,2,30,1,1,allow,0,0,Normal
50000,53,33265,53,216,110,106,2,30,1,1,allow,0,0,Normal
21993,25174,0,0,62,62,0,1,0,1,0,deny,0,1,Known Attack
4041,23,0,0,60,60,0,1,0,1,0,deny,1,1,High Risk
49156,53,43723,53,195,102,93,2,32,1,1,allow,0,0,Normal
52215,445,0,0,66,66,0,1,0,1,0,deny,0,1,Known Attack
49901,53,43057,53,752,93,659,2,31,1,1,allow,0,0,Normal
10243,36237,0,0,62,62,0,1,0,1,0,deny,1,1,High Risk
51206,445,0,0,70,70,0,1,0,1,0,drop,0,1,Known Attack
50002,53,41135,53,196,102,94,2,30,1,1,allow,0,0,Normal
63063,443,23701,443,303,85,218,2,30,1,1,allow,0,0,Normal
64661,53,48759,53,216,102,114,2,30,1,1,allow,0,0,Normal
39810,48817,0,0,148,148,0,1,0,1,0,deny,1,1,High Risk
59019,445,0,0,66,66,0,1,0,1,0,drop,0,1,Known Attack
8941,443,25184,443,541643,15245,526398,507,416,103,404,allow,1,0,Potential Threat
50389,445,0,0,70,70,0,1,0,1,0,drop,0,1,Known Attack
52317,5223,5494,5223,6070,1779,4291,17,3600,8,9,allow,1,0,Potential Threat
63628,53,35423,53,289,86,203,2,30,1,1,allow,0,0,Normal
50408,8080,50408,8080,378,180,198,7,32,4,3,allow,1,0,Potential Threat
57120,445,0,0,66,66,0,1,0,1,0,drop,0,1,Known Attack
55732,5900,0,0,60,60,0,1,0,1,0,deny,0,1,Known Attack
52424,445,0,0,66,66,0,1,0,1,0,drop,0,1,Known Attack
60289,80,35170,80,1928,906,1022,11,145,6,5,allow,1,0,Potential Threat
49275,53,35482,53,195,102,93,2,31,1,1,allow,0,0,Normal
60015,443,28429,443,6340,3788,2552,21,143,10,11,allow,1,0,Potential Threat
64038,53,4227,53,321,102,219,2,30,1,1,allow,0,0,Normal
8999,57470,0,0,146,146,0,1,0,1,0,deny,1,1,High Risk
55426,53,8033,53,181,98,83,2,30,1,1,allow,0,0,Normal
17171,22114,0,0,66,66,0,1,0,1,0,deny,0,1,Known Attack
50287,80,60290,80,3325,607,2718,11,45,6,5,allow,1,0,Potential Threat
55238,53,27709,53,168,86,82,2,31,1,1,allow,0,0,Normal
55528,443,24685,443,7845,1860,5985,24,81,14,10,allow,1,0,Potential Threat
50268,443,33459,443,35251,25181,10070,121,123,63,58,allow,1,0,Potential Threat
57387,53,39674,53,178,94,84,2,30,1,1,allow,0,0,Normal
65082,53,43263,53,183,94,89,2,30,1,1,allow,0,0,Normal
56419,53,27801,53,199,102,97,2,30,1,1,allow,0,0,Normal
65012,32468,0,0,62,62,0,1,0,1,0,deny,1,1,High Risk
28306,25604,0,0,62,62,0,1,0,1,0,deny,0,1,Known Attack
58461,443,33796,443,6100,1233,4867,21,17,11,10,allow,1,0,Potential Threat
48978,25174,0,0,62,62,0,1,0,1,0,deny,0,1,Known Attack
65182,53,61284,53,634,199,435,6,79,3,3,allow,1,0,Potential Threat
49160,57470,0,0,146,146,0,1,0,1,0,deny,1,1,High Risk
61820,445,0,0,70,70,0,1,0,1,0,drop,0,1,Known Attack
58007,445,0,0,66,66,0,1,0,1,0,drop,0,1,Known Attack
53130,443,53130,443,3121,1764,1357,19,181,10,9,allow,1,0,Potential Threat
49548,443,37968,443,1346,918,428,10,22,6,4,allow,0,0,Normal
64877,445,0,0,70,70,0,1,0,1,0,drop,0,1,Known Attack
51766,445,0,0,70,70,0,1,0,1,0,drop,0,1,Known Attack
45313,64147,0,0,62,62,0,1,0,1,0,deny,1,1,High Risk
27005,27015,5485,27015,889,126,763,2,30,1,1,allow,1,0,Potential Threat
49692,53,30173,53,212,110,102,2,30,1,1,allow,0,0,Normal
45627,443,27902,443,6410,1610,4800,24,17,13,11,allow,1,0,Potential Threat
39350,3389,39350,3389,3910,1805,2105,20,18,12,8,allow,1,0,Potential Threat
50175,53,55281,53,196,102,94,2,30,1,1,allow,0,0,Normal
53392,53,53392,53,832,106,726,2,30,1,1,allow,0,0,Normal
38852,37965,0,0,62,62,0,1,0,1,0,deny,0,1,Known Attack
59486,50584,0,0,62,62,0,1,0,1,0,deny,0,1,Known Attack
56843,53,57824,53,177,94,83,2,30,1,1,allow,0,0,Normal
38001,49152,63633,49152,156,156,0,3,8,3,0,allow,1,0,Potential Threat
57235,445,0,0,66,66,0,1,0,1,0,drop,0,1,Known Attack
54635,443,11319,443,11955,1861,10094,30,172,14,16,allow,1,0,Potential Threat
65168,53,46023,53,239,94,145,2,30,1,1,allow,0,0,Normal
52109,60841,37568,60841,258,70,188,4,8,2,2,allow,1,0,Potential Threat
1025,64147,0,0,62,62,0,1,0,1,0,deny,1,1,High Risk
34351,53,57036,53,202,83,119,2,31,1,1,allow,0,0,Normal
40249,443,14843,443,70,70,0,1,5,1,0,allow,0,0,Normal
52910,51221,0,0,78,78,0,1,0,1,0,deny,0,1,Known Attack
50380,53,4521,53,737,94,643,2,29,1,1,allow,0,0,Normal
56613,445,0,0,70,70,0,1,0,1,0,deny,0,1,Known Attack
14567,37965,0,0,62,62,0,1,0,1,0,deny,1,1,High Risk
57353,445,0,0,70,70,0,1,0,1,0,drop,0,1,Known Attack
10010,80,10501,80,2166,600,1566,10,45,6,4,allow,1,0,Potential Threat
63850,6881,4556,6881,70,70,0,1,4,1,0,allow,1,0,Potential Threat
10145,21247,0,0,62,62,0,1,0,1,0,deny,0,1,Known Attack
64330,53,10524,53,193,102,91,2,30,1,1,allow,0,0,Normal
55556,53,41769,53,224,94,130,2,30,1,1,allow,0,0,Normal
27005,1104,28939,1104,870,126,744,2,29,1,1,allow,1,0,Potential Threat
59904,443,14583,443,694,370,324,12,34,7,5,allow,0,0,Normal
56638,64147,0,0,62,62,0,1,0,1,0,deny,1,1,High Risk
49961,53,46234,53,216,110,106,2,31,1,1,allow,0,0,Normal
54471,445,0,0,66,66,0,1,0,1,0,drop,0,1,Known Attack
49589,53,16073,53,214,102,112,2,31,1,1,allow,0,0,Normal
51928,52520,20049,52520,258,70,188,4,8,2,2,allow,1,0,Potential Threat
52862,445,0,0,70,70,0,1,0,1,0,drop,0,1,Known Attack
52177,443,52177,443,38013,6855,31158,58,21,25,33,allow,1,0,Potential Threat
50367,37965,0,0,66,66,0,1,0,1,0,deny,0,1,Known Attack
49698,80,3522,80,140258,1720,138538,117,52,18,99,allow,1,0,Potential Threat
49547,443,35951,443,1346,918,428,10,23,6,4,allow,0,0,Normal
51785,33253,63010,33253,70,70,0,1,5,1,0,allow,1,0,Potential Threat
56614,25174,0,0,66,66,0,1,0,1,0,deny,0,1,Known Attack
56247,445,0,0,66,66,0,1,0,1,0,drop,0,1,Known Attack
49601,53,32118,53,178,94,84,2,30,1,1,allow,0,0,Normal
33886,52255,0,0,162,162,0,1,0,1,0,deny,1,1,High Risk
57409,53,7230,53,168,86,82,2,30,1,1,allow,0,0,Normal
58371,23,0,0,60,60,0,1,0,1,0,deny,0,1,Known Attack
48817,63615,48817,63615,765,296,469,4,1200,2,2,allow,1,0,Potential Threat
22783,64147,0,0,66,66,0,1,0,1,0,deny,1,1,High Risk
62739,445,0,0,70,70,0,1,0,1,0,drop,0,1,Known Attack
50584,51413,3341,51413,475,150,325,2,1200,1,1,allow,1,0,Potential Threat
56987,53,21347,53,196,102,94,2,30,1,1,allow,0,0,Normal
53372,443,36591,443,214,140,74,4,20,3,1,allow,0,0,Normal
49408,445,0,0,66,66,0,1,0,1,0,drop,0,1,Known Attack
54578,26467,0,0,66,66,0,1,0,1,0,deny,0,1,Known Attack
39872,53,48299,53,78,78,0,1,30,1,0,allow,0,0,Normal
56829,53,59229,53,199,102,97,2,30,1,1,allow,0,0,Normal
53531,48908,42269,48908,70,70,0,1,4,1,0,allow,1,0,Potential Threat
17344,62413,0,0,66,66,0,1,0,1,0,deny,1,1,High Risk
52988,53567,0,0,62,62,0,1,0,1,0,deny,0,1,Known Attack
64796,53,3205,53,184,94,90,2,31,1,1,allow,0,0,Normal
59996,443,60855,443,1641,730,911,14,18,8,6,allow,1,0,Potential Threat
38549,22114,0,0,62,62,0,1,0,1,0,deny,0,1,Known Attack
56083,53,60591,53,711,87,624,2,30,1,1,allow,0,0,Normal
56938,445,0,0,70,70,0,1,0,1,0,drop,0,1,Known Attack
62682,445,0,0,66,66,0,1,0,1,0,drop,0,1,Known Attack
51410,445,0,0,70,70,0,1,0,1,0,drop,0,1,Known Attack
49167,53,5532,53,816,102,714,2,30,1,1,allow,0,0,Normal
2828,35253,0,0,66,66,0,1,0,1,0,deny,1,1,High Risk
55057,53,26203,53,211,110,101,2,30,1,1,allow,0,0,Normal
51083,445,0,0,66,66,0,1,0,1,0,drop,0,1,Known Attack
58578,445,0,0,70,70,0,1,0,1,0,drop,0,1,Known Attack
56830,53,57872,53,190,97,93,2,31,1,1,allow,0,0,Normal
59891,445,0,0,70,70,0,1,0,1,0,drop,0,1,Known Attack
46492,443,13641,443,11163,3642,7521,25,30,14,11,allow,1,0,Potential Threat
52163,14181,24095,14181,70,70,0,2,8,2,0,allow,1,0,Potential Threat
53209,8081,13912,8081,5349,1928,3421,17,114,10,7,allow,1,0,Potential Threat
54873,443,62397,443,9238,3472,5766,43,75,24,19,allow,1,0,Potential Threat
7041,37965,0,0,66,66,0,1,0,1,0,deny,1,1,High Risk
59905,443,62793,443,21212,14546,6666,43,362,24,19,allow,1,0,Potential Threat
52088,443,13388,443,16165,3877,12288,53,186,25,28,allow,1,0,Potential Threat
58986,443,40709,443,10624,6845,3779,50,123,25,25,allow,1,0,Potential Threat
54390,445,0,0,66,66,0,1,0,1,0,drop,0,1,Known Attack
43345,51505,0,0,146,146,0,1,0,1,0,deny,1,1,High Risk
56317,53,26526,53,183,94,89,2,30,1,1,allow,0,0,Normal
59726,53,53950,53,304,86,218,2,30,1,1,allow,0,0,Normal
27005,27015,13852,27015,881,126,755,2,30,1,1,allow,1,0,Potential Threat
64605,35993,0,0,66,66,0,1,0,1,0,deny,0,1,Known Attack
57283,53,15261,53,185,102,83,2,30,1,1,allow,0,0,Normal
64000,44847,0,0,62,62,0,1,0,1,0,deny,1,1,High Risk
59935,445,0,0,66,66,0,1,0,1,0,drop,0,1,Known Attack
46945,64147,0,0,62,62,0,1,0,1,0,deny,1,1,High Risk
55407,53,58404,53,195,94,101,2,30,1,1,allow,0,0,Normal
26729,57470,0,0,66,66,0,1,0,1,0,deny,1,1,High Risk
61147,445,0,0,70,70,0,1,0,1,0,drop,0,1,Known Attack
49555,53,29992,53,193,102,91,2,30,1,1,allow,0,0,Normal
49891,53,30480,53,788,108,680,2,31,1,1,allow,0,0,Normal
44821,64147,0,0,62,62,0,1,0,1,0,deny,1,1,High Risk
32395,30188,0,0,146,146,0,1,0,1,0,deny,1,1,High Risk
63224,443,7611,443,1373,734,639,17,155,10,7,allow,1,0,Potential Threat
49946,80,45099,80,31517,1203,30314,38,15,15,23,allow,1,0,Potential Threat
993,16279,0,0,129,129,0,1,0,1,0,deny,1,1,High Risk
39042,443,60755,443,3589,1251,2338,15,20,9,6,allow,1,0,Potential Threat
58638,5900,0,0,62,62,0,1,0,1,0,deny,0,1,Known Attack
52277,445,0,0,66,66,0,1,0,1,0,drop,0,1,Known Attack
51457,443,49898,443,642,582,60,2,15,1,1,allow,0,0,Normal
5588,5588,0,0,3498,1872,1626,48,204,24,24,allow,1,0,Potential Threat
55261,53,19627,53,173,94,79,2,30,1,1,allow,0,0,Normal
59597,443,2305,443,10310,2469,7841,35,255,18,17,allow,1,0,Potential Threat
51722,445,0,0,70,70,0,1,0,1,0,drop,0,1,Known Attack
42566,53,42566,53,216,98,118,2,30,1,1,allow,0,0,Normal
53631,43562,1567,43562,492,306,186,8,15,5,3,allow,1,0,Potential Threat
58638,5900,0,0,62,62,0,1,0,1,0,deny,0,1,Known Attack
56763,27734,6083,27734,70,70,0,1,5,1,0,allow,1,0,Potential Threat
51931,19416,18686,19416,70,70,0,1,5,1,0,allow,1,0,Potential Threat
6889,8055,0,0,143,143,0,1,0,1,0,deny,1,1,High Risk
56494,3033,0,0,146,146,0,1,0,1,0,deny,0,1,Known Attack
13285,29892,0,0,145,145,0,1,0,1,0,deny,1,1,High Risk
57438,443,63629,443,7720,2815,4905,22,20,10,12,allow,1,0,Potential Threat
58348,445,0,0,70,70,0,1,0,1,0,drop,0,1,Known Attack
57470,48096,60784,48096,132,132,0,3,1200,3,0,allow,1,0,Potential Threat
56415,53,6839,53,198,101,97,2,30,1,1,allow,0,0,Normal
54956,53,14576,53,194,102,92,2,31,1,1,allow,0,0,Normal
55012,443,47170,443,3388,2236,1152,28,904,16,12,allow,1,0,Potential Threat
59424,50265,0,0,74,74,0,1,0,1,0,deny,1,1,High Risk
58638,5900,0,0,62,62,0,1,0,1,0,deny,0,1,Known Attack
55829,53,11417,53,212,110,102,2,29,1,1,allow,0,0,Normal
48513,44847,0,0,146,146,0,1,0,1,0,deny,1,1,High Risk
56848,53,54786,53,764,99,665,2,31,1,1,allow,0,0,Normal
35568,443,33534,443,5383,3710,1673,27,309,14,13,allow,1,0,Potential Threat
49160,14387,38901,14387,854,150,704,4,1200,2,2,allow,1,0,Potential Threat
59189,443,26773,443,9050,4611,4439,37,222,20,17,allow,1,0,Potential Threat
55706,443,29687,443,5259,1203,4056,19,41,10,9,allow,1,0,Potential Threat
17702,6881,0,0,62,62,0,1,0,1,0,deny,0,1,Known Attack
60441,443,36416,443,3211,1964,1247,25,263,13,12,allow,1,0,Potential Threat
33003,28543,0,0,62,62,0,1,0,1,0,deny,0,1,Known Attack
61473,445,0,0,70,70,0,1,0,1,0,drop,0,1,Known Attack
52614,44847,0,0,62,62,0,1,0,1,0,deny,0,1,Known Attack
39540,37965,0,0,66,66,0,1,0,1,0,deny,0,1,Known Attack
60413,43555,44163,43555,70,70,0,2,8,2,0,allow,1,0,Potential Threat
56143,53,42893,53,195,94,101,2,30,1,1,allow,0,0,Normal
65158,53,9153,53,728,102,626,2,30,1,1,allow,0,0,Normal
63352,445,0,0,70,70,0,1,0,1,0,drop,0,1,Known Attack
56988,53,25747,53,216,110,106,2,30,1,1,allow,0,0,Normal
0,0,0,0,244,244,0,2,0,2,0,allow,1,0,Potential Threat
54976,15503,0,0,66,66,0,1,0,1,0,deny,0,1,Known Attack
54702,445,0,0,70,70,0,1,0,1,0,drop,0,1,Known Attack
14247,53,14247,53,197,90,107,2,30,1,1,allow,0,0,Normal
56891,53,55899,53,226,110,116,2,30,1,1,allow,0,0,Normal
56263,445,0,0,70,70,0,1,0,1,0,drop,0,1,Known Attack
51719,13715,5835,13715,70,70,0,2,8,2,0,allow,1,0,Potential Threat
55079,25174,0,0,66,66,0,1,0,1,0,deny,0,1,Known Attack
64640,53,17711,53,249,94,155,2,30,1,1,allow,0,0,Normal
40254,443,35283,443,7646,1024,6622,19,15,11,8,allow,1,0,Potential Threat
50571,80,62731,80,318,192,126,6,26,4,2,allow,1,0,Potential Threat
49790,445,0,0,66,66,0,1,0,1,0,drop,0,1,Known Attack
56117,53,20260,53,178,94,84,2,30,1,1,allow,0,0,Normal
59165,53,3627,53,320,94,226,2,30,1,1,allow,0,0,Normal
58476,445,0,0,70,70,0,1,0,1,0,drop,0,1,Known Attack
26800,22,0,0,60,60,0,1,0,1,0,deny,0,1,Known Attack
34879,443,57316,443,167,107,60,2,5,1,1,allow,1,0,Potential Threat
58213,445,0,0,70,70,0,1,0,1,0,drop,0,1,Known Attack
38115,443,13490,443,281978,16098,265880,405,67,204,201,allow,1,0,Potential Threat
46770,80,34528,80,2068,1371,697,13,83,7,6,allow,0,0,Normal
49501,53,50847,53,193,102,91,2,31,1,1,allow,0,0,Normal
54304,445,0,0,66,66,0,1,0,1,0,drop,0,1,Known Attack
23089,48817,0,0,62,62,0,1,0,1,0,deny,1,1,High Risk
51372,445,0,0,66,66,0,1,0,1,0,drop,0,1,Known Attack
44719,80,51210,80,1998,1422,576,10,15,6,4,allow,1,0,Potential Threat
36672,53,36672,53,234,93,141,2,30,1,1,allow,0,0,Normal
56394,443,33249,443,12371,1344,11027,30,3944,10,20,allow,1,0,Potential Threat
49997,53,41448,53,284,94,190,2,29,1,1,allow,0,0,Normal
46484,22,46484,22,7922,3413,4509,55,38,26,29,allow,1,0,Potential Threat
26900,27017,22476,27017,422,164,258,6,30,3,3,allow,1,0,Potential Threat
27005,27058,26884,27058,908,126,782,2,31,1,1,allow,1,0,Potential Threat
63733,47013,45780,47013,66,66,0,2,8,2,0,allow,1,0,Potential Threat
59308,443,6790,443,12169,4963,7206,60,262,31,29,allow,1,0,Potential Threat
6889,48817,0,0,143,143,0,1,0,1,0,deny,1,1,High Risk
59810,6004,0,0,66,66,0,1,0,1,0,deny,0,1,Known Attack
49577,53,36536,53,242,94,148,2,30,1,1,allow,0,0,Normal
58822,443,40826,443,3594,1787,1807,31,163,17,14,allow,1,0,Potential Threat
59723,443,40207,443,304,86,218,2,30,1,1,allow,0,0,Normal
57164,50584,0,0,62,62,0,1,0,1,0,deny,0,1,Known Attack
50281,5223,28986,5223,208,60,148,4,11,2,2,allow,1,0,Potential Threat
34001,53,36189,53,225,78,147,2,30,1,1,allow,0,0,Normal
51778,60565,33068,60565,70,70,0,1,5,1,0,allow,1,0,Potential Threat
65497,53,19517,53,490,111,379,4,54,2,2,allow,0,0,Normal
58638,5900,0,0,62,62,0,1,0,1,0,deny,0,1,Known Attack
40967,443,61086,443,1786,172,1614,7,121,3,4,allow,1,0,Potential Threat
50545,445,0,0,66,66,0,1,0,1,0,drop,0,1,Known Attack
52141,445,0,0,66,66,0,1,0,1,0,drop,0,1,Known Attack
52150,37603,39264,37603,70,70,0,2,7,2,0,allow,1,0,Potential Threat
10736,6112,0,0,60,60,0,1,0,1,0,deny,0,1,Known Attack
50202,53,17431,53,166,86,80,2,30,1,1,allow,0,0,Normal
43542,53,13639,53,168,78,90,2,30,1,1,allow,0,0,Normal
59093,53,0,0,215,77,138,2,31,1,1,allow,0,0,Normal
49505,443,2441,443,35158,5065,30093,53,42,18,35,allow,1,0,Potential Threat
65236,53,5620,53,758,102,656,2,30,1,1,allow,0,0,Normal
55590,443,56220,443,7906,1569,6337,20,150,9,11,allow,1,0,Potential Threat
60617,64147,0,0,62,62,0,1,0,1,0,deny,1,1,High Risk
64190,445,0,0,70,70,0,1,0,1,0,drop,0,1,Known Attack
64850,53,55584,53,167,86,81,2,30,1,1,allow,0,0,Normal
49455,443,62985,443,12386,1821,10565,23,33,11,12,allow,1,0,Potential Threat
54146,445,0,0,70,70,0,1,0,1,0,drop,0,1,Known Attack
7844,22114,0,0,66,66,0,1,0,1,0,deny,1,1,High Risk
55850,443,8932,443,2883,642,2241,13,135,6,7,allow,1,0,Potential Threat
42386,443,40078,443,10424,3393,7031,31,274,16,15,allow,1,0,Potential Threat
50892,443,40533,443,8057,1135,6922,19,129,9,10,allow,1,0,Potential Threat
55606,445,0,0,66,66,0,1,0,1,0,drop,0,1,Known Attack
51980,80,2288,80,366,240,126,7,25,5,2,allow,0,0,Normal
5223,14446,0,0,220,220,0,1,0,1,0,deny,1,1,High Risk
38276,443,11817,443,600,156,444,8,25,2,6,allow,1,0,Potential Threat
35558,15503,0,0,66,66,0,1,0,1,0,deny,0,1,Known Attack
50292,443,41099,443,183024,16754,166270,247,28,114,133,allow,1,0,Potential Threat
45981,51505,0,0,62,62,0,1,0,1,0,deny,0,1,Known Attack
60987,445,0,0,70,70,0,1,0,1,0,drop,0,1,Known Attack
28474,3389,28474,3389,3850,1745,2105,19,18,11,8,allow,1,0,Potential Threat
42974,53,0,0,82,82,0,1,30,1,0,allow,0,0,Normal
58856,443,36240,443,6350667,198580,6152087,6885,451,2497,4388,allow,1,0,Potential Threat
57575,443,57575,443,206737,25710,181027,212,180,75,137,allow,1,0,Potential Threat
55714,445,0,0,70,70,0,1,0,1,0,drop,0,1,Known Attack
13027,64147,0,0,62,62,0,1,0,1,0,deny,1,1,High Risk
60450,56494,22867,56494,70,70,0,2,8,2,0,allow,1,0,Potential Threat
49824,445,0,0,66,66,0,1,0,1,0,drop,0,1,Known Attack
51393,443,1567,443,4721,2724,1997,35,130,19,16,allow,1,0,Potential Threat
60872,443,25312,443,27204,15677,11527,59,62,30,29,allow,1,0,Potential Threat
61703,80,42538,80,1494,954,540,13,51,8,5,allow,1,0,Potential Threat
59823,443,6570,443,27406,15466,11940,123,188,62,61,allow,1,0,Potential Threat
60338,7000,60338,7000,3486,1983,1503,15,16,8,7,allow,1,0,Potential Threat
51221,51413,20920,51413,459,149,310,2,1200,1,1,allow,1,0,Potential Threat
55123,53,24178,53,295,86,209,2,30,1,1,allow,0,0,Normal
37965,63728,43778,63728,1294,594,700,20,1781,10,10,allow,1,0,Potential Threat
49913,443,65032,443,976,589,387,10,76,6,4,allow,1,0,Potential Threat
4748,64147,0,0,66,66,0,1,0,1,0,deny,1,1,High Risk
53979,26308,29256,26308,70,70,0,1,4,1,0,allow,1,0,Potential Threat
50495,53,47068,53,195,102,93,2,30,1,1,allow,0,0,Normal
49869,80,36356,80,43386,3876,39510,79,22,42,37,allow,1,0,Potential Threat
49740,53,20655,53,793,101,692,2,31,1,1,allow,0,0,Normal
56397,53,62027,53,179,94,85,2,30,1,1,allow,0,0,Normal
55800,53,32257,53,177,94,83,2,30,1,1,allow,0,0,Normal
58226,52848,0,0,62,62,0,1,0,1,0,deny,0,1,Known Attack
11136,19910,0,0,62,62,0,1,0,1,0,deny,0,1,Known Attack
38057,443,24418,443,9486,2668,6818,26,81,14,12,allow,1,0,Potential Threat
64016,53,54267,53,183,94,89,2,30,1,1,allow,0,0,Normal
64418,445,0,0,70,70,0,1,0,1,0,drop,0,1,Known Attack
50257,443,7570,443,249660,21361,228299,416,141,191,225,allow,1,0,Potential Threat
53757,443,15611,443,499,425,74,4,0,3,1,allow,0,0,Normal
64280,53,51701,53,211,94,117,2,30,1,1,allow,0,0,Normal
53104,445,0,0,70,70,0,1,0,1,0,drop,0,1,Known Attack
53916,23505,33630,23505,70,70,0,2,7,2,0,allow,1,0,Potential Threat
49876,80,23793,80,24764,4454,20310,30,88,12,18,allow,1,0,Potential Threat
56007,53,28468,53,197,102,95,2,33,1,1,allow,0,0,Normal
50580,443,63411,443,2604,1413,1191,15,98,9,6,allow,1,0,Potential Threat
54807,445,0,0,66,66,0,1,0,1,0,drop,0,1,Known Attack
56812,443,43977,443,11568,9158,2410,42,80,23,19,allow,1,0,Potential Threat
60710,53,32625,53,211,78,133,2,30,1,1,allow,0,0,Normal
51409,443,64493,443,36713,3193,33520,57,623,23,34,allow,1,0,Potential Threat
50052,65008,0,0,60,60,0,1,0,1,0,deny,1,1,High Risk
56318,53,21992,53,183,94,89,2,29,1,1,allow,0,0,Normal
35738,80,42244,80,1151,711,440,10,16,5,5,allow,1,0,Potential Threat
2267,53,13184,53,826,826,0,8,44,8,0,allow,1,0,Potential Threat
64657,53,12172,53,312,94,218,2,30,1,1,allow,0,0,Normal
40430,80,30893,80,1566,754,812,10,15,6,4,allow,1,0,Potential Threat
60923,445,0,0,70,70,0,1,0,1,0,drop,0,1,Known Attack
57994,443,19602,443,14465,1797,12668,30,170,14,16,allow,1,0,Potential Threat
37460,443,43570,443,5674,3900,1774,29,80,15,14,allow,1,0,Potential Threat
52093,445,0,0,70,70,0,1,0,1,0,drop,0,1,Known Attack
57470,61467,29646,61467,479,150,329,2,1199,1,1,allow,1,0,Potential Threat
62229,445,0,0,66,66,0,1,0,1,0,drop,0,1,Known Attack
52699,25174,0,0,66,66,0,1,0,1,0,deny,0,1,Known Attack
64796,53,48263,53,184,94,90,2,31,1,1,allow,0,0,Normal
58334,5223,0,0,148,148,0,1,0,1,0,deny,0,1,Known Attack
51430,25174,0,0,62,62,0,1,0,1,0,deny,0,1,Known Attack
34989,80,37174,80,350,210,140,6,28,4,2,allow,0,0,Normal
55966,57866,0,0,62,62,0,1,0,1,0,deny,1,1,High Risk
55850,445,0,0,70,70,0,1,0,1,0,drop,0,1,Known Attack
443,47582,0,0,100,100,0,1,0,1,0,deny,1,1,High Risk
49524,80,21220,80,1401,828,573,11,38,6,5,allow,0,0,Normal
60450,56494,22389,56494,70,70,0,1,5,1,0,allow,1,0,Potential Threat
52386,445,0,0,70,70,0,1,0,1,0,drop,0,1,Known Attack
45941,23386,0,0,60,60,0,1,0,1,0,deny,0,1,Known Attack
17097,62413,0,0,62,62,0,1,0,1,0,deny,1,1,High Risk
63638,53,10182,53,286,78,208,2,30,1,1,allow,0,0,Normal
64914,53,14005,53,224,94,130,2,30,1,1,allow,0,0,Normal
50990,53,51984,53,232,94,138,2,29,1,1,allow,0,0,Normal
59812,443,39961,443,6412,1530,4882,24,255,11,13,allow,1,0,Potential Threat
56704,445,0,0,66,66,0,1,0,1,0,drop,0,1,Known Attack
64921,445,0,0,66,66,0,1,0,1,0,drop,0,1,Known Attack
44219,443,26012,443,35920,26656,9264,60,128,30,30,allow,1,0,Potential Threat
64323,53,64062,53,195,102,93,2,30,1,1,allow,1,0,Potential Threat
18061,25174,0,0,62,62,0,1,0,1,0,deny,0,1,Known Attack
56769,11155,9985,11155,70,70,0,2,8,2,0,allow,1,0,Potential Threat
50355,43890,0,0,66,66,0,1,0,1,0,deny,0,1,Known Attack
50407,8080,50407,8080,378,180,198,7,33,4,3,allow,1,0,Potential Threat
51706,25174,0,0,66,66,0,1,0,1,0,deny,0,1,Known Attack
49717,666,0,0,60,60,0,1,0,1,0,deny,0,1,Known Attack
55736,445,0,0,66,66,0,1,0,1,0,drop,0,1,Known Attack
49726,445,0,0,70,70,0,1,0,1,0,drop,0,1,Known Attack
49418,27001,35049,27001,256,78,178,2,30,1,1,allow,1,0,Potential Threat
57470,31112,14070,31112,132,132,0,3,1199,3,0,allow,1,0,Potential Threat
48817,51634,48817,51634,480,149,331,2,1200,1,1,allow,1,0,Potential Threat
13840,37965,0,0,146,146,0,1,0,1,0,deny,1,1,High Risk
9482,443,2770,443,5657,487,5170,14,15,7,7,allow,1,0,Potential Threat
62130,445,0,0,70,70,0,1,0,1,0,drop,0,1,Known Attack
60628,445,0,0,70,70,0,1,0,1,0,drop,0,1,Known Attack
50561,55777,0,0,62,62,0,1,0,1,0,deny,0,1,Known Attack
54968,53,43253,53,199,102,97,2,30,1,1,allow,0,0,Normal
53721,443,43069,443,70,70,0,2,7,2,0,allow,0,0,Normal
50984,443,27569,443,8023,3352,4671,19,80,11,8,allow,1,0,Potential Threat
58511,50584,0,0,62,62,0,1,0,1,0,deny,0,1,Known Attack
61555,445,0,0,70,70,0,1,0,1,0,drop,0,1,Known Attack
58980,445,0,0,70,70,0,1,0,1,0,drop,0,1,Known Attack
64825,445,0,0,70,70,0,1,0,1,0,drop,0,1,Known Attack
50279,443,56387,443,1786,172,1614,7,119,3,4,allow,1,0,Potential Threat
58384,445,0,0,70,70,0,1,0,1,0,drop,0,1,Known Attack
35101,443,31000,443,4988930,161289,4827641,5384,290,1964,3420,allow,1,0,Potential Threat
35486,443,63942,443,4630,2803,1827,29,80,14,15,allow,1,0,Potential Threat
56837,53,12687,53,180,94,86,2,30,1,1,allow,0,0,Normal
55710,445,0,0,70,70,0,1,0,1,0,drop,0,1,Known Attack
10775,35440,0,0,66,66,0,1,0,1,0,deny,1,1,High Risk
50824,445,0,0,66,66,0,1,0,1,0,drop,0,1,Known Attack
1227,56205,0,0,66,66,0,1,0,1,0,deny,1,1,High Risk
65371,53,39965,53,198,101,97,2,31,1,1,allow,0,0,Normal
35001,53,37388,53,78,78,0,1,30,1,0,allow,0,0,Normal
65072,445,0,0,70,70,0,1,0,1,0,drop,0,1,Known Attack
49753,445,0,0,70,70,0,1,0,1,0,drop,0,1,Known Attack
58638,5900,0,0,62,62,0,1,0,1,0,deny,0,1,Known Attack
27005,50003,20006,50003,887,126,761,2,31,1,1,allow,1,0,Potential Threat
55679,445,0,0,70,70,0,1,0,1,0,drop,0,1,Known Attack
61133,445,0,0,66,66,0,1,0,1,0,drop,0,1,Known Attack
25565,20455,0,0,60,60,0,1,0,1,0,deny,0,1,Known Attack
46085,443,28925,443,13018,2021,10997,34,95,14,20,allow,1,0,Potential Threat
443,62732,0,0,199,199,0,1,0,1,0,deny,1,1,High Risk
27841,35894,0,0,62,62,0,1,0,1,0,deny,0,1,Known Attack
49881,445,0,0,70,70,0,1,0,1,0,drop,0,1,Known Attack
51282,443,3652,443,4933,2248,2685,14,135,7,7,allow,1,0,Potential Threat
50728,27029,42888,27029,269,78,191,2,31,1,1,allow,1,0,Potential Threat
54826,56205,0,0,62,62,0,1,0,1,0,deny,0,1,Known Attack
63595,445,0,0,70,70,0,1,0,1,0,drop,0,1,Known Attack
63855,25174,0,0,62,62,0,1,0,1,0,deny,0,1,Known Attack
54967,445,0,0,66,66,0,1,0,1,0,drop,0,1,Known Attack
64872,53,35777,53,164,84,80,2,30,1,1,allow,0,0,Normal
57375,53,63119,53,198,102,96,2,30,1,1,allow,1,0,Potential Threat
56013,443,56013,443,4599,1692,2907,19,26,11,8,allow,1,0,Potential Threat
55820,53,49464,53,184,94,90,2,30,1,1,allow,0,0,Normal
56750,53,47077,53,711,87,624,2,30,1,1,allow,0,0,Normal
50630,445,0,0,70,70,0,1,0,1,0,drop,0,1,Known Attack
52176,445,0,0,70,70,0,1,0,1,0,drop,0,1,Known Attack
56618,445,0,0,70,70,0,1,0,1,0,drop,0,1,Known Attack
62115,57470,0,0,66,66,0,1,0,1,0,deny,1,1,High Risk
45963,443,45963,443,4592,1685,2907,19,27,11,8,allow,1,0,Potential Threat
49326,53,62713,53,193,102,91,2,30,1,1,allow,0,0,Normal
59599,62413,0,0,62,62,0,1,0,1,0,deny,1,1,High Risk
57654,35440,0,0,66,66,0,1,0,1,0,deny,0,1,Known Attack
58014,443,11079,443,5528,3392,2136,31,80,16,15,allow,1,0,Potential Threat
57431,15503,0,0,66,66,0,1,0,1,0,deny,0,1,Known Attack
61859,445,0,0,70,70,0,1,0,1,0,drop,0,1,Known Attack
56138,53,22955,53,177,94,83,2,30,1,1,allow,0,0,Normal
49562,80,14517,80,318,192,126,6,45,4,2,allow,0,0,Normal
14923,51505,0,0,66,66,0,1,0,1,0,deny,1,1,High Risk
55591,53,62499,53,195,102,93,2,31,1,1,allow,0,0,Normal
61440,445,0,0,70,70,0,1,0,1,0,drop,0,1,Known Attack
0,0,0,0,98,98,0,1,0,1,0,deny,1,1,High Risk
54348,443,31489,443,27760,9709,18051,56,45,27,29,allow,1,0,Potential Threat
65015,22114,0,0,62,62,0,1,0,1,0,deny,0,1,Known Attack
57324,445,0,0,70,70,0,1,0,1,0,drop,0,1,Known Attack
40108,23,0,0,60,60,0,1,0,1,0,deny,0,1,Known Attack
56357,53,52220,53,172,88,84,2,30,1,1,allow,0,0,Normal
49418,27016,33402,27016,259,78,181,2,29,1,1,allow,1,0,Potential Threat
54242,445,0,0,70,70,0,1,0,1,0,drop,0,1,Known Attack
27005,27015,3616,27015,887,126,761,2,30,1,1,allow,1,0,Potential Threat
54216,64147,0,0,66,66,0,1,0,1,0,deny,1,1,High Risk
51073,443,23186,443,7343,2672,4671,20,76,12,8,allow,1,0,Potential Threat
64122,443,27502,443,5121090,119252,5001838,5000,55,1680,3320,allow,1,0,Potential Threat
59881,443,61673,443,302,120,182,6,31,3,3,allow,1,0,Potential Threat
5588,5588,0,0,3498,1872,1626,48,205,24,24,allow,1,0,Potential Threat
44792,443,44086,443,9700,2137,7563,21,16,12,9,allow,1,0,Potential Threat
64221,53,19919,53,262,102,160,2,30,1,1,allow,0,0,Normal
10265,64147,0,0,66,66,0,1,0,1,0,deny,1,1,High Risk
59147,51505,0,0,66,66,0,1,0,1,0,deny,0,1,Known Attack
49835,53,10267,53,199,94,105,2,31,1,1,allow,0,0,Normal
11136,17500,0,0,62,62,0,1,0,1,0,deny,0,1,Known Attack
53961,13067,4497,13067,70,70,0,1,5,1,0,allow,1,0,Potential Threat
41381,23,0,0,60,60,0,1,0,1,0,deny,0,1,Known Attack
45964,55559,0,0,60,60,0,1,0,1,0,deny,1,1,High Risk
58206,445,0,0,66,66,0,1,0,1,0,drop,0,1,Known Attack
55288,443,7334,443,15679,1532,14147,16,139,3,13,allow,1,0,Potential Threat
9743,23,0,0,60,60,0,1,0,1,0,deny,0,1,Known Attack
51027,445,0,0,70,70,0,1,0,1,0,drop,0,1,Known Attack
58686,18375,0,0,66,66,0,1,0,1,0,deny,0,1,Known Attack
13334,41615,0,0,145,145,0,1,0,1,0,deny,1,1,High Risk
4788,53,4788,53,825,99,726,2,0,1,1,allow,1,0,Potential Threat
64559,53,32115,53,193,102,91,2,29,1,1,allow,0,0,Normal
50920,445,0,0,66,66,0,1,0,1,0,drop,0,1,Known Attack
58553,445,0,0,66,66,0,1,0,1,0,drop,0,1,Known Attack
23066,443,23066,443,5573,2434,3139,21,25,12,9,allow,1,0,Potential Threat
63038,53,49856,53,303,85,218,2,31,1,1,allow,0,0,Normal
51957,53,51957,53,825,99,726,2,31,1,1,allow,0,0,Normal
49304,443,52179,443,932965,16289,916676,768,65,148,620,allow,1,0,Potential Threat
39233,53,39233,53,235,90,145,2,33,1,1,allow,0,0,Normal
56770,443,61506,443,5829,2962,2867,35,89,17,18,allow,1,0,Potential Threat
38848,11119,0,0,146,146,0,1,0,1,0,deny,0,1,Known Attack
50610,80,53401,80,3726,1504,2222,13,21,7,6,allow,1,0,Potential Threat
49663,80,43225,80,8935,3175,5760,17,41,8,9,allow,1,0,Potential Threat
39915,443,23556,443,27886,17603,10283,138,462,76,62,allow,1,0,Potential Threat
58582,50584,0,0,66,66,0,1,0,1,0,deny,0,1,Known Attack
64320,53,33961,53,198,101,97,2,30,1,1,allow,0,0,Normal
62150,23718,0,0,66,66,0,1,0,1,0,deny,0,1,Known Attack
56226,53,12248,53,284,96,188,4,33,2,2,allow,0,0,Normal
59647,47993,0,0,66,66,0,1,0,1,0,deny,0,1,Known Attack
9443,443,55182,443,7398,1480,5918,24,39,12,12,allow,1,0,Potential Threat
50674,445,0,0,66,66,0,1,0,1,0,drop,0,1,Known Attack
443,43775,0,0,97,97,0,1,0,1,0,deny,1,1,High Risk
51167,445,0,0,70,70,0,1,0,1,0,drop,0,1,Known Attack
58255,445,0,0,70,70,0,1,0,1,0,drop,0,1,Known Attack
64167,445,0,0,66,66,0,1,0,1,0,drop,0,1,Known Attack
49560,443,58104,443,13516,6981,6535,61,2149,34,27,allow,1,0,Potential Threat
37591,443,50251,443,499,425,74,4,0,3,1,allow,1,0,Potential Threat
57798,445,0,0,70,70,0,1,0,1,0,drop,0,1,Known Attack
53667,49160,27701,49160,320,140,180,6,7,3,3,allow,1,0,Potential Threat
2075,7000,2075,7000,5850,4395,1455,18,15,10,8,allow,1,0,Potential Threat
54666,36237,0,0,62,62,0,1,0,1,0,deny,0,1,Known Attack
54551,445,0,0,66,66,0,1,0,1,0,drop,0,1,Known Attack
49336,25174,0,0,66,66,0,1,0,1,0,deny,0,1,Known Attack
57714,53,57714,53,233,90,143,2,32,1,1,allow,0,0,Normal
65285,50584,0,0,62,62,0,1,0,1,0,deny,1,1,High Risk
63795,52376,47084,52376,66,66,0,2,8,2,0,allow,1,0,Potential Threat
65379,443,56474,443,4514,2844,1670,29,84,14,15,allow,1,0,Potential Threat
3478,61463,0,0,857,857,0,1,0,1,0,deny,1,1,High Risk
57470,41024,3847,41024,330,330,0,6,1200,6,0,allow,1,0,Potential Threat
58664,53,10827,53,167,78,89,2,29,1,1,allow,0,0,Normal
33822,57470,0,0,66,66,0,1,0,1,0,deny,1,1,High Risk
11983,57470,0,0,62,62,0,1,0,1,0,deny,1,1,High Risk
56376,53,65133,53,198,102,96,2,30,1,1,allow,1,0,Potential Threat
56806,46903,25071,46903,3060,1569,1491,12,17,7,5,allow,1,0,Potential Threat
65511,445,0,0,70,70,0,1,0,1,0,drop,0,1,Known Attack
30129,37965,0,0,72,72,0,1,0,1,0,deny,0,1,Known Attack
48067,443,48553,443,12648,5285,7363,58,32,27,31,allow,1,0,Potential Threat
63577,30188,0,0,66,66,0,1,0,1,0,deny,0,1,Known Attack
52072,445,0,0,70,70,0,1,0,1,0,drop,0,1,Known Attack
60380,443,36908,443,24243,17180,7063,52,97,33,19,allow,1,0,Potential Threat
37965,15357,58016,15357,481,150,331,2,1200,1,1,allow,1,0,Potential Threat
57010,445,0,0,70,70,0,1,0,1,0,drop,0,1,Known Attack
53917,443,58017,443,499,425,74,4,0,3,1,allow,0,0,Normal
55022,53,45433,53,195,102,93,2,30,1,1,allow,0,0,Normal
54966,443,5878,443,4645,2498,2147,14,135,7,7,allow,1,0,Potential Threat
58034,443,56445,443,4132,2158,1974,35,255,17,18,allow,1,0,Potential Threat
9160,443,28992,443,5727,491,5236,14,15,7,7,allow,1,0,Potential Threat
55636,80,55636,80,1916,1467,449,10,19,6,4,allow,1,0,Potential Threat
16027,22,0,0,60,60,0,1,0,1,0,deny,0,1,Known Attack
53983,40500,52248,40500,70,70,0,2,7,2,0,allow,1,0,Potential Threat
51827,48432,31400,48432,160,70,90,2,4,1,1,allow,1,0,Potential Threat
57393,48983,0,0,146,146,0,1,0,1,0,deny,1,1,High Risk
49671,443,7194,443,1485,940,545,13,57,7,6,allow,1,0,Potential Threat
56453,53,58094,53,243,94,149,2,30,1,1,allow,0,0,Normal
53764,443,39809,443,8115,1962,6153,24,18,14,10,allow,1,0,Potential Threat
56459,53,48405,53,177,94,83,2,30,1,1,allow,0,0,Normal
49293,5223,22335,5223,202,142,60,2,15,1,1,allow,0,0,Normal
57470,51745,40205,51745,3214,1260,1954,33,1371,17,16,allow,1,0,Potential Threat
8283,52443,34417,52443,130,70,60,2,30,1,1,allow,1,0,Potential Threat
56086,53,3627,53,172,94,78,2,30,1,1,allow,0,0,Normal
19302,443,26733,443,2227,1018,1209,17,15,8,9,allow,1,0,Potential Threat
50537,445,0,0,66,66,0,1,0,1,0,drop,0,1,Known Attack
58057,443,19504,443,6821,1076,5745,21,38,12,9,allow,1,0,Potential Threat
25595,2323,0,0,60,60,0,1,0,1,0,deny,0,1,Known Attack
52447,43890,0,0,62,62,0,1,0,1,0,deny,0,1,Known Attack
53109,80,20052,80,8176,1443,6733,20,15,10,10,allow,1,0,Potential Threat
17251,10387,0,0,159,159,0,1,0,1,0,deny,1,1,High Risk
49372,53,37424,53,216,110,106,2,30,1,1,allow,0,0,Normal
55454,53,60300,53,168,86,82,2,33,1,1,allow,0,0,Normal
53720,443,24279,443,499,425,74,4,0,3,1,allow,0,0,Normal
62787,445,0,0,70,70,0,1,0,1,0,drop,0,1,Known Attack
44358,443,57886,443,502,288,214,8,131,5,3,allow,1,0,Potential Threat
56091,53,8508,53,771,101,670,2,31,1,1,allow,0,0,Normal
64303,53,57962,53,177,94,83,2,29,1,1,allow,0,0,Normal
65524,53,37598,53,183,94,89,2,30,1,1,allow,0,0,Normal
7041,37965,0,0,62,62,0,1,0,1,0,deny,1,1,High Risk
51151,64147,0,0,66,66,0,1,0,1,0,deny,1,1,High Risk
18203,23,0,0,60,60,0,1,0,1,0,deny,0,1,Known Attack
33044,443,11890,443,9695,5259,4436,24,35,12,12,allow,1,0,Potential Threat
64797,80,54604,80,378,192,186,7,71,4,3,allow,1,0,Potential Threat
0,0,0,0,156,156,0,2,0,2,0,deny,1,1,High Risk
55640,54435,42654,54435,70,70,0,1,5,1,0,allow,1,0,Potential Threat
19963,2767,0,0,66,66,0,1,0,1,0,deny,0,1,Known Attack
56293,53,25636,53,166,86,80,2,30,1,1,allow,0,0,Normal
58638,5900,0,0,62,62,0,1,0,1,0,deny,0,1,Known Attack
57618,80,57618,80,265909,7294,258615,235,25,55,180,allow,1,0,Potential Threat
51951,80,24462,80,1265,642,623,12,45,7,5,allow,0,0,Normal
13287,16933,0,0,62,62,0,1,0,1,0,deny,0,1,Known Attack
30765,56205,0,0,66,66,0,1,0,1,0,deny,1,1,High Risk
65378,53,49018,53,212,102,110,2,30,1,1,allow,0,0,Normal
65136,53,56790,53,335,84,251,4,32,2,2,allow,1,0,Potential Threat
31619,51221,0,0,62,62,0,1,0,1,0,deny,1,1,High Risk
64631,445,0,0,70,70,0,1,0,1,0,drop,0,1,Known Attack
53126,53,53126,53,247,98,149,2,32,1,1,allow,0,0,Normal
63816,2073,29145,2073,66,66,0,2,7,2,0,allow,1,0,Potential Threat
42388,161,0,0,109,109,0,2,35,2,0,allow,0,0,Normal
52770,445,0,0,70,70,0,1,0,1,0,drop,0,1,Known Attack
38678,443,31559,443,484,210,274,8,26,4,4,allow,0,0,Normal
57283,64147,0,0,66,66,0,1,0,1,0,deny,1,1,High Risk
57004,80,5611,80,214,140,74,4,30,3,1,allow,0,0,Normal
53316,445,0,0,70,70,0,1,0,1,0,drop,0,1,Known Attack
57545,35440,0,0,66,66,0,1,0,1,0,deny,0,1,Known Attack
39057,443,14567,443,70,70,0,1,5,1,0,allow,0,0,Normal
16293,57470,0,0,62,62,0,1,0,1,0,deny,1,1,High Risk
56455,53,54287,53,183,94,89,2,31,1,1,allow,0,0,Normal
16327,55442,0,0,66,66,0,1,0,1,0,deny,1,1,High Risk
57052,443,57052,443,4616,1709,2907,19,28,11,8,allow,1,0,Potential Threat
45013,50584,0,0,146,146,0,1,0,1,0,deny,1,1,High Risk
40742,2967,0,0,62,62,0,1,0,1,0,deny,0,1,Known Attack
64579,53,56844,53,178,94,84,2,30,1,1,allow,0,0,Normal
60717,445,0,0,70,70,0,1,0,1,0,drop,0,1,Known Attack
50929,445,0,0,66,66,0,1,0,1,0,drop,0,1,Known Attack
55454,53,34563,53,321,105,216,4,40,2,2,allow,0,0,Normal
26048,21,0,0,60,60,0,1,0,1,0,deny,0,1,Known Attack
51672,445,0,0,70,70,0,1,0,1,0,drop,0,1,Known Attack
64036,53,62200,53,183,94,89,2,29,1,1,allow,1,0,Potential Threat
40214,443,5611,443,3910,2223,1687,24,3676,8,16,allow,1,0,Potential Threat
58952,445,0,0,66,66,0,1,0,1,0,drop,0,1,Known Attack
58638,5900,0,0,62,62,0,1,0,1,0,deny,0,1,Known Attack
55487,53,48616,53,199,102,97,2,29,1,1,allow,0,0,Normal
8999,1,0,0,146,146,0,1,0,1,0,deny,0,1,Known Attack
52292,445,0,0,70,70,0,1,0,1,0,drop,0,1,Known Attack
35371,443,55003,443,304294,8535,295759,302,132,90,212,allow,1,0,Potential Threat
49665,80,35482,80,8457,3062,5395,16,41,7,9,allow,1,0,Potential Threat
65374,445,0,0,70,70,0,1,0,1,0,drop,0,1,Known Attack
51236,443,52300,443,7950,2502,5448,38,15,22,16,allow,1,0,Potential Threat
55661,445,0,0,66,66,0,1,0,1,0,drop,0,1,Known Attack
5115,53,5115,53,216,90,126,2,30,1,1,allow,1,0,Potential Threat
49971,445,0,0,70,70,0,1,0,1,0,drop,0,1,Known Attack
53942,28921,35066,28921,320,140,180,6,6,3,3,allow,1,0,Potential Threat
55533,53,30263,53,816,97,719,2,31,1,1,allow,0,0,Normal
54776,443,51403,443,9501,1502,7999,24,29,13,11,allow,1,0,Potential Threat
55209,53,9446,53,98,98,0,1,30,1,0,allow,0,0,Normal
8430,53,21349,53,80361,77433,2928,946,89,930,16,allow,1,0,Potential Threat
57470,58125,57009,58125,1572,664,908,14,1200,9,5,allow,1,0,Potential Threat
36352,443,46352,443,3256,1753,1503,17,315,10,7,allow,1,0,Potential Threat
30188,17677,54608,17677,11116,4642,6474,64,1457,30,34,allow,1,0,Potential Threat
56617,3389,56617,3389,3425,1470,1955,16,17,8,8,allow,1,0,Potential Threat
61838,53,61838,53,216,90,126,2,30,1,1,allow,0,0,Normal
63976,53,54023,53,200,102,98,2,33,1,1,allow,0,0,Normal
62331,445,0,0,70,70,0,1,0,1,0,drop,0,1,Known Attack
59651,445,0,0,70,70,0,1,0,1,0,drop,0,1,Known Attack
52298,445,0,0,66,66,0,1,0,1,0,drop,0,1,Known Attack
34896,53,34896,53,231,90,141,2,30,1,1,allow,0,0,Normal
49876,53,42623,53,211,102,109,2,30,1,1,allow,0,0,Normal
64933,53,11327,53,349,94,255,2,30,1,1,allow,0,0,Normal
60907,443,25513,443,7477,3022,4455,27,45,15,12,allow,1,0,Potential Threat
55752,53,32253,53,177,94,83,2,30,1,1,allow,0,0,Normal
61068,445,0,0,70,70,0,1,0,1,0,drop,0,1,Known Attack
56973,445,0,0,70,70,0,1,0,1,0,drop,0,1,Known Attack
49577,53,58264,53,389,134,255,2,29,1,1,allow,0,0,Normal
62799,25174,0,0,146,146,0,1,0,1,0,deny,1,1,High Risk
1048,25174,0,0,62,62,0,1,0,1,0,deny,1,1,High Risk
16387,22272,0,0,60,60,0,1,0,1,0,deny,0,1,Known Attack
60911,445,0,0,70,70,0,1,0,1,0,drop,0,1,Known Attack
56753,44847,0,0,62,62,0,1,0,1,0,deny,0,1,Known Attack
49268,443,60948,443,77368,9874,67494,139,100,65,74,allow,1,0,Potential Threat
34215,443,33625,443,5341,1386,3955,19,649,11,8,allow,1,0,Potential Threat
57445,66,37294,66,70,70,0,2,8,2,0,allow,0,0,Normal
27721,53,27721,53,404,259,145,3,32,2,1,allow,1,0,Potential Threat
57144,53,3454,53,172,88,84,2,31,1,1,allow,0,0,Normal
58598,50584,0,0,66,66,0,1,0,1,0,deny,0,1,Known Attack
62283,445,0,0,66,66,0,1,0,1,0,drop,0,1,Known Attack
53729,40721,59100,40721,70,70,0,2,8,2,0,allow,1,0,Potential Threat
38017,7275,45146,7275,4615,664,3951,15,15,9,6,allow,1,0,Potential Threat
63138,51452,48571,51452,70,70,0,2,8,2,0,allow,1,0,Potential Threat
60693,445,0,0,66,66,0,1,0,1,0,drop,0,1,Known Attack
50422,445,0,0,66,66,0,1,0,1,0,drop,0,1,Known Attack
56479,445,0,0,66,66,0,1,0,1,0,drop,0,1,Known Attack
63331,51221,0,0,62,62,0,1,0,1,0,deny,1,1,High Risk
6881,55108,0,0,143,143,0,1,0,1,0,deny,1,1,High Risk
49935,445,0,0,70,70,0,1,0,1,0,drop,0,1,Known Attack
58426,445,0,0,66,66,0,1,0,1,0,drop,0,1,Known Attack
62395,445,0,0,70,70,0,1,0,1,0,drop,0,1,Known Attack
55217,53,28752,53,189,102,87,2,30,1,1,allow,0,0,Normal
65418,445,0,0,70,70,0,1,0,1,0,drop,0,1,Known Attack
0,0,0,0,124,64,60,2,0,1,1,allow,1,0,Potential Threat
51259,445,0,0,70,70,0,1,0,1,0,drop,0,1,Known Attack
37555,16385,34137,16385,130,70,60,2,30,1,1,allow,1,0,Potential Threat
48706,23393,0,0,60,60,0,1,0,1,0,deny,0,1,Known Attack
54978,80,11814,80,1448,539,909,17,32,9,8,allow,0,0,Normal
2932,44847,0,0,66,66,0,1,0,1,0,deny,1,1,High Risk
56596,53,38999,53,188,96,92,2,31,1,1,allow,0,0,Normal
50615,445,0,0,70,70,0,1,0,1,0,drop,0,1,Known Attack
48768,443,48768,443,4398,1491,2907,19,27,11,8,allow,1,0,Potential Threat
60600,445,0,0,70,70,0,1,0,1,0,drop,0,1,Known Attack
42663,80,49274,80,5562,1204,4358,11,91,7,4,allow,1,0,Potential Threat
63587,22114,0,0,62,62,0,1,0,1,0,deny,0,1,Known Attack
60415,443,32364,443,7727,2796,4931,36,104,18,18,allow,1,0,Potential Threat
51712,445,0,0,70,70,0,1,0,1,0,drop,0,1,Known Attack
20012,8443,0,0,60,60,0,1,0,1,0,deny,0,1,Known Attack
50887,80,30027,80,256649,11414,245235,280,141,111,169,allow,1,0,Potential Threat
64422,53,42337,53,176,90,86,2,30,1,1,allow,0,0,Normal
50265,50262,19967,50262,3758,2456,1302,52,2355,31,21,allow,1,0,Potential Threat
56717,80,40230,80,3894448,104279,3790169,4041,97,1411,2630,allow,1,0,Potential Threat
55532,445,0,0,70,70,0,1,0,1,0,drop,0,1,Known Attack
30456,36237,0,0,62,62,0,1,0,1,0,deny,0,1,Known Attack
45294,443,12924,443,6290,4832,1458,18,120,11,7,allow,1,0,Potential Threat
62759,443,5744,443,9928,5183,4745,34,134,17,17,allow,1,0,Potential Threat
48605,50584,0,0,146,146,0,1,0,1,0,deny,1,1,High Risk
38011,443,62208,443,14337,3375,10962,47,121,23,24,allow,1,0,Potential Threat
56015,53,32700,53,190,97,93,2,31,1,1,allow,0,0,Normal
51045,445,0,0,70,70,0,1,0,1,0,drop,0,1,Known Attack
54429,53,0,0,195,70,125,2,30,1,1,allow,0,0,Normal
55209,53,7531,53,196,102,94,2,33,1,1,allow,0,0,Normal
29576,37807,0,0,66,66,0,1,0,1,0,deny,0,1,Known Attack
50207,53,41164,53,189,102,87,2,30,1,1,allow,0,0,Normal
49300,443,26110,443,8282,3240,5042,40,255,20,20,allow,1,0,Potential Threat
58365,5900,0,0,60,60,0,1,0,1,0,deny,0,1,Known Attack
55131,445,0,0,70,70,0,1,0,1,0,drop,0,1,Known Attack
24285,26467,0,0,62,62,0,1,0,1,0,deny,0,1,Known Attack
42685,51180,0,0,62,62,0,1,0,1,0,deny,0,1,Known Attack
6455,80,6455,80,326,186,140,6,29,4,2,allow,1,0,Potential Threat
54295,445,0,0,70,70,0,1,0,1,0,drop,0,1,Known Attack
60750,53,24428,53,198,93,105,2,30,1,1,allow,0,0,Normal
65387,53,24725,53,272,122,150,2,30,1,1,allow,0,0,Normal
6881,6881,0,0,146,146,0,1,0,1,0,deny,1,1,High Risk
26900,27017,49129,27017,422,164,258,6,30,3,3,allow,1,0,Potential Threat
12608,21247,0,0,66,66,0,1,0,1,0,deny,0,1,Known Attack
52025,80,59666,80,87927,9680,78247,101,37,40,61,allow,1,0,Potential Threat
60594,445,0,0,70,70,0,1,0,1,0,drop,0,1,Known Attack
3424,53,3424,53,216,88,128,2,30,1,1,allow,1,0,Potential Threat
58616,80,39662,80,1056,682,374,10,15,6,4,allow,0,0,Normal
52055,20019,40122,20019,316,136,180,6,7,3,3,allow,1,0,Potential Threat
1024,25174,0,0,146,146,0,1,0,1,0,deny,1,1,High Risk
56126,53,16372,53,774,101,673,2,31,1,1,allow,0,0,Normal
63403,443,54530,443,4470,1597,2873,16,138,8,8,allow,1,0,Potential Threat
52650,44847,0,0,66,66,0,1,0,1,0,deny,0,1,Known Attack
42986,25174,0,0,66,66,0,1,0,1,0,deny,0,1,Known Attack
61622,445,0,0,70,70,0,1,0,1,0,drop,0,1,Known Attack
18173,25174,0,0,66,66,0,1,0,1,0,deny,0,1,Known Attack
63141,55860,18547,55860,316,190,126,5,15,3,2,allow,1,0,Potential Threat
56770,53,63283,53,208,106,102,2,30,1,1,allow,1,0,Potential Threat
58977,37965,0,0,66,66,0,1,0,1,0,deny,0,1,Known Attack
64697,37965,0,0,66,66,0,1,0,1,0,deny,0,1,Known Attack
54087,443,2699,443,2637658,83234,2554424,2794,140,929,1865,allow,1,0,Potential Threat
49418,27016,5778,27016,263,78,185,2,29,1,1,allow,1,0,Potential Threat
55338,11744,0,0,145,145,0,1,0,1,0,deny,0,1,Known Attack
57500,37965,0,0,62,62,0,1,0,1,0,deny,0,1,Known Attack
44414,123,11306,123,184,94,90,2,30,1,1,allow,0,0,Normal
52604,25174,0,0,66,66,0,1,0,1,0,deny,0,1,Known Attack
58638,5900,0,0,62,62,0,1,0,1,0,deny,0,1,Known Attack
57470,13244,33439,13244,166,166,0,1,1199,1,0,allow,1,0,Potential Threat
57142,53,22612,53,165,86,79,2,31,1,1,allow,0,0,Normal
64913,53,26175,53,555,195,360,6,62,3,3,allow,1,0,Potential Threat
52001,80,32528,80,7578,4652,2926,49,323,30,19,allow,1,0,Potential Threat
61868,445,0,0,70,70,0,1,0,1,0,drop,0,1,Known Attack
57095,53,33152,53,177,94,83,2,30,1,1,allow,0,0,Normal
64316,53,59418,53,184,94,90,2,31,1,1,allow,0,0,Normal
24534,50584,0,0,146,146,0,1,0,1,0,deny,1,1,High Risk
44334,26467,0,0,62,62,0,1,0,1,0,deny,0,1,Known Attack
27005,33076,50946,33076,889,126,763,2,31,1,1,allow,1,0,Potential Threat
61788,20000,0,0,60,60,0,1,0,1,0,deny,0,1,Known Attack
46103,80,5613,80,70,70,0,2,5,2,0,allow,0,0,Normal
56629,53,53878,53,183,94,89,2,30,1,1,allow,0,0,Normal
64990,445,0,0,70,70,0,1,0,1,0,drop,0,1,Known Attack
51756,64147,0,0,66,66,0,1,0,1,0,deny,1,1,High Risk
36228,80,25190,80,1114,540,574,17,191,10,7,allow,1,0,Potential Threat
53685,445,0,0,70,70,0,1,0,1,0,drop,0,1,Known Attack
3478,61463,0,0,982,982,0,1,0,1,0,deny,1,1,High Risk
49279,53,50429,53,199,102,97,2,29,1,1,allow,0,0,Normal
51887,445,0,0,70,70,0,1,0,1,0,drop,0,1,Known Attack
64603,34021,0,0,66,66,0,1,90,1,0,allow,1,0,Potential Threat
56068,53,7794,53,152,78,74,2,30,1,1,allow,0,0,Normal
21588,52700,0,0,145,145,0,1,0,1,0,deny,1,1,High Risk
55868,445,0,0,66,66,0,1,0,1,0,drop,0,1,Known Attack
61742,445,0,0,70,70,0,1,0,1,0,drop,0,1,Known Attack
58058,445,0,0,66,66,0,1,0,1,0,drop,0,1,Known Attack
49812,443,22276,443,6128,1356,4772,20,978,10,10,allow,1,0,Potential Threat
56856,47715,25916,47715,66,66,0,1,5,1,0,allow,1,0,Potential Threat
55024,53,31814,53,179,94,85,2,30,1,1,allow,0,0,Normal
9130,80,10198,80,318,192,126,6,30,4,2,allow,1,0,Potential Threat
59201,51221,0,0,62,62,0,1,0,1,0,deny,0,1,Known Attack
59848,53,28215,53,239,102,137,2,30,1,1,allow,0,0,Normal
60075,445,0,0,70,70,0,1,0,1,0,drop,0,1,Known Attack
56691,445,0,0,66,66,0,1,0,1,0,drop,0,1,Known Attack
52148,80,52148,80,62796,1961,60835,72,141,26,46,allow,1,0,Potential Threat
52166,57975,14625,57975,70,70,0,2,8,2,0,allow,1,0,Potential Threat
51265,445,0,0,70,70,0,1,0,1,0,drop,0,1,Known Attack
65024,53,8030,53,295,101,194,4,33,2,2,allow,0,0,Normal
56699,443,19537,443,8006,1986,6020,20,15,11,9,allow,1,0,Potential Threat
59285,445,0,0,70,70,0,1,0,1,0,drop,0,1,Known Attack
59668,51505,0,0,62,62,0,1,0,1,0,deny,0,1,Known Attack
56123,445,0,0,66,66,0,1,0,1,0,drop,0,1,Known Attack
60058,25174,0,0,66,66,0,1,0,1,0,deny,0,1,Known Attack
50166,80,59884,80,2181,849,1332,14,97,7,7,allow,1,0,Potential Threat
49668,53,59883,53,200,94,106,2,29,1,1,allow,0,0,Normal
49845,53,47352,53,194,102,92,2,30,1,1,allow,0,0,Normal
51540,445,0,0,70,70,0,1,0,1,0,drop,0,1,Known Attack
37965,11102,8568,11102,132,132,0,3,1200,3,0,allow,1,0,Potential Threat
56816,11392,0,0,66,66,0,1,0,1,0,deny,0,1,Known Attack
55966,35440,0,0,62,62,0,1,0,1,0,deny,0,1,Known Attack
58638,5900,0,0,62,62,0,1,0,1,0,deny,0,1,Known Attack
40764,443,58656,443,3321,1297,2024,13,28,7,6,allow,1,0,Potential Threat
52522,80,14593,80,3290,2776,514,12,15,7,5,allow,1,0,Potential Threat
61689,445,0,0,70,70,0,1,0,1,0,drop,0,1,Known Attack
51591,80,40282,80,12683,8567,4116,53,271,33,20,allow,1,0,Potential Threat
38976,46824,0,0,62,62,0,1,0,1,0,deny,0,1,Known Attack
1369,48817,0,0,145,145,0,1,0,1,0,deny,1,1,High Risk
62919,9694,0,0,146,146,0,1,0,1,0,deny,0,1,Known Attack
30951,50584,0,0,62,62,0,1,0,1,0,deny,1,1,High Risk
43300,18242,0,0,62,62,0,1,60,1,0,allow,0,0,Normal
57082,80,34844,80,2944,1074,1870,12,75,7,5,allow,0,0,Normal
49234,53,38404,53,170,87,83,2,30,1,1,allow,0,0,Normal
53790,53,7041,53,167,78,89,2,29,1,1,allow,0,0,Normal
52804,445,0,0,70,70,0,1,0,1,0,drop,0,1,Known Attack
60065,443,12163,443,6395,2524,3871,18,141,10,8,allow,1,0,Potential Threat
64534,53,35373,53,214,110,104,2,30,1,1,allow,0,0,Normal
51010,22114,0,0,146,146,0,1,0,1,0,deny,1,1,High Risk
13525,51505,0,0,62,62,0,1,0,1,0,deny,1,1,High Risk
46318,443,20839,443,6373,1744,4629,22,15,13,9,allow,1,0,Potential Threat
52012,445,0,0,70,70,0,1,0,1,0,drop,0,1,Known Attack
56562,44847,0,0,66,66,0,1,0,1,0,deny,0,1,Known Attack
58660,445,0,0,70,70,0,1,0,1,0,drop,0,1,Known Attack
49662,53,17327,53,268,93,175,4,57,2,2,allow,0,0,Normal
18950,50584,0,0,62,62,0,1,0,1,0,deny,1,1,High Risk
49698,53,38054,53,184,102,82,2,30,1,1,allow,0,0,Normal
42361,23,0,0,60,60,0,1,0,1,0,deny,0,1,Known Attack
55674,445,0,0,70,70,0,1,0,1,0,drop,0,1,Known Attack
60806,40010,25471,40010,316,136,180,6,6,3,3,allow,1,0,Potential Threat
57132,445,0,0,70,70,0,1,0,1,0,drop,0,1,Known Attack
60865,443,14969,443,9934,4897,5037,43,15,25,18,allow,1,0,Potential Threat
64284,445,0,0,70,70,0,1,0,1,0,drop,0,1,Known Attack
1026,64147,0,0,62,62,0,1,0,1,0,deny,1,1,High Risk
5588,5588,0,0,3354,1792,1562,46,193,23,23,allow,1,0,Potential Threat
11344,42873,0,0,62,62,0,1,0,1,0,deny,1,1,High Risk
31035,23,0,0,60,60,0,1,0,1,0,deny,0,1,Known Attack
51908,445,0,0,66,66,0,1,0,1,0,drop,0,1,Known Attack
49730,443,40154,443,3233,1141,2092,14,135,7,7,allow,1,0,Potential Threat
54045,445,0,0,70,70,0,1,0,1,0,drop,0,1,Known Attack
62075,445,0,0,70,70,0,1,0,1,0,drop,0,1,Known Attack
56786,443,61415,443,238132,13988,224144,317,32,161,156,allow,1,0,Potential Threat
52745,443,60430,443,19919,2270,17649,38,26,21,17,allow,1,0,Potential Threat
48847,443,1416,443,2523,1483,1040,19,276,10,9,allow,1,0,Potential Threat
64957,53,47584,53,192,98,94,2,30,1,1,allow,0,0,Normal
52282,37965,0,0,66,66,0,1,0,1,0,deny,0,1,Known Attack
63884,445,0,0,66,66,0,1,0,1,0,drop,0,1,Known Attack
443,43775,0,0,97,97,0,1,0,1,0,deny,1,1,High Risk
55631,53,42735,53,422,96,326,4,42,2,2,allow,0,0,Normal
53183,443,26366,443,6094,1073,5021,19,15,10,9,allow,1,0,Potential Threat
59529,445,0,0,66,66,0,1,0,1,0,drop,0,1,Known Attack
49769,443,60646,443,14166,2015,12151,27,127,11,16,allow,1,0,Potential Threat
42457,5222,64493,5222,35380,2898,32482,63,227,22,41,allow,1,0,Potential Threat
23383,64147,0,0,62,62,0,1,0,1,0,deny,1,1,High Risk
13413,44847,0,0,62,62,0,1,0,1,0,deny,1,1,High Risk
50644,443,24533,443,1514,852,662,16,86,9,7,allow,1,0,Potential Threat
51948,445,0,0,70,70,0,1,0,1,0,drop,0,1,Known Attack
65270,3855,0,0,78,78,0,1,0,1,0,deny,0,1,Known Attack
44125,53,44125,53,209,79,130,2,30,1,1,allow,0,0,Normal
65466,53,32995,53,200,102,98,2,30,1,1,allow,0,0,Normal
55205,53,45357,53,167,86,81,2,29,1,1,allow,0,0,Normal
57470,6881,47770,6881,330,330,0,6,1200,6,0,allow,1,0,Potential Threat
65386,53,20616,53,762,101,661,2,30,1,1,allow,0,0,Normal
49421,443,54717,443,5422,801,4621,21,173,9,12,allow,1,0,Potential Threat
56783,53,44308,53,193,102,91,2,30,1,1,allow,0,0,Normal
45000,443,43427,443,2227,1018,1209,17,16,8,9,allow,1,0,Potential Threat
50336,53,8935,53,102,102,0,1,30,1,0,allow,0,0,Normal
64516,53,9042,53,216,110,106,2,30,1,1,allow,0,0,Normal
36301,443,2134,443,7316,1933,5383,27,15,15,12,allow,1,0,Potential Threat
43479,443,6073,443,6990,2019,4971,29,20,16,13,allow,1,0,Potential Threat
42753,56205,0,0,62,62,0,1,0,1,0,deny,0,1,Known Attack
50573,80,11289,80,318,192,126,6,26,4,2,allow,0,0,Normal
65131,53,1840,53,168,86,82,2,29,1,1,allow,0,0,Normal
32491,15503,0,0,66,66,0,1,0,1,0,deny,0,1,Known Attack
50668,445,0,0,66,66,0,1,0,1,0,drop,0,1,Known Attack
50924,445,0,0,66,66,0,1,0,1,0,drop,0,1,Known Attack
64539,53,12093,53,177,94,83,2,30,1,1,allow,0,0,Normal
55866,443,45291,443,53845,7300,46545,80,31,38,42,allow,1,0,Potential Threat
64076,53,18119,53,353,118,235,2,30,1,1,allow,0,0,Normal
60959,445,0,0,70,70,0,1,0,1,0,drop,0,1,Known Attack
56782,53,33216,53,197,102,95,2,33,1,1,allow,0,0,Normal
60889,445,0,0,70,70,0,1,0,1,0,drop,0,1,Known Attack
64819,445,0,0,70,70,0,1,0,1,0,drop,0,1,Known Attack
54189,445,0,0,70,70,0,1,0,1,0,drop,0,1,Known Attack
54916,445,0,0,70,70,0,1,0,1,0,drop,0,1,Known Attack
43817,53,43817,53,203,82,121,2,30,1,1,allow,0,0,Normal
39430,443,21846,443,506,292,214,8,50,5,3,allow,0,0,Normal
55346,443,44978,443,13181,6041,7140,60,410,27,33,allow,1,0,Potential Threat
49834,23,0,0,60,60,0,1,0,1,0,deny,0,1,Known Attack
22547,48817,0,0,72,72,0,1,0,1,0,deny,1,1,High Risk
64467,53,11977,53,184,94,90,2,30,1,1,allow,0,0,Normal
50493,443,36062,443,2147464,35144,2112320,1951,72,540,1411,allow,1,0,Potential Threat
62505,443,46992,443,14891,3970,10921,32,33,15,17,allow,1,0,Potential Threat
57351,62413,0,0,66,66,0,1,0,1,0,deny,1,1,High Risk
9520,443,43478,443,3614,434,3180,11,15,6,5,allow,1,0,Potential Threat
54858,51505,0,0,66,66,0,1,0,1,0,deny,0,1,Known Attack
28064,53,28064,53,233,90,143,2,32,1,1,allow,0,0,Normal
56586,53,17774,53,177,94,83,2,29,1,1,allow,0,0,Normal
27841,35894,0,0,62,62,0,1,0,1,0,deny,0,1,Known Attack
61875,445,0,0,70,70,0,1,0,1,0,drop,0,1,Known Attack
61701,44847,0,0,66,66,0,1,0,1,0,deny,0,1,Known Attack
32100,53,32100,53,200,90,110,2,29,1,1,allow,0,0,Normal
52447,445,0,0,70,70,0,1,0,1,0,drop,0,1,Known Attack
58037,80,32783,80,2339,1122,1217,11,20,6,5,allow,0,0,Normal
58879,443,43164,443,10439,1785,8654,25,85,10,15,allow,1,0,Potential Threat
29291,40108,0,0,150,150,0,1,0,1,0,deny,1,1,High Risk
47910,7454,0,0,60,60,0,1,0,1,0,deny,0,1,Known Attack
64287,53,20763,53,178,91,87,2,31,1,1,allow,0,0,Normal
48110,443,9219,443,537031,23421,513610,622,43,258,364,allow,1,0,Potential Threat
64118,445,0,0,66,66,0,1,0,1,0,drop,0,1,Known Attack
25101,50584,0,0,62,62,0,1,0,1,0,deny,1,1,High Risk
64689,53,48296,53,183,94,89,2,30,1,1,allow,0,0,Normal
55444,53,54146,53,193,102,91,2,30,1,1,allow,0,0,Normal
54427,53,16738,53,199,94,105,2,30,1,1,allow,0,0,Normal
50667,80,4915,80,3778,2082,1696,12,21,7,5,allow,1,0,Potential Threat
59181,445,0,0,70,70,0,1,0,1,0,drop,0,1,Known Attack
63503,42707,0,0,66,66,0,1,0,1,0,deny,0,1,Known Attack
59799,445,0,0,70,70,0,1,0,1,0,drop,0,1,Known Attack
2572,17546,0,0,66,66,0,1,0,1,0,deny,1,1,High Risk
55697,53,51781,53,193,102,91,2,30,1,1,allow,0,0,Normal
54869,35440,0,0,146,146,0,1,0,1,0,deny,1,1,High Risk
10103,443,54343,443,6334,910,5424,20,360,10,10,allow,1,0,Potential Threat
64980,53,39962,53,90,90,0,1,31,1,0,allow,0,0,Normal
58638,5900,0,0,62,62,0,1,0,1,0,deny,0,1,Known Attack
44798,443,42874,443,3239,2220,1019,16,15,9,7,allow,1,0,Potential Threat
52065,80,16889,80,81670,2359,79311,89,621,30,59,allow,1,0,Potential Threat
2791,7302,0,0,62,62,0,1,0,1,0,deny,1,1,High Risk
56766,443,55432,443,7888,1899,5989,20,15,11,9,allow,1,0,Potential Threat
45941,23386,0,0,60,60,0,1,0,1,0,deny,0,1,Known Attack
49371,445,0,0,70,70,0,1,0,1,0,drop,0,1,Known Attack
50393,53,2809,53,759,94,665,2,29,1,1,allow,0,0,Normal
61973,445,0,0,66,66,0,1,0,1,0,drop,0,1,Known Attack
61257,56448,0,0,146,146,0,1,0,1,0,deny,1,1,High Risk
56759,55201,40009,55201,66,66,0,1,5,1,0,allow,1,0,Potential Threat
56067,25174,0,0,146,146,0,1,0,1,0,deny,1,1,High Risk
59076,25174,0,0,62,62,0,1,0,1,0,deny,0,1,Known Attack
58638,5900,0,0,62,62,0,1,0,1,0,deny,0,1,Known Attack
50229,443,13758,443,6846,2479,4367,41,256,19,22,allow,1,0,Potential Threat
27988,40003,22369,40003,148,86,62,2,30,1,1,allow,1,0,Potential Threat
35088,443,54099,443,800,452,348,12,94,7,5,allow,1,0,Potential Threat
52327,443,53473,443,134,60,74,3,6,2,1,allow,0,0,Normal
53395,445,0,0,70,70,0,1,0,1,0,drop,0,1,Known Attack
26448,41864,0,0,145,145,0,1,0,1,0,deny,1,1,High Risk
64217,445,0,0,70,70,0,1,0,1,0,drop,0,1,Known Attack
50344,80,51584,80,3132,730,2402,13,42,7,6,allow,0,0,Normal
64990,53,21080,53,323,94,229,2,30,1,1,allow,0,0,Normal
58638,5900,0,0,62,62,0,1,0,1,0,deny,0,1,Known Attack
50557,445,0,0,70,70,0,1,0,1,0,drop,0,1,Known Attack
49254,445,0,0,66,66,0,1,0,1,0,drop,0,1,Known Attack
64023,53,2522,53,179,94,85,2,29,1,1,allow,0,0,Normal
7444,57470,0,0,66,66,0,1,0,1,0,deny,1,1,High Risk
50422,50584,0,0,62,62,0,1,0,1,0,deny,0,1,Known Attack
64770,53,5158,53,360,93,267,3,37,2,1,allow,0,0,Normal
59535,25174,0,0,62,62,0,1,0,1,0,deny,0,1,Known Attack
64306,64147,0,0,66,66,0,1,0,1,0,deny,1,1,High Risk
33238,443,21628,443,21538,3952,17586,48,17,27,21,allow,1,0,Potential Threat
52057,80,6987,80,422,240,182,8,25,5,3,allow,0,0,Normal
48676,53392,0,0,60,60,0,1,0,1,0,deny,0,1,Known Attack
58166,53,23423,53,224,94,130,2,30,1,1,allow,0,0,Normal
58638,5900,0,0,62,62,0,1,0,1,0,deny,0,1,Known Attack
60372,445,0,0,70,70,0,1,0,1,0,drop,0,1,Known Attack
60413,80,20847,80,958,543,415,11,315,6,5,allow,1,0,Potential Threat
49811,53,52504,53,300,118,182,2,29,1,1,allow,0,0,Normal
54473,37807,0,0,66,66,0,1,0,1,0,deny,0,1,Known Attack
2267,53,54928,53,204,118,86,2,31,1,1,allow,1,0,Potential Threat
27005,33060,38657,33060,928,126,802,2,31,1,1,allow,1,0,Potential Threat
10151,31964,38746,31964,481,150,331,2,1200,1,1,allow,1,0,Potential Threat
57007,53,22368,53,183,94,89,2,30,1,1,allow,0,0,Normal
59124,443,60758,443,27431,19413,8018,71,175,36,35,allow,1,0,Potential Threat
51560,46783,0,0,66,66,0,1,0,1,0,deny,0,1,Known Attack
50739,445,0,0,70,70,0,1,0,1,0,drop,0,1,Known Attack
60691,445,0,0,70,70,0,1,0,1,0,drop,0,1,Known Attack
56922,53,43765,53,86,86,0,1,30,1,0,allow,0,0,Normal
63473,443,25564,443,4490,1234,3256,20,122,9,11,allow,1,0,Potential Threat
46275,64147,0,0,62,62,0,1,0,1,0,deny,1,1,High Risk
52886,445,0,0,70,70,0,1,0,1,0,drop,0,1,Known Attack
39575,53,26625,53,198,93,105,2,30,1,1,allow,0,0,Normal
61631,445,0,0,70,70,0,1,0,1,0,drop,0,1,Known Attack
50672,80,6037,80,1718,1247,471,9,14,5,4,allow,1,0,Potential Threat
19840,7000,19840,7000,3610,2043,1567,16,17,9,7,allow,1,0,Potential Threat
123,123,58588,123,184,94,90,2,30,1,1,allow,1,0,Potential Threat
51989,29736,26603,29736,160,70,90,2,5,1,1,allow,1,0,Potential Threat
60206,443,52179,443,4706,2475,2231,13,120,7,6,allow,1,0,Potential Threat
59604,443,43036,443,4507,1525,2982,24,147,13,11,allow,1,0,Potential Threat
49174,443,55183,443,524887,14310,510577,546,18,201,345,allow,1,0,Potential Threat
64255,53,12895,53,200,94,106,2,29,1,1,allow,0,0,Normal
62401,445,0,0,70,70,0,1,0,1,0,drop,0,1,Known Attack
58924,445,0,0,70,70,0,1,0,1,0,drop,0,1,Known Attack
12605,57470,0,0,62,62,0,1,0,1,0,deny,1,1,High Risk
51374,30317,0,0,66,66,0,1,0,1,0,deny,0,1,Known Attack
56038,53,40412,53,170,87,83,2,30,1,1,allow,0,0,Normal
47966,443,16155,443,10895,2151,8744,26,362,11,15,allow,1,0,Potential Threat
46824,53,42441,53,326,78,248,2,30,1,1,allow,0,0,Normal
50655,80,4984,80,91198,3990,87208,113,19,49,64,allow,1,0,Potential Threat
56015,56205,0,0,66,66,0,1,0,1,0,deny,0,1,Known Attack
54932,445,0,0,66,66,0,1,0,1,0,drop,0,1,Known Attack
37264,443,41734,443,130,70,60,3,5,2,1,allow,0,0,Normal
63878,22114,0,0,62,62,0,1,0,1,0,deny,0,1,Known Attack
52916,80,53748,80,4266,1776,2490,20,367,11,9,allow,1,0,Potential Threat
56584,53,11866,53,214,102,112,2,30,1,1,allow,0,0,Normal
56681,443,64351,443,19154,11130,8024,40,102,24,16,allow,1,0,Potential Threat
64534,445,0,0,66,66,0,1,0,1,0,drop,0,1,Known Attack
49379,53,28766,53,199,102,97,2,30,1,1,allow,0,0,Normal
55751,53,8390,53,216,94,122,2,30,1,1,allow,0,0,Normal
63399,445,0,0,70,70,0,1,0,1,0,drop,0,1,Known Attack
60463,6890,23297,6890,164,70,94,3,8,2,1,allow,1,0,Potential Threat
1027,23684,0,0,159,159,0,1,0,1,0,deny,1,1,High Risk
63802,445,0,0,66,66,0,1,0,1,0,drop,0,1,Known Attack
63969,57635,11400,57635,504,382,122,8,17,6,2,allow,1,0,Potential Threat
56000,53,18353,53,177,94,83,2,29,1,1,allow,0,0,Normal
61714,443,30943,443,134,60,74,3,10,2,1,allow,0,0,Normal
57339,443,47908,443,1495,768,727,16,26,9,7,allow,1,0,Potential Threat
52938,64097,0,0,66,66,0,1,0,1,0,deny,1,1,High Risk
43357,443,31552,443,6392,1099,5293,18,33,10,8,allow,1,0,Potential Threat
22636,30188,0,0,66,66,0,1,0,1,0,deny,0,1,Known Attack
50075,443,63297,443,4701,2758,1943,41,93,22,19,allow,1,0,Potential Threat
60413,445,0,0,70,70,0,1,0,1,0,drop,0,1,Known Attack
55452,53,61292,53,184,94,90,2,30,1,1,allow,0,0,Normal
20083,6881,0,0,62,62,0,1,0,1,0,deny,0,1,Known Attack
1262,23,0,0,60,60,0,1,0,1,0,deny,1,1,High Risk
61072,445,0,0,70,70,0,1,0,1,0,drop,0,1,Known Attack
58799,30188,0,0,66,66,0,1,0,1,0,deny,0,1,Known Attack
55858,80,7371,80,104399,8436,95963,122,21,49,73,allow,1,0,Potential Threat
14084,43890,0,0,146,146,0,1,0,1,0,deny,1,1,High Risk
52269,443,52269,443,1615,941,674,15,20,7,8,allow,1,0,Potential Threat
36369,443,28864,443,4039,2616,1423,24,45,14,10,allow,1,0,Potential Threat
56658,53,34980,53,458,188,270,6,30,3,3,allow,0,0,Normal
59505,53733,0,0,62,62,0,1,0,1,0,deny,1,1,High Risk
60756,445,0,0,66,66,0,1,0,1,0,drop,0,1,Known Attack
56496,53,56369,53,193,102,91,2,30,1,1,allow,0,0,Normal
19698,502,0,0,60,60,0,1,0,1,0,deny,0,1,Known Attack
41713,443,59804,443,61983,10061,51922,85,130,35,50,allow,1,0,Potential Threat
63944,8999,41992,8999,70,70,0,1,5,1,0,allow,1,0,Potential Threat
60579,25174,0,0,62,62,0,1,0,1,0,deny,0,1,Known Attack
50986,445,0,0,70,70,0,1,0,1,0,drop,0,1,Known Attack
443,23220,0,0,100,100,0,1,0,1,0,deny,1,1,High Risk
45336,443,30419,443,2312,1382,930,19,28,11,8,allow,1,0,Potential Threat
50353,443,15424,443,1775,169,1606,7,121,3,4,allow,1,0,Potential Threat
57305,53,63466,53,177,94,83,2,30,1,1,allow,1,0,Potential Threat
58638,5900,0,0,62,62,0,1,0,1,0,deny,0,1,Known Attack
58048,80,12048,80,5171,3018,2153,16,30,8,8,allow,1,0,Potential Threat
53321,443,65410,443,416,210,206,7,28,4,3,allow,1,0,Potential Threat
53759,80,20494,80,997,582,415,11,315,6,5,allow,1,0,Potential Threat
63285,445,0,0,66,66,0,1,0,1,0,drop,0,1,Known Attack
44641,80,65447,80,1354,850,504,13,256,8,5,allow,1,0,Potential Threat
50972,3544,50946,3544,258,107,151,2,30,1,1,allow,1,0,Potential Threat
56661,443,39690,443,7900,3324,4576,28,139,13,15,allow,1,0,Potential Threat
55580,445,0,0,70,70,0,1,0,1,0,drop,0,1,Known Attack
35136,443,3606,443,25542,17843,7699,58,59,34,24,allow,1,0,Potential Threat
60095,443,60308,443,2357,1467,890,15,140,8,7,allow,1,0,Potential Threat
39336,443,55309,443,7759,4000,3759,23,96,11,12,allow,1,0,Potential Threat
54246,445,0,0,66,66,0,1,0,1,0,drop,0,1,Known Attack
58795,445,0,0,70,70,0,1,0,1,0,drop,0,1,Known Attack
58884,23,0,0,60,60,0,1,0,1,0,deny,0,1,Known Attack
57075,53,9642,53,199,94,105,2,30,1,1,allow,0,0,Normal
40408,1488,40408,1488,156,156,0,3,8,3,0,allow,1,0,Potential Threat
63939,445,0,0,70,70,0,1,0,1,0,drop,0,1,Known Attack
63940,3389,63940,3389,3347,1458,1889,15,17,8,7,allow,1,0,Potential Threat
5588,5588,0,0,3354,1792,1562,46,194,23,23,allow,1,0,Potential Threat
52147,445,0,0,70,70,0,1,0,1,0,drop,0,1,Known Attack
50076,80,29026,80,26128,9214,16914,81,512,40,41,allow,1,0,Potential Threat
50729,445,0,0,70,70,0,1,0,1,0,drop,0,1,Known Attack
64753,53,63867,53,94,94,0,1,30,1,0,allow,1,0,Potential Threat
57175,445,0,0,70,70,0,1,0,1,0,drop,0,1,Known Attack
42298,40007,30822,40007,143,81,62,2,31,1,1,allow,1,0,Potential Threat
10736,35440,0,0,62,62,0,1,0,1,0,deny,1,1,High Risk
61923,80,14146,80,4295,719,3576,16,125,8,8,allow,1,0,Potential Threat
64721,443,45723,443,5552,927,4625,16,15,10,6,allow,1,0,Potential Threat
10013,443,27326,443,10336,4760,5576,37,315,18,19,allow,1,0,Potential Threat
55141,53,13525,53,184,94,90,2,31,1,1,allow,0,0,Normal
64543,53,58923,53,761,100,661,2,31,1,1,allow,1,0,Potential Threat
50376,53,65518,53,164,84,80,2,31,1,1,allow,1,0,Potential Threat
51676,445,0,0,70,70,0,1,0,1,0,drop,0,1,Known Attack
50329,80,27783,80,1550,728,822,13,47,7,6,allow,0,0,Normal
55639,53,39796,53,292,102,190,2,29,1,1,allow,0,0,Normal
49343,445,0,0,70,70,0,1,0,1,0,drop,0,1,Known Attack
57917,44847,0,0,66,66,0,1,0,1,0,deny,0,1,Known Attack
51110,445,0,0,66,66,0,1,0,1,0,drop,0,1,Known Attack
54872,53,11458,53,578,286,292,9,15,5,4,allow,0,0,Normal
55808,445,0,0,66,66,0,1,0,1,0,drop,0,1,Known Attack
8592,35993,0,0,66,66,0,1,0,1,0,deny,1,1,High Risk
56352,53,18136,53,177,94,83,2,30,1,1,allow,0,0,Normal
52801,443,38731,443,8308,3201,5107,36,1401,19,17,allow,1,0,Potential Threat
55719,13302,2915,13302,70,70,0,1,5,1,0,allow,1,0,Potential Threat
58598,50584,0,0,66,66,0,1,0,1,0,deny,0,1,Known Attack
27005,27018,47150,27018,1898,378,1520,6,31,4,2,allow,1,0,Potential Threat
2935,64147,0,0,62,62,0,1,0,1,0,deny,1,1,High Risk
56563,53,56693,53,177,94,83,2,30,1,1,allow,0,0,Normal
53915,443,38797,443,7917,2410,5507,32,26,18,14,allow,1,0,Potential Threat
65464,443,36070,443,395647,11870,383777,409,16,144,265,allow,1,0,Potential Threat
34692,53,2143,53,271,102,169,2,30,1,1,allow,0,0,Normal
54762,53,0,0,86,86,0,1,30,1,0,allow,0,0,Normal
52076,44847,0,0,66,66,0,1,0,1,0,deny,0,1,Known Attack
59457,53,59457,53,213,87,126,2,30,1,1,allow,0,0,Normal
49932,53,55615,53,195,102,93,2,30,1,1,allow,0,0,Normal
2837,25174,0,0,66,66,0,1,0,1,0,deny,1,1,High Risk
57174,57470,0,0,66,66,0,1,0,1,0,deny,0,1,Known Attack
61744,11392,0,0,66,66,0,1,0,1,0,deny,0,1,Known Attack
63181,445,0,0,66,66,0,1,0,1,0,drop,0,1,Known Attack
55369,53,62193,53,376,94,282,2,30,1,1,allow,0,0,Normal
56724,53,34585,53,308,97,211,4,45,2,2,allow,0,0,Normal
51015,64147,0,0,62,62,0,1,0,1,0,deny,1,1,High Risk
45315,80,28283,80,6087687,127446,5960241,5920,28,1981,3939,allow,1,0,Potential Threat
64581,53,40086,53,214,110,104,2,30,1,1,allow,0,0,Normal
50535,51505,0,0,66,66,0,1,0,1,0,deny,0,1,Known Attack
58724,443,33462,443,10179,4285,5894,60,272,31,29,allow,1,0,Potential Threat
56980,53,33611,53,526,188,338,6,48,3,3,allow,0,0,Normal
55748,445,0,0,70,70,0,1,0,1,0,drop,0,1,Known Attack
48488,50584,0,0,62,62,0,1,0,1,0,deny,0,1,Known Attack
56967,35440,0,0,66,66,0,1,0,1,0,deny,0,1,Known Attack
58015,445,0,0,70,70,0,1,0,1,0,drop,0,1,Known Attack
51125,80,6897,80,2880,815,2065,12,25,7,5,allow,1,0,Potential Threat
30960,45722,27416,45722,396,396,0,7,3616,7,0,allow,1,0,Potential Threat
61451,17500,0,0,66,66,0,1,0,1,0,deny,0,1,Known Attack
54942,53,0,0,168,74,94,2,30,1,1,allow,0,0,Normal
56676,53,4759,53,172,88,84,2,31,1,1,allow,0,0,Normal
49295,53,60068,53,172,94,78,2,30,1,1,allow,0,0,Normal
64289,53,64357,53,199,102,97,2,30,1,1,allow,1,0,Potential Threat
52573,445,0,0,70,70,0,1,0,1,0,drop,0,1,Known Attack
2267,53,49774,53,826,826,0,8,44,8,0,allow,1,0,Potential Threat
50261,445,0,0,70,70,0,1,0,1,0,drop,0,1,Known Attack
50,38211,0,0,66,66,0,1,0,1,0,deny,1,1,High Risk
56250,36237,0,0,66,66,0,1,0,1,0,deny,0,1,Known Attack
58294,445,0,0,66,66,0,1,0,1,0,drop,0,1,Known Attack
63709,445,0,0,70,70,0,1,0,1,0,drop,0,1,Known Attack
46902,443,9815,443,1312,651,661,13,184,7,6,allow,1,0,Potential Threat
63288,445,0,0,70,70,0,1,0,1,0,drop,0,1,Known Attack
52892,443,14885,443,130,70,60,2,14,1,1,allow,0,0,Normal
55602,443,15216,443,7360,2298,5062,22,255,12,10,allow,1,0,Potential Threat
56783,53,44833,53,193,102,91,2,30,1,1,allow,0,0,Normal
49562,53,28687,53,198,94,104,2,30,1,1,allow,0,0,Normal
63568,445,0,0,66,66,0,1,0,1,0,drop,0,1,Known Attack
56229,53,12969,53,165,86,79,2,30,1,1,allow,0,0,Normal
443,34599,0,0,60,60,0,1,0,1,0,deny,1,1,High Risk
34306,37965,0,0,62,62,0,1,0,1,0,deny,0,1,Known Attack
31727,57470,0,0,62,62,0,1,0,1,0,deny,1,1,High Risk
56431,53,52567,53,323,110,213,2,30,1,1,allow,0,0,Normal
65206,53,13449,53,330,118,212,2,30,1,1,allow,0,0,Normal
39351,23,0,0,60,60,0,1,0,1,0,deny,0,1,Known Attack
49805,6881,0,0,66,66,0,1,0,1,0,deny,0,1,Known Attack
56873,53,25069,53,184,94,90,2,30,1,1,allow,0,0,Normal
39735,53,51086,53,223,78,145,2,30,1,1,allow,0,0,Normal
63799,13835,56478,13835,66,66,0,1,5,1,0,allow,1,0,Potential Threat
59526,445,0,0,70,70,0,1,0,1,0,drop,0,1,Known Attack
53789,443,10563,443,499,425,74,4,0,3,1,allow,0,0,Normal
57308,443,38390,443,36373,15248,21125,172,123,69,103,allow,1,0,Potential Threat
52144,445,0,0,70,70,0,1,0,1,0,drop,0,1,Known Attack
8999,8055,0,0,146,146,0,1,0,1,0,deny,1,1,High Risk
55710,445,0,0,70,70,0,1,0,1,0,drop,0,1,Known Attack
50065,445,0,0,70,70,0,1,0,1,0,drop,0,1,Known Attack
58638,5900,0,0,62,62,0,1,0,1,0,deny,0,1,Known Attack
55691,445,0,0,66,66,0,1,0,1,0,drop,0,1,Known Attack
44912,80,52893,80,1602,1282,320,10,15,5,5,allow,1,0,Potential Threat
64652,443,64652,443,6792,1521,5271,18,26,11,7,allow,1,0,Potential Threat
11842,23,0,0,60,60,0,1,0,1,0,deny,0,1,Known Attack
42319,443,8708,443,6664,1570,5094,23,18,13,10,allow,1,0,Potential Threat
57131,35776,0,0,145,145,0,1,0,1,0,deny,1,1,High Risk
57173,44847,0,0,62,62,0,1,0,1,0,deny,0,1,Known Attack
80,9918,0,0,60,60,0,1,0,1,0,deny,1,1,High Risk
57807,443,57807,443,4434,1527,2907,19,29,11,8,allow,1,0,Potential Threat
49977,53,37356,53,212,94,118,2,30,1,1,allow,0,0,Normal
56618,80,46340,80,234,234,0,4,12,4,0,allow,0,0,Normal
59861,445,0,0,70,70,0,1,0,1,0,drop,0,1,Known Attack
54922,445,0,0,66,66,0,1,0,1,0,drop,0,1,Known Attack
53164,48198,7411,48198,320,140,180,6,7,3,3,allow,1,0,Potential Threat
58129,26467,0,0,62,62,0,1,0,1,0,deny,0,1,Known Attack
17548,36829,0,0,62,62,0,1,0,1,0,deny,1,1,High Risk
60491,445,0,0,70,70,0,1,0,1,0,drop,0,1,Known Attack
41832,5222,27749,5222,3823,1878,1945,39,309,22,17,allow,1,0,Potential Threat
60441,445,0,0,70,70,0,1,0,1,0,drop,0,1,Known Attack
14333,51050,0,0,62,62,0,1,0,1,0,deny,1,1,High Risk
11136,19910,0,0,62,62,0,1,0,1,0,deny,0,1,Known Attack
60549,445,0,0,66,66,0,1,0,1,0,drop,0,1,Known Attack
49173,80,62950,80,254,128,126,5,15,3,2,allow,1,0,Potential Threat
49969,53,53673,53,789,102,687,2,30,1,1,allow,0,0,Normal
35718,20238,0,0,62,62,0,1,0,1,0,deny,0,1,Known Attack
56396,5900,0,0,60,60,0,1,0,1,0,deny,0,1,Known Attack
59865,443,51225,443,502,250,252,9,26,5,4,allow,1,0,Potential Threat
57426,66,63838,66,70,70,0,1,5,1,0,allow,1,0,Potential Threat
46983,443,17844,443,2809,1884,925,19,25,11,8,allow,1,0,Potential Threat
49771,80,10429,80,254,128,126,5,16,3,2,allow,0,0,Normal
57319,53,22543,53,176,90,86,2,30,1,1,allow,0,0,Normal
56986,53,31308,53,177,94,83,2,29,1,1,allow,0,0,Normal
58169,445,0,0,70,70,0,1,0,1,0,drop,0,1,Known Attack
50684,80,37949,80,66772,4924,61848,110,19,60,50,allow,1,0,Potential Threat
56611,443,56611,443,4530,1623,2907,19,26,11,8,allow,1,0,Potential Threat
56825,16648,32548,16648,164,70,94,2,7,1,1,allow,1,0,Potential Threat
62598,445,0,0,66,66,0,1,0,1,0,drop,0,1,Known Attack
49335,80,26214,80,1193,703,490,8,18,5,3,allow,0,0,Normal
53122,80,53122,80,19237,829,18408,29,15,13,16,allow,1,0,Potential Threat
55372,53,13857,53,271,93,178,4,42,2,2,allow,0,0,Normal
1484,22114,0,0,146,146,0,1,0,1,0,deny,1,1,High Risk
65381,80,14160,80,1630,982,648,13,78,7,6,allow,1,0,Potential Threat
42417,22114,0,0,62,62,0,1,0,1,0,deny,0,1,Known Attack
64539,53,23141,53,712,214,498,6,44,3,3,allow,1,0,Potential Threat
56913,53,31255,53,193,102,91,2,29,1,1,allow,0,0,Normal
56431,53,28557,53,177,94,83,2,31,1,1,allow,0,0,Normal
55107,53,40259,53,184,94,90,2,30,1,1,allow,0,0,Normal
62819,56205,0,0,62,62,0,1,0,1,0,deny,1,1,High Risk
50522,443,6531,443,1579,988,591,13,45,7,6,allow,1,0,Potential Threat
123,123,55557,123,184,94,90,2,29,1,1,allow,1,0,Potential Threat
49913,53,61333,53,177,94,83,2,29,1,1,allow,0,0,Normal
53459,443,23457,443,88210,4564,83646,115,46,50,65,allow,1,0,Potential Threat
54688,443,54688,443,149676,25300,124376,220,110,122,98,allow,1,0,Potential Threat
49189,445,0,0,70,70,0,1,0,1,0,drop,0,1,Known Attack
64124,53,35184,53,183,94,89,2,30,1,1,allow,0,0,Normal
65387,445,0,0,70,70,0,1,0,1,0,drop,0,1,Known Attack
57555,35440,0,0,66,66,0,1,0,1,0,deny,0,1,Known Attack
0,0,0,0,320,320,0,5,0,5,0,allow,1,0,Potential Threat
55191,445,0,0,70,70,0,1,0,1,0,drop,0,1,Known Attack
55516,53,62536,53,211,102,109,2,30,1,1,allow,0,0,Normal
22783,64147,0,0,66,66,0,1,0,1,0,deny,1,1,High Risk
53024,57866,0,0,146,146,0,1,0,1,0,deny,1,1,High Risk
43674,80,54012,80,3714,1646,2068,18,186,9,9,allow,1,0,Potential Threat
53278,443,20618,443,12634,1635,10999,26,322,11,15,allow,1,0,Potential Threat
51760,36558,34247,36558,70,70,0,1,5,1,0,allow,1,0,Potential Threat
46641,8100,62793,8100,234,234,0,4,11,4,0,allow,1,0,Potential Threat
38425,443,45581,443,103112,8212,94900,165,55,80,85,allow,1,0,Potential Threat
56249,443,29498,443,80340,72269,8071,106,122,65,41,allow,1,0,Potential Threat
47962,16069,0,0,62,62,0,1,0,1,0,deny,0,1,Known Attack
58283,443,44449,443,42792,12402,30390,98,370,45,53,allow,1,0,Potential Threat
27005,32065,5075,32065,877,126,751,2,31,1,1,allow,1,0,Potential Threat
59287,445,0,0,70,70,0,1,0,1,0,drop,0,1,Known Attack
64530,53,5563,53,264,110,154,2,30,1,1,allow,0,0,Normal
50734,80,62871,80,3498,2696,802,9,26,5,4,allow,1,0,Potential Threat
49418,27021,53913,27021,232,71,161,2,30,1,1,allow,1,0,Potential Threat
51268,47662,19145,47662,70,70,0,1,5,1,0,allow,1,0,Potential Threat
9472,443,45589,443,5699,505,5194,14,15,7,7,allow,1,0,Potential Threat
2681,48817,0,0,146,146,0,1,0,1,0,deny,1,1,High Risk
60824,53,60824,53,220,90,130,2,30,1,1,allow,0,0,Normal
64996,27034,9075,27034,1761,924,837,6,30,3,3,allow,1,0,Potential Threat
56426,53,8485,53,184,94,90,2,30,1,1,allow,0,0,Normal
55323,445,0,0,70,70,0,1,0,1,0,drop,0,1,Known Attack
59828,53,0,0,275,75,200,2,30,1,1,allow,0,0,Normal
26651,25174,0,0,146,146,0,1,0,1,0,deny,1,1,High Risk
37562,443,51859,443,13836,6371,7465,34,23,20,14,allow,1,0,Potential Threat
45064,25174,0,0,62,62,0,1,0,1,0,deny,0,1,Known Attack
50283,80,41911,80,5689,1015,4674,16,45,8,8,allow,1,0,Potential Threat
65495,445,0,0,70,70,0,1,0,1,0,drop,0,1,Known Attack
62953,445,0,0,66,66,0,1,0,1,0,drop,0,1,Known Attack
65270,3855,0,0,78,78,0,1,0,1,0,deny,0,1,Known Attack
36851,53,52640,53,404,261,143,3,30,2,1,allow,0,0,Normal
4366,51505,0,0,62,62,0,1,0,1,0,deny,1,1,High Risk
57588,443,16925,443,9109,2044,7065,25,22,14,11,allow,1,0,Potential Threat
27005,1102,9620,1102,867,126,741,2,30,1,1,allow,1,0,Potential Threat
65312,53,55577,53,182,94,88,2,30,1,1,allow,0,0,Normal
55439,53,53595,53,209,110,99,2,29,1,1,allow,0,0,Normal
53810,23,0,0,60,60,0,1,0,1,0,deny,0,1,Known Attack
56783,53,42766,53,199,102,97,2,30,1,1,allow,0,0,Normal
53389,23,0,0,60,60,0,1,0,1,0,deny,0,1,Known Attack
52477,443,18110,443,8788,2185,6603,15,134,7,8,allow,1,0,Potential Threat
55294,53,35326,53,199,102,97,2,30,1,1,allow,0,0,Normal
63153,445,0,0,70,70,0,1,0,1,0,drop,0,1,Known Attack
49277,53,20518,53,199,102,97,2,30,1,1,allow,0,0,Normal
56472,445,0,0,66,66,0,1,0,1,0,drop,0,1,Known Attack
60598,445,0,0,70,70,0,1,0,1,0,drop,0,1,Known Attack
60866,445,0,0,70,70,0,1,0,1,0,drop,0,1,Known Attack
14420,443,3846,443,5103,3164,1939,32,168,17,15,allow,1,0,Potential Threat
55972,53,38960,53,756,95,661,2,31,1,1,allow,0,0,Normal
57301,445,0,0,70,70,0,1,0,1,0,drop,0,1,Known Attack
50366,445,0,0,66,66,0,1,0,1,0,drop,0,1,Known Attack
60971,443,2878,443,2732,1359,1373,29,193,16,13,allow,1,0,Potential Threat
48344,443,40212,443,232,172,60,3,5,2,1,allow,0,0,Normal
64655,53,25772,53,225,102,123,2,30,1,1,allow,0,0,Normal
50584,62833,22282,62833,1275,300,975,6,1200,3,3,allow,1,0,Potential Threat
55600,22,0,0,60,60,0,1,0,1,0,deny,0,1,Known Attack
58743,443,24933,443,14819,3993,10826,80,330,36,44,allow,1,0,Potential Threat
31469,23,0,0,60,60,0,1,0,1,0,deny,0,1,Known Attack
60228,443,13572,443,1058,641,417,10,50,6,4,allow,1,0,Potential Threat
36834,80,37812,80,12993,6920,6073,22,20,13,9,allow,1,0,Potential Threat
53595,445,0,0,70,70,0,1,0,1,0,drop,0,1,Known Attack
55081,53,46160,53,209,102,107,2,30,1,1,allow,0,0,Normal
57176,53,30899,53,172,88,84,2,30,1,1,allow,0,0,Normal
50493,15503,0,0,146,146,0,1,0,1,0,deny,0,1,Known Attack
60404,445,0,0,70,70,0,1,0,1,0,drop,0,1,Known Attack
51954,57470,0,0,66,66,0,1,0,1,0,deny,0,1,Known Attack
50467,445,0,0,66,66,0,1,0,1,0,drop,0,1,Known Attack
58046,443,58046,443,4682,1775,2907,19,29,11,8,allow,1,0,Potential Threat
50732,27029,64378,27029,269,78,191,2,30,1,1,allow,1,0,Potential Threat
44208,26467,0,0,62,62,0,1,0,1,0,deny,0,1,Known Attack
6666,138,0,0,60,60,0,1,0,1,0,deny,0,1,Known Attack
55687,53,59046,53,186,95,91,2,31,1,1,allow,0,0,Normal
43549,443,50179,443,10316,2303,8013,39,120,20,19,allow,1,0,Potential Threat
57166,53,13391,53,177,94,83,2,30,1,1,allow,0,0,Normal
56650,80,32144,80,234,234,0,4,12,4,0,allow,0,0,Normal
26457,80,26457,80,17147,1829,15318,28,17,15,13,allow,1,0,Potential Threat
55533,53,2426,53,183,94,89,2,30,1,1,allow,0,0,Normal
53152,27367,49089,27367,758,320,438,11,20,6,5,allow,1,0,Potential Threat
51665,443,64553,443,8783,4321,4462,39,94,19,20,allow,1,0,Potential Threat
65443,80,29432,80,366,180,186,7,28,4,3,allow,1,0,Potential Threat
56968,80,38598,80,2273,1511,762,7,29,4,3,allow,0,0,Normal
49635,53,55370,53,204,104,100,2,30,1,1,allow,0,0,Normal
59850,443,34758,443,10260,1360,8900,22,18,7,15,allow,1,0,Potential Threat
46093,32661,0,0,74,74,0,1,0,1,0,deny,0,1,Known Attack
60538,80,60538,80,318,120,198,6,26,3,3,allow,0,0,Normal
56415,445,0,0,70,70,0,1,0,1,0,drop,0,1,Known Attack
49793,445,0,0,70,70,0,1,0,1,0,drop,0,1,Known Attack
42993,443,7986,443,10692,4532,6160,31,134,16,15,allow,1,0,Potential Threat
14694,443,0,0,60,60,0,1,0,1,0,deny,0,1,Known Attack
6881,60026,38643,60026,509,150,359,2,1199,1,1,allow,1,0,Potential Threat
38699,443,63342,443,759586,14873,744713,719,16,209,510,allow,1,0,Potential Threat
38551,53,14191,53,168,78,90,2,30,1,1,allow,0,0,Normal
60993,445,0,0,70,70,0,1,0,1,0,drop,0,1,Known Attack
55865,53,56298,53,168,86,82,2,30,1,1,allow,0,0,Normal
18472,5278,0,0,145,145,0,1,0,1,0,deny,1,1,High Risk
13285,29892,0,0,145,145,0,1,0,1,0,deny,1,1,High Risk
34417,443,59906,443,6378,1571,4807,23,315,12,11,allow,1,0,Potential Threat
65220,53,21177,53,184,94,90,2,30,1,1,allow,0,0,Normal
17244,22114,0,0,62,62,0,1,0,1,0,deny,0,1,Known Attack
57798,445,0,0,70,70,0,1,0,1,0,drop,0,1,Known Attack
1114,46824,0,0,62,62,0,1,0,1,0,deny,1,1,High Risk
5223,14446,0,0,220,220,0,1,0,1,0,deny,1,1,High Risk
58570,445,0,0,66,66,0,1,0,1,0,drop,0,1,Known Attack
31410,25174,0,0,62,62,0,1,0,1,0,deny,0,1,Known Attack
51167,445,0,0,66,66,0,1,0,1,0,drop,0,1,Known Attack
59442,53,59442,53,235,90,145,2,33,1,1,allow,0,0,Normal
56288,53,63412,53,210,110,100,2,30,1,1,allow,1,0,Potential Threat
46774,64147,0,0,145,145,0,1,0,1,0,deny,1,1,High Risk
56099,445,0,0,70,70,0,1,0,1,0,drop,0,1,Known Attack
50179,80,50179,80,1473,920,553,9,137,6,3,allow,1,0,Potential Threat
50518,53,60220,53,802,104,698,2,31,1,1,allow,0,0,Normal
64854,53,27051,53,178,94,84,2,30,1,1,allow,0,0,Normal
56041,53,17868,53,179,94,85,2,31,1,1,allow,0,0,Normal
55690,53,21416,53,183,94,89,2,29,1,1,allow,0,0,Normal
56560,53,34693,53,196,100,96,2,31,1,1,allow,0,0,Normal
56188,445,0,0,70,70,0,1,0,1,0,drop,0,1,Known Attack
17734,53,17734,53,217,90,127,2,30,1,1,allow,0,0,Normal
60043,445,0,0,70,70,0,1,0,1,0,drop,0,1,Known Attack
50031,53,6210,53,181,94,87,2,30,1,1,allow,0,0,Normal
47638,443,5364,443,1056,569,487,10,38,6,4,allow,1,0,Potential Threat
41267,8245,14045,8245,280,214,66,2,30,1,1,allow,1,0,Potential Threat
64816,53,50725,53,166,86,80,2,30,1,1,allow,0,0,Normal
56468,53,49469,53,209,110,99,2,30,1,1,allow,0,0,Normal
57136,53,22982,53,209,110,99,2,30,1,1,allow,0,0,Normal
58638,5900,58638,5900,66,66,0,1,4,1,0,allow,1,0,Potential Threat
60396,443,5888,443,5964,1586,4378,19,80,10,9,allow,1,0,Potential Threat
53807,28630,23692,28630,70,70,0,1,4,1,0,allow,1,0,Potential Threat
64808,53,34038,53,239,94,145,2,30,1,1,allow,0,0,Normal
64086,443,16892,443,3289,1031,2258,13,121,6,7,allow,1,0,Potential Threat
58594,445,0,0,70,70,0,1,0,1,0,drop,0,1,Known Attack
27005,27237,41184,27237,891,126,765,2,30,1,1,allow,1,0,Potential Threat
59017,445,0,0,66,66,0,1,0,1,0,drop,0,1,Known Attack
56418,53,28996,53,183,94,89,2,31,1,1,allow,0,0,Normal
50567,443,27568,443,198,120,78,4,15,3,1,allow,0,0,Normal
58656,445,0,0,70,70,0,1,0,1,0,drop,0,1,Known Attack
38901,53,60941,53,168,78,90,2,30,1,1,allow,1,0,Potential Threat
64603,53,6564,53,258,102,156,2,30,1,1,allow,0,0,Normal
64811,51221,0,0,66,66,0,1,0,1,0,deny,1,1,High Risk
56574,443,10843,443,6974,1513,5461,21,81,11,10,allow,1,0,Potential Threat
50041,443,48278,443,7924,1798,6126,26,15,14,12,allow,1,0,Potential Threat
61389,445,0,0,66,66,0,1,0,1,0,drop,0,1,Known Attack
64314,53,48605,53,264,110,154,2,30,1,1,allow,0,0,Normal
38280,80,34023,80,748,459,289,8,254,5,3,allow,1,0,Potential Threat
50318,53,63172,53,732,89,643,2,30,1,1,allow,1,0,Potential Threat
22948,26467,0,0,62,62,0,1,0,1,0,deny,0,1,Known Attack
51865,14732,26909,14732,70,70,0,2,7,2,0,allow,1,0,Potential Threat
54226,443,4295,443,499,425,74,4,0,3,1,allow,0,0,Normal
50265,49083,4910,49083,132,132,0,3,1200,3,0,allow,1,0,Potential Threat
56887,53,19033,53,177,94,83,2,31,1,1,allow,0,0,Normal
55221,443,65521,443,10435,2860,7575,27,46,15,12,allow,1,0,Potential Threat
61673,443,54566,443,9218,3728,5490,30,50,16,14,allow,1,0,Potential Threat
55026,53,14938,53,177,94,83,2,30,1,1,allow,0,0,Normal
52172,7353,21812,7353,70,70,0,1,5,1,0,allow,1,0,Potential Threat
58812,445,0,0,70,70,0,1,0,1,0,drop,0,1,Known Attack
27005,27015,60094,27015,876,126,750,2,31,1,1,allow,1,0,Potential Threat
63988,53,51956,53,195,102,93,2,30,1,1,allow,0,0,Normal
58421,30188,0,0,66,66,0,1,0,1,0,deny,0,1,Known Attack
17811,23,0,0,60,60,0,1,0,1,0,deny,0,1,Known Attack
65189,53,20195,53,176,90,86,2,31,1,1,allow,0,0,Normal
62340,445,0,0,70,70,0,1,0,1,0,drop,0,1,Known Attack
56637,443,26633,443,7907,1918,5989,20,15,11,9,allow,1,0,Potential Threat
43363,26467,0,0,66,66,0,1,0,1,0,deny,0,1,Known Attack
51909,6881,0,0,66,66,0,1,0,1,0,deny,0,1,Known Attack
56520,53,53336,53,177,94,83,2,31,1,1,allow,0,0,Normal
54238,445,0,0,70,70,0,1,0,1,0,drop,0,1,Known Attack
27005,27058,35794,27058,908,126,782,2,30,1,1,allow,1,0,Potential Threat
58742,443,35475,443,5166,700,4466,16,15,7,9,allow,1,0,Potential Threat
49262,53,13310,53,168,86,82,2,29,1,1,allow,0,0,Normal
9748,21247,0,0,66,66,0,1,0,1,0,deny,0,1,Known Attack
65497,53,35507,53,194,99,95,2,31,1,1,allow,0,0,Normal
56313,443,7717,443,37465,18615,18850,299,588,135,164,allow,1,0,Potential Threat
56951,53,25007,53,198,101,97,2,31,1,1,allow,0,0,Normal
56965,53,26904,53,183,94,89,2,30,1,1,allow,0,0,Normal
19473,6889,17971,6889,481,150,331,2,1200,1,1,allow,1,0,Potential Threat
52185,13269,13389,13269,70,70,0,1,4,1,0,allow,1,0,Potential Threat
52471,443,64710,443,8398,1552,6846,27,50,14,13,allow,1,0,Potential Threat
52322,53,58058,53,86,86,0,1,30,1,0,allow,0,0,Normal
57372,53,54871,53,177,94,83,2,30,1,1,allow,0,0,Normal
64950,445,0,0,70,70,0,1,0,1,0,drop,0,1,Known Attack
49963,53,30474,53,279,96,183,4,58,2,2,allow,0,0,Normal
35849,30188,0,0,146,146,0,1,0,1,0,deny,1,1,High Risk
13514,53,13514,53,244,98,146,2,32,1,1,allow,0,0,Normal
52993,443,64908,443,16229,3316,12913,23,125,9,14,allow,1,0,Potential Threat
57312,53,30289,53,212,110,102,2,31,1,1,allow,0,0,Normal
16693,36237,0,0,66,66,0,1,0,1,0,deny,1,1,High Risk
57159,445,0,0,70,70,0,1,0,1,0,drop,0,1,Known Attack
53897,46913,50139,46913,552,306,246,9,15,5,4,allow,1,0,Potential Threat
47141,50584,0,0,62,62,0,1,0,1,0,deny,0,1,Known Attack
6881,6881,7756,6881,501,150,351,2,1200,1,1,allow,1,0,Potential Threat
35421,30188,0,0,146,146,0,1,0,1,0,deny,1,1,High Risk
49364,80,23008,80,1614,1300,314,10,15,5,5,allow,0,0,Normal
19473,6881,30849,6881,491,150,341,2,1200,1,1,allow,1,0,Potential Threat
53111,50809,43690,50809,70,70,0,1,4,1,0,allow,1,0,Potential Threat
6843,42873,0,0,62,62,0,1,0,1,0,deny,1,1,High Risk
64797,53,54337,53,182,93,89,2,30,1,1,allow,0,0,Normal
53796,48019,39849,48019,70,70,0,2,7,2,0,allow,1,0,Potential Threat
50502,443,59383,443,11323,3376,7947,29,77,16,13,allow,1,0,Potential Threat
62880,53,59831,53,248,78,170,2,30,1,1,allow,0,0,Normal
62772,445,0,0,66,66,0,1,0,1,0,drop,0,1,Known Attack
64926,53,0,0,371,77,294,2,30,1,1,allow,0,0,Normal
31925,53,31925,53,237,91,146,2,33,1,1,allow,0,0,Normal
50119,443,16718,443,15168,5689,9479,51,34,27,24,allow,1,0,Potential Threat
65349,53,30593,53,772,103,669,2,31,1,1,allow,0,0,Normal
63971,42759,55186,42759,504,382,122,8,15,6,2,allow,1,0,Potential Threat
4110,35440,0,0,66,66,0,1,0,1,0,deny,1,1,High Risk
63745,445,0,0,66,66,0,1,0,1,0,drop,0,1,Known Attack
35098,161,0,0,15190,7454,7736,78,30,39,39,allow,1,0,Potential Threat
51522,445,0,0,66,66,0,1,0,1,0,drop,0,1,Known Attack
39687,443,29168,443,10412,5123,5289,36,236,19,17,allow,1,0,Potential Threat
49418,27015,58093,27015,78,78,0,1,30,1,0,allow,1,0,Potential Threat
35549,443,45483,443,9032,2244,6788,36,255,17,19,allow,1,0,Potential Threat
63542,445,0,0,70,70,0,1,0,1,0,drop,0,1,Known Attack
54115,443,7544,443,6840,1394,5446,29,270,14,15,allow,1,0,Potential Threat
55877,1049,50494,1049,323,150,173,2,1200,1,1,allow,1,0,Potential Threat
50028,53,56615,53,323,110,213,2,29,1,1,allow,0,0,Normal
57807,80,6054,80,1013,566,447,8,162,5,3,allow,1,0,Potential Threat
49417,53,14090,53,211,110,101,2,30,1,1,allow,0,0,Normal
59068,57470,0,0,74,74,0,1,0,1,0,deny,1,1,High Risk
50468,443,35607,443,227265,6450,220815,225,124,63,162,allow,1,0,Potential Threat
38420,80,16840,80,4535,1637,2898,23,2899,14,9,allow,1,0,Potential Threat
20563,21247,0,0,66,66,0,1,0,1,0,deny,0,1,Known Attack
51196,443,64591,443,346,140,206,6,130,3,3,allow,1,0,Potential Threat
38330,44847,0,0,66,66,0,1,0,1,0,deny,0,1,Known Attack
49593,5228,25502,5228,9720,2717,7003,67,1019,34,33,allow,1,0,Potential Threat
32520,47993,0,0,66,66,0,1,0,1,0,deny,1,1,High Risk
58849,64147,0,0,62,62,0,1,0,1,0,deny,1,1,High Risk
54994,53,3788,53,209,110,99,2,30,1,1,allow,0,0,Normal
57408,53,58963,53,195,102,93,2,33,1,1,allow,0,0,Normal
59790,445,0,0,66,66,0,1,0,1,0,drop,0,1,Known Attack
49676,53,19443,53,216,110,106,2,30,1,1,allow,0,0,Normal
55196,10387,0,0,159,159,0,1,0,1,0,deny,0,1,Known Attack
36656,64147,0,0,62,62,0,1,0,1,0,deny,1,1,High Risk
3181,53,3181,53,214,97,117,2,30,1,1,allow,1,0,Potential Threat
65514,53,61722,53,291,98,193,4,33,2,2,allow,1,0,Potential Threat
51928,80,8868,80,1357,963,394,10,26,7,3,allow,1,0,Potential Threat
10333,22114,0,0,146,146,0,1,0,1,0,deny,1,1,High Risk
63389,3389,63389,3389,293,223,70,4,0,3,1,reset-both,1,1,High Risk
56030,445,0,0,70,70,0,1,0,1,0,drop,0,1,Known Attack
65176,53,48862,53,193,102,91,2,31,1,1,allow,0,0,Normal
65129,53,16453,53,324,110,214,2,30,1,1,allow,0,0,Normal
51079,80,14506,80,19699,2094,17605,32,229,14,18,allow,1,0,Potential Threat
26900,27017,12054,27017,422,164,258,6,30,3,3,allow,1,0,Potential Threat
51578,44847,0,0,66,66,0,1,0,1,0,deny,0,1,Known Attack
43109,80,31634,80,7607,3563,4044,18,20,9,9,allow,1,0,Potential Threat
35023,53,0,0,82,82,0,2,40,2,0,allow,0,0,Normal
50254,44847,0,0,66,66,0,1,0,1,0,deny,0,1,Known Attack
64080,445,0,0,70,70,0,1,0,1,0,drop,0,1,Known Attack
64426,53,6048,53,289,101,188,4,50,2,2,allow,0,0,Normal
48817,57451,48817,57451,152,152,0,1,1200,1,0,allow,1,0,Potential Threat
25363,22114,0,0,66,66,0,1,0,1,0,deny,0,1,Known Attack
53540,443,65354,443,20948,4141,16807,76,616,37,39,allow,1,0,Potential Threat
55199,53,24591,53,152,78,74,2,29,1,1,allow,0,0,Normal
8979,443,54799,443,62149740,2002795,60146945,62894,211,19380,43514,allow,1,0,Potential Threat
35266,53,50904,53,164,78,86,2,30,1,1,allow,0,0,Normal
56675,443,33305,443,7941,1952,5989,20,15,11,9,allow,1,0,Potential Threat
64605,445,0,0,66,66,0,1,0,1,0,drop,0,1,Known Attack
54428,445,0,0,70,70,0,1,0,1,0,drop,0,1,Known Attack
39336,443,13653,443,4362,1145,3217,17,25,9,8,allow,1,0,Potential Threat
28999,37807,0,0,62,62,0,1,0,1,0,deny,0,1,Known Attack
64510,443,61997,443,18370,2434,15936,26,120,11,15,allow,1,0,Potential Threat
64038,28187,34899,28187,66,66,0,2,8,2,0,allow,1,0,Potential Threat
52057,34664,13510,34664,70,70,0,2,8,2,0,allow,1,0,Potential Threat
55057,443,7517,443,1364,940,424,12,16,7,5,allow,1,0,Potential Threat
56120,53,36940,53,212,102,110,2,30,1,1,allow,0,0,Normal
61506,443,7741,443,15255,2304,12951,30,31,13,17,allow,1,0,Potential Threat
62375,445,0,0,70,70,0,1,0,1,0,drop,0,1,Known Attack
32722,25174,0,0,62,62,0,1,0,1,0,deny,0,1,Known Attack
57117,53,45575,53,366,102,264,4,46,2,2,allow,0,0,Normal
57927,445,0,0,70,70,0,1,0,1,0,drop,0,1,Known Attack
64217,53,58721,53,186,95,91,2,31,1,1,allow,0,0,Normal
57432,443,22941,443,26468,3325,23143,41,147,16,25,allow,1,0,Potential Threat
50265,24387,12796,24387,132,132,0,3,1200,3,0,allow,1,0,Potential Threat
56225,53,8973,53,194,102,92,2,29,1,1,allow,0,0,Normal
27005,27016,26608,27016,880,126,754,2,30,1,1,allow,1,0,Potential Threat
47508,443,1346,443,5778,1095,4683,17,26,10,7,allow,1,0,Potential Threat
61141,445,0,0,70,70,0,1,0,1,0,drop,0,1,Known Attack
51495,445,0,0,66,66,0,1,0,1,0,drop,0,1,Known Attack
49646,53,41795,53,209,102,107,2,30,1,1,allow,0,0,Normal
49323,53,12095,53,790,110,680,2,30,1,1,allow,0,0,Normal
60684,80,43634,80,1737,796,941,12,16,7,5,allow,1,0,Potential Threat
55109,445,0,0,70,70,0,1,0,1,0,drop,0,1,Known Attack
6881,64910,0,0,146,146,0,1,0,1,0,deny,1,1,High Risk
49650,80,5839,80,318,192,126,6,41,4,2,allow,0,0,Normal
6881,58293,28909,58293,228,118,110,2,1200,1,1,allow,1,0,Potential Threat
50283,49169,0,0,66,66,0,1,0,1,0,deny,0,1,Known Attack
56901,53,23977,53,710,89,621,2,31,1,1,allow,0,0,Normal
60222,443,32889,443,12428,5331,7097,47,32,21,26,allow,1,0,Potential Threat
55386,32480,0,0,66,66,0,1,0,1,0,deny,0,1,Known Attack
53550,445,0,0,70,70,0,1,0,1,0,drop,0,1,Known Attack
50542,53,12388,53,782,110,672,2,30,1,1,allow,0,0,Normal
44847,9912,37796,9912,502,150,352,2,1200,1,1,allow,1,0,Potential Threat
60803,80,16464,80,254,128,126,5,15,3,2,allow,0,0,Normal
21482,22114,0,0,62,62,0,1,0,1,0,deny,0,1,Known Attack
37571,443,14290,443,499,425,74,4,0,3,1,allow,0,0,Normal
61639,37965,0,0,66,66,0,1,0,1,0,deny,0,1,Known Attack
33165,443,61975,443,7442,1260,6182,19,15,10,9,allow,1,0,Potential Threat
59591,445,0,0,70,70,0,1,0,1,0,drop,0,1,Known Attack
3478,61463,0,0,1118,1118,0,1,0,1,0,deny,1,1,High Risk
56655,445,0,0,70,70,0,1,0,1,0,drop,0,1,Known Attack
53530,53,6923,53,164,78,86,2,30,1,1,allow,0,0,Normal
60486,8999,41044,8999,70,70,0,1,5,1,0,allow,1,0,Potential Threat
50316,53,38175,53,753,94,659,2,29,1,1,allow,0,0,Normal
34914,26467,0,0,62,62,0,1,0,1,0,deny,0,1,Known Attack
57386,443,57835,443,1056,569,487,10,38,6,4,allow,1,0,Potential Threat
42732,57470,0,0,62,62,0,1,0,1,0,deny,0,1,Known Attack
13062,52752,0,0,66,66,0,1,0,1,0,deny,1,1,High Risk
54343,50584,0,0,66,66,0,1,0,1,0,deny,0,1,Known Attack
62921,993,3682,993,8856,4253,4603,79,27,42,37,allow,1,0,Potential Threat
37067,443,4326,443,21446,1599,19847,35,155,16,19,allow,1,0,Potential Threat
64279,53,42792,53,177,94,83,2,30,1,1,allow,0,0,Normal
48755,23,0,0,60,60,0,1,0,1,0,deny,0,1,Known Attack
49506,53,26702,53,200,102,98,2,31,1,1,allow,0,0,Normal
49300,445,0,0,66,66,0,1,0,1,0,drop,0,1,Known Attack
60256,80,21007,80,3401,2157,1244,12,149,7,5,allow,1,0,Potential Threat
52853,445,0,0,66,66,0,1,0,1,0,drop,0,1,Known Attack
45567,443,10380,443,1473,988,485,12,25,7,5,allow,1,0,Potential Threat
65224,445,0,0,66,66,0,1,0,1,0,drop,0,1,Known Attack
29682,44847,0,0,62,62,0,1,0,1,0,deny,1,1,High Risk
62218,53,62218,53,253,99,154,2,33,1,1,allow,1,0,Potential Threat
17119,53,17119,53,217,87,130,2,30,1,1,allow,0,0,Normal
64210,445,0,0,70,70,0,1,0,1,0,drop,0,1,Known Attack
36551,443,34195,443,8674,2101,6573,25,15,13,12,allow,1,0,Potential Threat
61075,445,0,0,70,70,0,1,0,1,0,drop,0,1,Known Attack
60377,65054,58961,65054,624,318,306,10,15,5,5,allow,1,0,Potential Threat
44847,26356,3716,26356,501,150,351,2,1200,1,1,allow,1,0,Potential Threat
65386,445,0,0,66,66,0,1,0,1,0,drop,0,1,Known Attack
58824,443,46343,443,11863,7694,4169,33,17,17,16,allow,1,0,Potential Threat
14697,8000,59482,8000,212,150,62,2,30,1,1,allow,1,0,Potential Threat
61718,445,0,0,70,70,0,1,0,1,0,drop,0,1,Known Attack
53501,445,0,0,66,66,0,1,0,1,0,drop,0,1,Known Attack
55453,53,1077,53,730,102,628,2,30,1,1,allow,0,0,Normal
50872,80,50084,80,54441,4387,50054,75,140,37,38,allow,1,0,Potential Threat
63284,445,0,0,70,70,0,1,0,1,0,drop,0,1,Known Attack
63769,47661,26406,47661,70,70,0,1,5,1,0,allow,1,0,Potential Threat
54519,445,0,0,70,70,0,1,0,1,0,drop,0,1,Known Attack
57237,21247,0,0,62,62,0,1,0,1,0,deny,0,1,Known Attack
60374,443,9623,443,130,70,60,2,15,1,1,allow,0,0,Normal
51221,10476,15636,10476,528,528,0,9,1201,9,0,allow,1,0,Potential Threat
57880,80,31507,80,13028,3246,9782,29,30,16,13,allow,1,0,Potential Threat
56391,445,0,0,66,66,0,1,0,1,0,drop,0,1,Known Attack
27005,27055,64070,27055,915,126,789,2,31,1,1,allow,1,0,Potential Threat
65012,32468,0,0,66,66,0,1,0,1,0,deny,0,1,Known Attack
47391,443,14660,443,9921,3169,6752,31,20,17,14,allow,1,0,Potential Threat
63062,53,18913,53,70,70,0,1,30,1,0,allow,0,0,Normal
29029,53,43871,53,323,77,246,4,30,2,2,allow,1,0,Potential Threat
60572,80,35245,80,556,280,276,9,28,5,4,allow,0,0,Normal
50223,445,0,0,66,66,0,1,0,1,0,drop,0,1,Known Attack
55646,53,7208,53,216,94,122,2,30,1,1,allow,0,0,Normal
49020,80,13819,80,3422,2088,1334,18,152,9,9,allow,1,0,Potential Threat
64980,53,54616,53,200,102,98,2,30,1,1,allow,0,0,Normal
55190,445,0,0,70,70,0,1,0,1,0,drop,0,1,Known Attack
63774,445,0,0,70,70,0,1,0,1,0,drop,0,1,Known Attack
48706,23393,0,0,60,60,0,1,0,1,0,deny,0,1,Known Attack
60895,445,0,0,66,66,0,1,0,1,0,drop,0,1,Known Attack
38926,37965,0,0,62,62,0,1,0,1,0,deny,0,1,Known Attack
65122,53,25897,53,410,110,300,2,30,1,1,allow,0,0,Normal
49225,443,22877,443,11707,2326,9381,28,19,14,14,allow,1,0,Potential Threat
41197,30188,0,0,62,62,0,1,0,1,0,deny,0,1,Known Attack
56816,53,44842,53,754,94,660,2,31,1,1,allow,0,0,Normal
19610,55839,0,0,137,137,0,1,0,1,0,deny,1,1,High Risk
58638,5900,0,0,62,62,0,1,0,1,0,deny,0,1,Known Attack
59683,443,22150,443,13310,4422,8888,47,136,27,20,allow,1,0,Potential Threat
27005,27052,57707,27052,1948,378,1570,6,33,4,2,allow,1,0,Potential Threat
57368,7302,0,0,66,66,0,1,0,1,0,deny,0,1,Known Attack
35485,443,29586,443,1633,1038,595,14,34,8,6,allow,1,0,Potential Threat
56960,53,36561,53,196,102,94,2,30,1,1,allow,0,0,Normal
53922,445,0,0,70,70,0,1,0,1,0,drop,0,1,Known Attack
53913,443,40081,443,499,425,74,4,0,3,1,allow,0,0,Normal
60230,445,0,0,70,70,0,1,0,1,0,drop,0,1,Known Attack
49611,53,44426,53,184,94,90,2,30,1,1,allow,0,0,Normal
53469,36237,0,0,66,66,0,1,0,1,0,deny,0,1,Known Attack
13021,25174,0,0,62,62,0,1,0,1,0,deny,0,1,Known Attack
63032,22114,0,0,66,66,0,1,0,1,0,deny,0,1,Known Attack
36503,443,18047,443,3549,899,2650,13,120,6,7,allow,1,0,Potential Threat
56673,443,23897,443,6693,1072,5621,18,26,10,8,allow,1,0,Potential Threat
27005,4444,13134,4444,881,126,755,2,30,1,1,allow,1,0,Potential Threat
55452,53,54913,53,184,94,90,2,30,1,1,allow,0,0,Normal
55966,443,15279,443,9006,2048,6958,36,121,18,18,allow,1,0,Potential Threat
60596,53,45720,53,300,86,214,2,31,1,1,allow,0,0,Normal
64658,53,8151,53,195,102,93,2,30,1,1,allow,0,0,Normal
58264,44847,0,0,66,66,0,1,0,1,0,deny,0,1,Known Attack
50313,445,0,0,70,70,0,1,0,1,0,drop,0,1,Known Attack
21998,51221,0,0,62,62,0,1,0,1,0,deny,1,1,High Risk
65120,445,0,0,66,66,0,1,0,1,0,drop,0,1,Known Attack
9756,26467,0,0,66,66,0,1,0,1,0,deny,0,1,Known Attack
16387,3655,0,0,60,60,0,1,0,1,0,deny,0,1,Known Attack
47548,53,51360,53,168,78,90,2,30,1,1,allow,0,0,Normal
49413,443,21606,443,7849,1104,6745,23,123,12,11,allow,1,0,Potential Threat
57814,443,32836,443,6162,925,5237,18,108,10,8,allow,1,0,Potential Threat
51921,37744,59756,37744,70,70,0,2,8,2,0,allow,1,0,Potential Threat
64756,11392,0,0,62,62,0,1,0,1,0,deny,0,1,Known Attack
51961,40373,19759,40373,70,70,0,2,8,2,0,allow,1,0,Potential Threat
53624,53,53624,53,832,106,726,2,29,1,1,allow,0,0,Normal
48706,23393,0,0,60,60,0,1,0,1,0,deny,0,1,Known Attack
39017,443,58610,443,5176,861,4315,16,26,9,7,allow,1,0,Potential Threat
51594,53,51594,53,219,92,127,2,30,1,1,allow,0,0,Normal
36406,443,50079,443,1149,709,440,13,38,8,5,allow,1,0,Potential Threat
41581,443,9229,443,6816,1197,5619,24,269,12,12,allow,1,0,Potential Threat
58638,5900,0,0,62,62,0,1,0,1,0,deny,0,1,Known Attack
56486,443,16895,443,2673671,30446,2643225,2145,125,234,1911,allow,1,0,Potential Threat
51221,49683,21900,49683,870,330,540,12,1316,6,6,allow,1,0,Potential Threat
50894,80,58930,80,5900,751,5149,15,130,7,8,allow,1,0,Potential Threat
56601,80,22349,80,234,234,0,4,12,4,0,allow,0,0,Normal
60292,7129,0,0,62,62,0,1,0,1,0,deny,0,1,Known Attack
50639,445,0,0,66,66,0,1,0,1,0,drop,0,1,Known Attack
49653,443,56043,443,8915,2193,6722,22,46,13,9,allow,1,0,Potential Threat
60326,80,6892,80,3697,2062,1635,16,61,9,7,allow,1,0,Potential Threat
51756,41471,58464,41471,70,70,0,1,5,1,0,allow,1,0,Potential Threat
50452,80,41109,80,318,192,126,6,29,4,2,allow,0,0,Normal
55415,53,34000,53,182,93,89,2,31,1,1,allow,0,0,Normal
55265,53,65356,53,199,102,97,2,30,1,1,allow,1,0,Potential Threat
53195,443,48069,443,1462,965,497,13,18,7,6,allow,0,0,Normal
55475,443,50971,443,8714,1456,7258,25,32,13,12,allow,1,0,Potential Threat
27005,33055,20199,33055,888,126,762,2,31,1,1,allow,1,0,Potential Threat
26900,27017,2675,27017,422,164,258,6,30,3,3,allow,1,0,Potential Threat
39937,443,39937,443,4756,1849,2907,19,27,11,8,allow,1,0,Potential Threat
64164,445,0,0,70,70,0,1,0,1,0,drop,0,1,Known Attack
46409,80,63158,80,1053,613,440,10,15,5,5,allow,1,0,Potential Threat
56646,48817,0,0,62,62,0,1,0,1,0,deny,0,1,Known Attack
50662,443,44987,443,3306,1714,1592,17,16,9,8,allow,1,0,Potential Threat
59182,53,59092,53,168,78,90,2,30,1,1,allow,0,0,Normal
63896,80,57609,80,314,192,122,6,15,4,2,allow,1,0,Potential Threat
44155,443,5461,443,5157,917,4240,20,360,10,10,allow,1,0,Potential Threat
11859,64147,0,0,62,62,0,1,0,1,0,deny,1,1,High Risk
40603,53,40603,53,240,96,144,2,31,1,1,allow,0,0,Normal
21594,22448,0,0,62,62,0,1,61,1,0,allow,1,0,Potential Threat
60231,443,26634,443,1868,1229,639,18,151,11,7,allow,1,0,Potential Threat
51909,33509,44942,33509,70,70,0,2,8,2,0,allow,1,0,Potential Threat
55635,53,27124,53,170,87,83,2,30,1,1,allow,0,0,Normal
26494,26467,0,0,62,62,0,1,0,1,0,deny,0,1,Known Attack
55967,53,9494,53,701,88,613,2,30,1,1,allow,0,0,Normal
65228,53,60799,53,267,93,174,4,47,2,2,allow,1,0,Potential Threat
65024,53,40250,53,198,101,97,2,32,1,1,allow,0,0,Normal
60141,62413,0,0,66,66,0,1,0,1,0,deny,1,1,High Risk
50063,53,17752,53,173,94,79,2,29,1,1,allow,0,0,Normal
52101,443,43263,443,22696,18094,4602,41,315,25,16,allow,1,0,Potential Threat
64429,53,41917,53,217,94,123,2,30,1,1,allow,0,0,Normal
5588,5588,0,0,3354,1792,1562,46,194,23,23,allow,1,0,Potential Threat
41755,48817,0,0,145,145,0,1,0,1,0,deny,1,1,High Risk
53893,443,15377,443,499,425,74,4,0,3,1,allow,0,0,Normal
12242,51221,0,0,62,62,0,1,0,1,0,deny,1,1,High Risk
46275,64147,0,0,62,62,0,1,0,1,0,deny,1,1,High Risk
50252,53,7370,53,165,86,79,2,30,1,1,allow,0,0,Normal
55666,36653,34073,36653,70,70,0,1,5,1,0,allow,1,0,Potential Threat
55713,25174,0,0,62,62,0,1,0,1,0,deny,0,1,Known Attack
52016,58318,32216,58318,70,70,0,2,9,2,0,allow,1,0,Potential Threat
53495,37807,0,0,66,66,0,1,0,1,0,deny,0,1,Known Attack
50400,53,28411,53,177,94,83,2,30,1,1,allow,0,0,Normal
64561,53,25485,53,270,94,176,2,30,1,1,allow,0,0,Normal
50897,80,4903,80,13981183,155668,13825515,11482,136,2194,9288,allow,1,0,Potential Threat
55484,445,0,0,66,66,0,1,0,1,0,drop,0,1,Known Attack
24988,53,24988,53,214,82,132,2,33,1,1,allow,0,0,Normal
63390,445,0,0,70,70,0,1,0,1,0,drop,0,1,Known Attack
44517,53,22276,53,306,212,94,3,29,2,1,allow,0,0,Normal
60776,445,0,0,70,70,0,1,0,1,0,drop,0,1,Known Attack
58638,5900,0,0,62,62,0,1,0,1,0,deny,0,1,Known Attack
59511,21247,0,0,66,66,0,1,0,1,0,deny,0,1,Known Attack
36541,443,3197,443,4322,797,3525,14,64,8,6,allow,1,0,Potential Threat
38637,443,8499,443,12339,2392,9947,36,287,15,21,allow,1,0,Potential Threat
64683,53,62247,53,198,102,96,2,29,1,1,allow,1,0,Potential Threat
33543,44847,0,0,66,66,0,1,0,1,0,deny,1,1,High Risk
49437,443,4843,443,9621,2347,7274,24,78,12,12,allow,1,0,Potential Threat
60939,445,0,0,70,70,0,1,0,1,0,drop,0,1,Known Attack
49437,53,49111,53,498,204,294,6,30,3,3,allow,0,0,Normal
64040,12226,50739,12226,70,70,0,1,4,1,0,allow,1,0,Potential Threat
29021,23,0,0,60,60,0,1,0,1,0,deny,0,1,Known Attack
56700,53,42094,53,443,182,261,6,30,3,3,allow,0,0,Normal
55504,445,0,0,70,70,0,1,0,1,0,drop,0,1,Known Attack
58755,443,6984,443,4827,2244,2583,16,135,8,8,allow,1,0,Potential Threat
45964,2777,0,0,60,60,0,1,0,1,0,deny,0,1,Known Attack
53243,57470,0,0,74,74,0,1,0,1,0,deny,1,1,High Risk
58858,443,56785,443,7413235,214811,7198424,7869,344,2785,5084,allow,1,0,Potential Threat
44919,26467,0,0,62,62,0,1,0,1,0,deny,0,1,Known Attack
53016,80,53016,80,265868,5026,260842,277,24,75,202,allow,1,0,Potential Threat
49966,53,5626,53,168,78,90,2,30,1,1,allow,0,0,Normal
63864,44139,53899,44139,70,70,0,1,5,1,0,allow,1,0,Potential Threat
54455,445,0,0,70,70,0,1,0,1,0,drop,0,1,Known Attack
57270,53,35020,53,211,102,109,2,30,1,1,allow,0,0,Normal
6943,57099,0,0,100,100,0,1,0,1,0,deny,1,1,High Risk
64812,53,57206,53,347,91,256,4,56,2,2,allow,1,0,Potential Threat
51221,51413,15223,51413,460,150,310,2,1200,1,1,allow,1,0,Potential Threat
57493,443,0,0,60,60,0,1,0,1,0,deny,0,1,Known Attack
60698,445,0,0,66,66,0,1,0,1,0,drop,0,1,Known Attack
34744,443,31137,443,13175,2432,10743,52,3587,23,29,allow,1,0,Potential Threat
65477,53,61765,53,183,94,89,2,30,1,1,allow,1,0,Potential Threat
38053,50584,0,0,62,62,0,1,0,1,0,deny,0,1,Known Attack
56502,445,0,0,66,66,0,1,0,1,0,drop,0,1,Known Attack
60228,80,30633,80,6854,6211,643,16,151,9,7,allow,1,0,Potential Threat
45844,80,40841,80,152,78,74,2,5,1,1,allow,0,0,Normal
10467,25174,0,0,62,62,0,1,0,1,0,deny,0,1,Known Attack
64312,53,26634,53,202,103,99,2,31,1,1,allow,0,0,Normal
50914,443,19872,443,8058,1136,6922,19,129,9,10,allow,1,0,Potential Threat
34359,80,6984,80,350,210,140,6,14,4,2,allow,1,0,Potential Threat
28007,443,40494,443,31586,15587,15999,213,884,105,108,allow,1,0,Potential Threat
9192,443,26579,443,318,192,126,6,22,4,2,allow,1,0,Potential Threat
50,64147,0,0,66,66,0,1,0,1,0,deny,1,1,High Risk
51730,33399,18349,33399,66,66,0,1,5,1,0,allow,1,0,Potential Threat
49631,53,56350,53,198,102,96,2,30,1,1,allow,0,0,Normal
56426,53,19941,53,184,94,90,2,31,1,1,allow,0,0,Normal
58791,15503,0,0,66,66,0,1,0,1,0,deny,0,1,Known Attack
16660,55783,0,0,62,62,0,1,0,1,0,deny,1,1,High Risk
56878,443,56878,443,27657,5506,22151,58,46,30,28,allow,1,0,Potential Threat
18889,50584,0,0,146,146,0,1,0,1,0,deny,1,1,High Risk
64940,445,0,0,70,70,0,1,0,1,0,drop,0,1,Known Attack
49160,51839,39818,51839,868,150,718,4,1200,2,2,allow,1,0,Potential Threat
16948,990,0,0,60,60,0,1,0,1,0,deny,0,1,Known Attack
50869,445,0,0,70,70,0,1,0,1,0,drop,0,1,Known Attack
50584,53,13408,53,793,101,692,2,30,1,1,allow,0,0,Normal
36148,443,59223,443,2233,1237,996,18,75,9,9,allow,1,0,Potential Threat
52069,53446,38596,53446,70,70,0,2,7,2,0,allow,1,0,Potential Threat
60416,37965,0,0,66,66,0,1,0,1,0,deny,0,1,Known Attack
64565,445,0,0,70,70,0,1,0,1,0,drop,0,1,Known Attack
45995,443,45995,443,1494,898,596,12,142,6,6,allow,1,0,Potential Threat
60223,67,0,0,60,60,0,1,0,1,0,deny,0,1,Known Attack
64936,53,3056,53,193,102,91,2,30,1,1,allow,0,0,Normal
65189,27015,29892,27015,295,78,217,2,30,1,1,allow,1,0,Potential Threat
50834,64147,0,0,62,62,0,1,0,1,0,deny,1,1,High Risk
55450,445,0,0,70,70,0,1,0,1,0,drop,0,1,Known Attack
27908,23,0,0,60,60,0,1,0,1,0,deny,0,1,Known Attack
49175,53,11847,53,193,102,91,2,29,1,1,allow,0,0,Normal
33871,443,48273,443,11277,2233,9044,43,215,20,23,allow,1,0,Potential Threat
54849,22448,0,0,66,66,0,1,90,1,0,allow,0,0,Normal
52743,443,59107,443,1547,960,587,14,26,8,6,allow,1,0,Potential Threat
59483,23,0,0,60,60,0,1,0,1,0,deny,0,1,Known Attack
63595,51050,0,0,66,66,0,1,0,1,0,deny,1,1,High Risk
64689,53,34039,53,183,94,89,2,30,1,1,allow,0,0,Normal
60058,25174,0,0,66,66,0,1,0,1,0,deny,0,1,Known Attack
57706,445,0,0,70,70,0,1,0,1,0,drop,0,1,Known Attack
57170,38303,0,0,66,66,0,1,0,1,0,deny,0,1,Known Attack
51045,25174,0,0,62,62,0,1,0,1,0,deny,0,1,Known Attack
58816,443,57126,443,5168,700,4468,16,15,7,9,allow,1,0,Potential Threat
59378,50584,0,0,62,62,0,1,0,1,0,deny,0,1,Known Attack
58883,445,0,0,66,66,0,1,0,1,0,drop,0,1,Known Attack
51657,445,0,0,70,70,0,1,0,1,0,drop,0,1,Known Attack
55551,53,53923,53,180,94,86,2,30,1,1,allow,0,0,Normal
57430,53,16018,53,200,102,98,2,29,1,1,allow,0,0,Normal
56512,53,52518,53,889,404,485,10,31,5,5,allow,0,0,Normal
56941,445,0,0,70,70,0,1,0,1,0,drop,0,1,Known Attack
38082,443,40503,443,9037,1851,7186,26,180,14,12,allow,1,0,Potential Threat
37048,53,15129,53,168,78,90,2,29,1,1,allow,0,0,Normal
50716,50584,0,0,74,74,0,1,0,1,0,deny,0,1,Known Attack
64456,53,28818,53,341,110,231,2,29,1,1,allow,0,0,Normal
56331,445,0,0,70,70,0,1,0,1,0,drop,0,1,Known Attack
9138,80,8999,80,318,192,126,6,29,4,2,allow,1,0,Potential Threat
39390,15503,0,0,74,74,0,1,0,1,0,deny,0,1,Known Attack
35128,443,23671,443,9120,5103,4017,38,587,22,16,allow,1,0,Potential Threat
52838,37965,0,0,66,66,0,1,0,1,0,deny,0,1,Known Attack
62293,443,17682,443,598,598,0,8,40,8,0,allow,1,0,Potential Threat
34920,53,40562,53,168,78,90,2,31,1,1,allow,0,0,Normal
41895,443,48920,443,282,60,222,5,14,2,3,allow,0,0,Normal
43586,443,62166,443,2328,1429,899,18,33,10,8,allow,1,0,Potential Threat
50848,80,48215,80,1213557,27203,1186354,1120,133,327,793,allow,1,0,Potential Threat
62514,37807,0,0,66,66,0,1,0,1,0,deny,0,1,Known Attack
13281,51050,0,0,66,66,0,1,0,1,0,deny,1,1,High Risk
40326,443,22959,443,7937,3883,4054,65,4602,25,40,allow,1,0,Potential Threat
55204,53,12205,53,263,94,169,2,30,1,1,allow,0,0,Normal
53975,40978,50066,40978,1946,1019,927,10,15,6,4,allow,1,0,Potential Threat
63620,445,0,0,70,70,0,1,0,1,0,drop,0,1,Known Attack
54111,62609,0,0,148,148,0,1,0,1,0,deny,1,1,High Risk
49347,53,23678,53,342,91,251,4,54,2,2,allow,0,0,Normal
49708,53,2580,53,177,94,83,2,30,1,1,allow,0,0,Normal
49904,80,22359,80,1647,508,1139,8,138,5,3,allow,1,0,Potential Threat
64919,53,63713,53,822,102,720,2,29,1,1,allow,1,0,Potential Threat
63952,50734,54501,50734,66,66,0,2,8,2,0,allow,1,0,Potential Threat
61743,445,0,0,70,70,0,1,0,1,0,drop,0,1,Known Attack
51653,445,0,0,66,66,0,1,0,1,0,drop,0,1,Known Attack
65451,445,0,0,66,66,0,1,0,1,0,drop,0,1,Known Attack
57192,53,44126,53,177,94,83,2,30,1,1,allow,0,0,Normal
56873,53,11452,53,184,94,90,2,29,1,1,allow,0,0,Normal
27005,27016,18663,27016,892,126,766,2,30,1,1,allow,1,0,Potential Threat
48857,50584,0,0,66,66,0,1,0,1,0,deny,0,1,Known Attack
24202,53,24202,53,220,90,130,2,29,1,1,allow,0,0,Normal
49990,443,43414,443,622,210,412,10,21,4,6,allow,0,0,Normal
49418,27058,37318,27058,263,78,185,2,30,1,1,allow,1,0,Potential Threat
56343,53,54537,53,177,94,83,2,30,1,1,allow,0,0,Normal
49209,53,59782,53,199,102,97,2,30,1,1,allow,0,0,Normal
35756,80,35756,80,364170,17670,346500,412,31,170,242,allow,1,0,Potential Threat
49752,53,64105,53,193,102,91,2,30,1,1,allow,1,0,Potential Threat
47957,443,9309,443,7658,4247,3411,29,31,15,14,allow,1,0,Potential Threat
15641,26467,0,0,62,62,0,1,0,1,0,deny,0,1,Known Attack
55373,445,0,0,70,70,0,1,0,1,0,drop,0,1,Known Attack
55727,53,2697,53,195,102,93,2,31,1,1,allow,0,0,Normal
50798,36237,0,0,62,62,0,1,0,1,0,deny,0,1,Known Attack
51981,445,0,0,70,70,0,1,0,1,0,drop,0,1,Known Attack
51781,445,0,0,70,70,0,1,0,1,0,deny,0,1,Known Attack
56712,53,47464,53,177,94,83,2,30,1,1,allow,0,0,Normal
54159,443,5303,443,10945,2478,8467,39,18,19,20,allow,1,0,Potential Threat
49673,443,32250,443,6404,829,5575,18,57,9,9,allow,1,0,Potential Threat
38728,53,38728,53,414,268,146,3,33,2,1,allow,0,0,Normal
20689,53,20689,53,237,91,146,2,33,1,1,allow,0,0,Normal
49711,14984,0,0,66,66,0,1,0,1,0,deny,0,1,Known Attack
51973,44847,0,0,62,62,0,1,0,1,0,deny,0,1,Known Attack
48817,6884,48817,6884,479,277,202,4,1200,2,2,allow,1,0,Potential Threat
64333,445,0,0,70,70,0,1,0,1,0,drop,0,1,Known Attack
49157,53,54699,53,184,94,90,2,30,1,1,allow,0,0,Normal
55041,80,12804,80,486,240,246,9,35,5,4,allow,0,0,Normal
30960,45703,22089,45703,330,330,0,6,3609,6,0,allow,1,0,Potential Threat
45764,443,11581,443,57543,2347,55196,68,16,26,42,allow,1,0,Potential Threat
52021,443,14701,443,7508,2350,5158,37,1323,21,16,allow,1,0,Potential Threat
49845,53,0,0,206,83,123,2,30,1,1,allow,0,0,Normal
53598,40326,41639,40326,70,70,0,2,7,2,0,allow,1,0,Potential Threat
52973,57470,0,0,74,74,0,1,0,1,0,deny,1,1,High Risk
53725,57418,1375,57418,70,70,0,2,8,2,0,allow,1,0,Potential Threat
64053,53,32861,53,276,94,182,4,54,2,2,allow,0,0,Normal
37616,443,4256,443,18611,3046,15565,41,362,20,21,allow,1,0,Potential Threat
58638,5900,0,0,62,62,0,1,0,1,0,deny,0,1,Known Attack
34932,38608,0,0,62,62,0,1,0,1,0,deny,0,1,Known Attack
56704,53,2195,53,177,94,83,2,30,1,1,allow,0,0,Normal
50442,25174,0,0,66,66,0,1,0,1,0,deny,0,1,Known Attack
49860,445,0,0,70,70,0,1,0,1,0,drop,0,1,Known Attack
53017,80,53017,80,184725,5028,179697,217,25,75,142,allow,1,0,Potential Threat
36080,26467,0,0,62,62,0,1,0,1,0,deny,0,1,Known Attack
8917,443,55362,443,7308,864,6444,26,394,9,17,allow,1,0,Potential Threat
17177,64147,0,0,62,62,0,1,0,1,0,deny,1,1,High Risk
56334,53,19616,53,177,94,83,2,30,1,1,allow,0,0,Normal
55442,53,42681,53,177,94,83,2,30,1,1,allow,0,0,Normal
56522,443,50354,443,5212,1037,4175,20,115,10,10,allow,1,0,Potential Threat
60260,22114,0,0,66,66,0,1,0,1,0,deny,0,1,Known Attack
44847,6892,1040,6892,279,161,118,3,1200,2,1,allow,1,0,Potential Threat
55467,53,65023,53,198,94,104,2,30,1,1,allow,1,0,Potential Threat
43465,80,31398,80,1352,848,504,13,255,8,5,allow,1,0,Potential Threat
55877,39578,13811,39578,150,150,0,1,1200,1,0,allow,1,0,Potential Threat
51171,445,0,0,70,70,0,1,0,1,0,drop,0,1,Known Attack
37924,80,11096,80,214,140,74,4,15,3,1,allow,0,0,Normal
58874,443,22621,443,4738,1023,3715,18,66,10,8,allow,1,0,Potential Threat
64949,44847,0,0,62,62,0,1,0,1,0,deny,1,1,High Risk
3212,22114,0,0,62,62,0,1,0,1,0,deny,1,1,High Risk
34485,81,0,0,60,60,0,1,0,1,0,deny,0,1,Known Attack
55477,80,28863,80,498,280,218,8,26,5,3,allow,0,0,Normal
46279,443,60019,443,172,172,0,2,5,2,0,allow,1,0,Potential Threat
62769,25174,0,0,62,62,0,1,0,1,0,deny,0,1,Known Attack
55505,53,4978,53,199,102,97,2,29,1,1,allow,0,0,Normal
50630,53,12018,53,209,110,99,2,29,1,1,allow,0,0,Normal
50584,16455,26852,16455,1356,300,1056,6,1200,3,3,allow,1,0,Potential Threat
57878,55108,0,0,148,148,0,1,0,1,0,deny,1,1,High Risk
43185,443,5462,443,6951,1333,5618,26,271,14,12,allow,1,0,Potential Threat
56938,53,56411,53,199,102,97,2,31,1,1,allow,0,0,Normal
30114,65151,0,0,60,60,0,1,0,1,0,deny,1,1,High Risk
56111,53,45505,53,179,94,85,2,30,1,1,allow,0,0,Normal
60089,445,0,0,70,70,0,1,0,1,0,drop,0,1,Known Attack
64810,53,23866,53,199,102,97,2,29,1,1,allow,0,0,Normal
62894,993,44411,993,8840,4151,4689,80,190,41,39,allow,1,0,Potential Threat
51426,52700,0,0,100,100,0,1,0,1,0,deny,1,1,High Risk
57076,5222,34364,5222,15600,7789,7811,155,169,82,73,allow,1,0,Potential Threat
50306,80,39882,80,182517,10761,171756,265,352,130,135,allow,1,0,Potential Threat
49500,443,11255,443,16888,2692,14196,42,150,22,20,allow,1,0,Potential Threat
52848,443,15385,443,6218,1239,4979,14,133,7,7,allow,1,0,Potential Threat
58502,445,0,0,70,70,0,1,0,1,0,drop,0,1,Known Attack
3001,28680,0,0,148,148,0,1,0,1,0,deny,1,1,High Risk
51192,15503,0,0,66,66,0,1,0,1,0,deny,0,1,Known Attack
60347,80,6401,80,2018,1704,314,16,15,11,5,allow,1,0,Potential Threat
61270,445,0,0,70,70,0,1,0,1,0,drop,0,1,Known Attack
53737,51456,42714,51456,70,70,0,1,5,1,0,allow,1,0,Potential Threat
6666,138,0,0,60,60,0,1,0,1,0,deny,0,1,Known Attack
53543,44847,0,0,62,62,0,1,0,1,0,deny,0,1,Known Attack
56227,53,50602,53,278,102,176,2,30,1,1,allow,0,0,Normal
53004,445,0,0,66,66,0,1,0,1,0,drop,0,1,Known Attack
50245,44847,0,0,66,66,0,1,0,1,0,deny,0,1,Known Attack
53845,445,0,0,70,70,0,1,0,1,0,drop,0,1,Known Attack
40204,40027,54251,40027,245,182,63,2,30,1,1,allow,1,0,Potential Threat
64987,53,14036,53,192,98,94,2,30,1,1,allow,0,0,Normal
56808,53,41016,53,90,90,0,1,30,1,0,allow,0,0,Normal
61420,445,0,0,70,70,0,1,0,1,0,drop,0,1,Known Attack
58638,5900,0,0,62,62,0,1,0,1,0,deny,0,1,Known Attack
64937,53,42639,53,204,104,100,2,31,1,1,allow,0,0,Normal
64346,445,0,0,70,70,0,1,0,1,0,drop,0,1,Known Attack
56368,53,19422,53,817,98,719,2,30,1,1,allow,0,0,Normal
54277,22114,0,0,62,62,0,1,0,1,0,deny,0,1,Known Attack
4515,37807,0,0,62,62,0,1,0,1,0,deny,1,1,High Risk
50771,445,0,0,70,70,0,1,0,1,0,drop,0,1,Known Attack
57238,445,0,0,70,70,0,1,0,1,0,drop,0,1,Known Attack
56072,53,61103,53,199,102,97,2,30,1,1,allow,0,0,Normal
39061,22114,0,0,146,146,0,1,0,1,0,deny,1,1,High Risk
61164,445,0,0,66,66,0,1,0,1,0,drop,0,1,Known Attack
49302,443,8225,443,3182,1568,1614,8,120,4,4,allow,1,0,Potential Threat
45230,443,23452,443,33924,26047,7877,73,403,33,40,allow,1,0,Potential Threat
46518,44847,0,0,62,62,0,1,0,1,0,deny,0,1,Known Attack
40689,443,13371,443,4203,1564,2639,26,470,14,12,allow,1,0,Potential Threat
58120,445,0,0,70,70,0,1,0,1,0,drop,0,1,Known Attack
60477,445,0,0,70,70,0,1,0,1,0,drop,0,1,Known Attack
41475,443,20491,443,1251209,30056,1221153,1238,85,386,852,allow,1,0,Potential Threat
65123,53,59199,53,816,102,714,2,29,1,1,allow,1,0,Potential Threat
56327,53,21642,53,178,94,84,2,29,1,1,allow,0,0,Normal
49761,445,0,0,70,70,0,1,0,1,0,drop,0,1,Known Attack
45952,22114,0,0,62,62,0,1,0,1,0,deny,0,1,Known Attack
49289,53,43256,53,177,94,83,2,30,1,1,allow,0,0,Normal
44320,443,12809,443,7244,1861,5383,26,330,14,12,allow,1,0,Potential Threat
45682,25604,0,0,62,62,0,1,0,1,0,deny,0,1,Known Attack
51689,443,47234,443,8488,2174,6314,23,255,12,11,allow,1,0,Potential Threat
64979,53,4667,53,194,102,92,2,31,1,1,allow,0,0,Normal
27005,27015,37450,27015,879,126,753,2,31,1,1,allow,1,0,Potential Threat
49191,35440,0,0,66,66,0,1,0,1,0,deny,0,1,Known Attack
17010,57470,0,0,62,62,0,1,0,1,0,deny,1,1,High Risk
53890,445,0,0,70,70,0,1,0,1,0,drop,0,1,Known Attack
49453,445,0,0,70,70,0,1,0,1,0,drop,0,1,Known Attack
34657,443,31367,443,448,78,370,6,25,1,5,allow,0,0,Normal
54393,445,0,0,66,66,0,1,0,1,0,drop,0,1,Known Attack
49857,443,44578,443,18811,1868,16943,22,139,7,15,allow,1,0,Potential Threat
56775,20617,21189,20617,70,70,0,1,5,1,0,allow,1,0,Potential Threat
30960,45750,9630,45750,66,66,0,1,3600,1,0,allow,1,0,Potential Threat
58542,445,0,0,70,70,0,1,0,1,0,drop,0,1,Known Attack
4019,50584,0,0,66,66,0,1,0,1,0,deny,1,1,High Risk
34734,443,41689,443,7974,2716,5258,50,7261,26,24,allow,1,0,Potential Threat
58638,5900,0,0,62,62,0,1,0,1,0,deny,0,1,Known Attack
48125,7548,0,0,60,60,0,1,0,1,0,deny,0,1,Known Attack
60246,44612,0,0,66,66,0,1,0,1,0,deny,0,1,Known Attack
52280,443,52280,443,1615,941,674,15,20,7,8,allow,1,0,Potential Threat
60869,48817,0,0,66,66,0,1,0,1,0,deny,0,1,Known Attack
11585,56205,0,0,66,66,0,1,0,1,0,deny,1,1,High Risk
52374,445,0,0,70,70,0,1,0,1,0,drop,0,1,Known Attack
61915,445,0,0,70,70,0,1,0,1,0,drop,0,1,Known Attack
51848,80,47789,80,12009,5364,6645,23,31,12,11,allow,1,0,Potential Threat
49554,80,58941,80,1515,481,1034,11,15,6,5,allow,1,0,Potential Threat
10348,25604,0,0,66,66,0,1,0,1,0,deny,0,1,Known Attack
65282,53,39898,53,193,102,91,2,30,1,1,allow,0,0,Normal
58723,443,11514,443,24079,11282,12797,44,17,22,22,allow,1,0,Potential Threat
55594,53,44459,53,752,93,659,2,31,1,1,allow,0,0,Normal
42030,25,0,0,74,74,0,1,0,1,0,deny,0,1,Known Attack
60079,445,0,0,70,70,0,1,0,1,0,drop,0,1,Known Attack
51243,445,0,0,66,66,0,1,0,1,0,drop,0,1,Known Attack
63460,55160,0,0,62,62,0,1,0,1,0,deny,1,1,High Risk
55937,53,13424,53,177,94,83,2,30,1,1,allow,0,0,Normal
49860,53,13520,53,550,129,421,4,57,2,2,allow,0,0,Normal
56127,35440,0,0,62,62,0,1,0,1,0,deny,0,1,Known Attack
65274,53,19286,53,295,101,194,4,32,2,2,allow,0,0,Normal
51910,60443,42638,60443,66,66,0,1,5,1,0,allow,1,0,Potential Threat
49160,1025,14161,1025,868,150,718,4,1200,2,2,allow,1,0,Potential Threat
56417,445,0,0,70,70,0,1,0,1,0,drop,0,1,Known Attack
63878,50829,35363,50829,70,70,0,1,5,1,0,allow,1,0,Potential Threat
55269,53,35707,53,193,102,91,2,31,1,1,allow,0,0,Normal
60721,22114,0,0,66,66,0,1,0,1,0,deny,0,1,Known Attack
50480,443,25461,443,57535,3735,53800,70,122,26,44,allow,1,0,Potential Threat
50265,17555,24395,17555,1488,930,558,21,1200,12,9,allow,1,0,Potential Threat
56922,53,63628,53,168,86,82,2,31,1,1,allow,1,0,Potential Threat
50719,445,0,0,66,66,0,1,0,1,0,deny,0,1,Known Attack
55644,445,0,0,70,70,0,1,0,1,0,drop,0,1,Known Attack
60428,25174,0,0,66,66,0,1,0,1,0,deny,0,1,Known Attack
40845,53,40845,53,210,98,112,2,31,1,1,allow,0,0,Normal
36629,23117,0,0,62,62,0,1,0,1,0,deny,0,1,Known Attack
65285,44847,0,0,62,62,0,1,0,1,0,deny,1,1,High Risk
58931,443,42670,443,1413,876,537,12,28,6,6,allow,1,0,Potential Threat
54440,26467,0,0,66,66,0,1,0,1,0,deny,0,1,Known Attack
36729,443,18622,443,7480,1122,6358,27,257,13,14,allow,1,0,Potential Threat
57044,53,13631,53,177,94,83,2,29,1,1,allow,0,0,Normal
60840,53,50587,53,255,86,169,2,31,1,1,allow,0,0,Normal
63928,445,0,0,70,70,0,1,0,1,0,drop,0,1,Known Attack
63149,445,0,0,70,70,0,1,0,1,0,drop,0,1,Known Attack
61763,445,0,0,70,70,0,1,0,1,0,drop,0,1,Known Attack
18624,29434,0,0,148,148,0,1,0,1,0,deny,1,1,High Risk
56668,80,5597,80,234,234,0,4,12,4,0,allow,0,0,Normal
16425,15503,0,0,62,62,0,1,0,1,0,deny,0,1,Known Attack
57001,53,50963,53,210,110,100,2,30,1,1,allow,0,0,Normal
443,1785,0,0,97,97,0,1,0,1,0,deny,1,1,High Risk
51160,445,0,0,70,70,0,1,0,1,0,drop,0,1,Known Attack
42273,443,42273,443,4398,1491,2907,19,26,11,8,allow,1,0,Potential Threat
51172,443,45149,443,1472,965,507,13,20,7,6,allow,1,0,Potential Threat
52946,445,0,0,70,70,0,1,0,1,0,drop,0,1,Known Attack
56477,53,34733,53,198,101,97,2,31,1,1,allow,0,0,Normal
59879,443,12932,443,302,120,182,6,32,3,3,allow,0,0,Normal
50292,22114,0,0,66,66,0,1,0,1,0,deny,0,1,Known Attack
25448,23,25448,23,66,66,0,1,5,1,0,allow,1,0,Potential Threat
63407,445,0,0,66,66,0,1,0,1,0,drop,0,1,Known Attack
52027,443,40345,443,8698,1393,7305,22,16,12,10,allow,1,0,Potential Threat
63305,445,0,0,70,70,0,1,0,1,0,drop,0,1,Known Attack
55551,445,0,0,70,70,0,1,0,1,0,drop,0,1,Known Attack
39834,53,46672,53,199,94,105,2,30,1,1,allow,0,0,Normal
49807,53,0,0,218,77,141,2,30,1,1,allow,0,0,Normal
65212,53,6232,53,196,102,94,2,31,1,1,allow,0,0,Normal
56771,443,16357,443,7941,1952,5989,20,15,11,9,allow,1,0,Potential Threat
63968,445,0,0,66,66,0,1,0,1,0,drop,0,1,Known Attack
58910,443,57868,443,27575,18478,9097,64,22,36,28,allow,1,0,Potential Threat
57918,445,0,0,70,70,0,1,0,1,0,drop,0,1,Known Attack
65171,53,47372,53,760,97,663,2,31,1,1,allow,0,0,Normal
55599,80,22870,80,1165,473,692,10,14,5,5,allow,0,0,Normal
51798,445,0,0,70,70,0,1,0,1,0,drop,0,1,Known Attack
50360,37965,0,0,66,66,0,1,0,1,0,deny,0,1,Known Attack
1903,43890,0,0,66,66,0,1,0,1,0,deny,1,1,High Risk
64940,26467,0,0,62,62,0,1,0,1,0,deny,0,1,Known Attack
65307,445,0,0,70,70,0,1,0,1,0,drop,0,1,Known Attack
19747,37965,0,0,62,62,0,1,0,1,0,deny,1,1,High Risk
37420,44847,0,0,66,66,0,1,0,1,0,deny,0,1,Known Attack
60487,1134,57270,1134,70,70,0,1,5,1,0,allow,0,0,Normal
50584,51413,31560,51413,800,150,650,4,1200,2,2,allow,1,0,Potential Threat
56794,443,16368,443,8073,2053,6020,20,15,11,9,allow,1,0,Potential Threat
62490,445,0,0,70,70,0,1,0,1,0,drop,0,1,Known Attack
49749,53,61513,53,200,102,98,2,30,1,1,allow,0,0,Normal
16322,57470,0,0,62,62,0,1,0,1,0,deny,1,1,High Risk
60787,40010,15005,40010,316,136,180,6,6,3,3,allow,1,0,Potential Threat
60355,445,0,0,70,70,0,1,0,1,0,drop,0,1,Known Attack
57071,53,61611,53,164,84,80,2,31,1,1,allow,0,0,Normal
60916,445,0,0,70,70,0,1,0,1,0,drop,0,1,Known Attack
64283,53,39891,53,337,110,227,2,29,1,1,allow,0,0,Normal
61388,80,19899,80,14158,1392,12766,26,255,14,12,allow,1,0,Potential Threat
62905,445,0,0,70,70,0,1,0,1,0,drop,0,1,Known Attack
49210,80,26357,80,2965,715,2250,9,75,5,4,allow,1,0,Potential Threat
54842,443,49660,443,5860,1151,4709,18,283,10,8,allow,1,0,Potential Threat
45608,443,58506,443,8487,2231,6256,26,350,12,14,allow,1,0,Potential Threat
51420,443,42852,443,7653,1188,6465,21,16,12,9,allow,1,0,Potential Threat
52026,26467,0,0,60,60,0,1,0,1,0,deny,0,1,Known Attack
50205,445,0,0,70,70,0,1,0,1,0,drop,0,1,Known Attack
62382,445,0,0,70,70,0,1,0,1,0,drop,0,1,Known Attack
65505,53,12322,53,164,84,80,2,31,1,1,allow,0,0,Normal
58923,443,63838,443,5167,700,4467,16,14,7,9,allow,1,0,Potential Threat
48822,53,49162,53,168,78,90,2,30,1,1,allow,0,0,Normal
50239,445,0,0,66,66,0,1,0,1,0,drop,0,1,Known Attack
60213,445,0,0,70,70,0,1,0,1,0,drop,0,1,Known Attack
21365,23718,0,0,62,62,0,1,0,1,0,deny,0,1,Known Attack
49370,11392,0,0,66,66,0,1,0,1,0,deny,0,1,Known Attack
56003,445,0,0,66,66,0,1,0,1,0,drop,0,1,Known Attack
58308,445,0,0,66,66,0,1,0,1,0,drop,0,1,Known Attack
56649,53,31076,53,168,94,74,2,30,1,1,allow,0,0,Normal
49540,53,16812,53,279,94,185,2,30,1,1,allow,0,0,Normal
27005,27015,45773,27015,899,126,773,2,30,1,1,allow,1,0,Potential Threat
49418,27017,63792,27017,256,71,185,2,30,1,1,allow,1,0,Potential Threat
22924,25174,0,0,146,146,0,1,0,1,0,deny,1,1,High Risk
50433,443,11749,443,134,60,74,3,10,2,1,allow,0,0,Normal
49920,80,51045,80,3649288,78688,3570600,2923,179,528,2395,allow,1,0,Potential Threat
50091,53,1529,53,172,94,78,2,31,1,1,allow,0,0,Normal
49899,7000,49899,7000,758568,17631,740937,772,17,269,503,allow,1,0,Potential Threat
57835,53,49650,53,308,118,190,2,29,1,1,allow,0,0,Normal
64586,53,2228,53,173,94,79,2,30,1,1,allow,0,0,Normal
57306,53,15056,53,177,94,83,2,31,1,1,allow,0,0,Normal
57256,443,52300,443,47762,39522,8240,77,332,43,34,allow,1,0,Potential Threat
10092,443,29539,443,130,70,60,3,5,2,1,allow,1,0,Potential Threat
63044,443,58831,443,512,166,346,2,30,1,1,allow,0,0,Normal
51922,18413,51851,18413,70,70,0,1,5,1,0,allow,1,0,Potential Threat
51077,443,51077,443,32010,3207,28803,52,128,20,32,allow,1,0,Potential Threat
49966,445,0,0,70,70,0,1,0,1,0,drop,0,1,Known Attack
50094,445,0,0,66,66,0,1,0,1,0,drop,0,1,Known Attack
53234,445,0,0,70,70,0,1,0,1,0,drop,0,1,Known Attack
63945,53,51432,53,216,110,106,2,29,1,1,allow,0,0,Normal
27125,51221,0,0,62,62,0,1,0,1,0,deny,1,1,High Risk
49068,443,37354,443,98965,16634,82331,187,30,82,105,allow,1,0,Potential Threat
62549,64147,0,0,62,62,0,1,0,1,0,deny,1,1,High Risk
58600,443,58600,443,4398,1491,2907,19,28,11,8,allow,1,0,Potential Threat
55343,53,44963,53,366,94,272,2,30,1,1,allow,0,0,Normal
51244,3855,0,0,100,100,0,1,0,1,0,deny,0,1,Known Attack
50721,445,0,0,66,66,0,1,0,1,0,drop,0,1,Known Attack
53972,59089,19075,59089,70,70,0,1,4,1,0,allow,1,0,Potential Threat
53983,40500,9041,40500,70,70,0,1,4,1,0,allow,1,0,Potential Threat
55382,53,35558,53,199,102,97,2,30,1,1,allow,0,0,Normal
59891,445,0,0,70,70,0,1,0,1,0,drop,0,1,Known Attack
59663,37965,0,0,62,62,0,1,0,1,0,deny,0,1,Known Attack
21892,15503,0,0,62,62,0,1,0,1,0,deny,0,1,Known Attack
58638,5900,0,0,62,62,0,1,0,1,0,deny,0,1,Known Attack
44847,20101,53137,20101,150,150,0,1,1200,1,0,allow,1,0,Potential Threat
65312,53,47796,53,180,92,88,2,30,1,1,allow,0,0,Normal
39771,443,64614,443,6903,1273,5630,25,255,13,12,allow,1,0,Potential Threat
39094,443,9909,443,350650,19028,331622,494,83,251,243,allow,1,0,Potential Threat
64905,53,16169,53,245,94,151,2,30,1,1,allow,0,0,Normal
28236,53,28236,53,235,90,145,2,32,1,1,allow,0,0,Normal
50288,445,0,0,66,66,0,1,0,1,0,drop,0,1,Known Attack
2815,62413,0,0,66,66,0,1,0,1,0,deny,1,1,High Risk
50820,445,0,0,70,70,0,1,0,1,0,drop,0,1,Known Attack
62042,445,0,0,66,66,0,1,0,1,0,drop,0,1,Known Attack
16059,22114,0,0,62,62,0,1,0,1,0,deny,0,1,Known Attack
65472,53,63288,53,202,103,99,2,31,1,1,allow,1,0,Potential Threat
64299,445,0,0,70,70,0,1,0,1,0,drop,0,1,Known Attack
42298,40017,13967,40017,148,86,62,2,30,1,1,allow,1,0,Potential Threat
50116,22,0,0,60,60,0,1,0,1,0,deny,0,1,Known Attack
42025,443,50486,443,70,70,0,1,5,1,0,allow,0,0,Normal
43260,41615,0,0,145,145,0,1,0,1,0,deny,1,1,High Risk
58917,445,0,0,70,70,0,1,0,1,0,drop,0,1,Known Attack
57009,53,27487,53,1435,98,1337,4,34,2,2,allow,0,0,Normal
42228,51050,0,0,66,66,0,1,0,1,0,deny,0,1,Known Attack
49463,445,0,0,70,70,0,1,0,1,0,drop,0,1,Known Attack
51244,29517,0,0,100,100,0,1,0,1,0,deny,0,1,Known Attack
56810,53,54787,53,170,87,83,2,31,1,1,allow,0,0,Normal
53031,445,0,0,66,66,0,1,0,1,0,drop,0,1,Known Attack
64036,53,20328,53,183,94,89,2,30,1,1,allow,0,0,Normal
56390,445,0,0,70,70,0,1,0,1,0,drop,0,1,Known Attack
65126,445,0,0,70,70,0,1,0,1,0,drop,0,1,Known Attack
55655,53,4325,53,524,214,310,6,57,3,3,allow,0,0,Normal
65143,53,45277,53,184,94,90,2,30,1,1,allow,0,0,Normal
46082,443,8016,443,137024,6442,130582,171,109,61,110,allow,1,0,Potential Threat
38523,53,38523,53,214,82,132,2,32,1,1,allow,0,0,Normal
63902,445,0,0,70,70,0,1,0,1,0,drop,0,1,Known Attack
55129,53,28774,53,754,94,660,2,31,1,1,allow,0,0,Normal
45020,443,16879,443,2293,1592,701,16,21,8,8,allow,1,0,Potential Threat
51443,443,36286,443,70,70,0,1,5,1,0,allow,0,0,Normal
54958,53,54115,53,1413,85,1328,4,47,2,2,allow,0,0,Normal
64592,53,58811,53,209,110,99,2,30,1,1,allow,0,0,Normal
6881,6881,44839,6881,238,118,120,2,1200,1,1,allow,1,0,Potential Threat
50534,80,11143,80,318,192,126,6,25,4,2,allow,0,0,Normal
65363,53,1138,53,181,94,87,2,31,1,1,allow,0,0,Normal
53114,445,0,0,66,66,0,1,0,1,0,drop,0,1,Known Attack
36839,80,35799,80,10345,6823,3522,25,25,14,11,allow,1,0,Potential Threat
60438,445,0,0,66,66,0,1,0,1,0,drop,0,1,Known Attack
50017,80,11643,80,827,687,140,6,32,4,2,allow,0,0,Normal
58704,80,26628,80,4115,3452,663,13,15,7,6,allow,1,0,Potential Threat
27005,27015,62315,27015,1006,252,754,4,32,3,1,allow,1,0,Potential Threat
51426,80,51426,80,114697,3049,111648,114,26,35,79,allow,1,0,Potential Threat
52148,29104,12286,29104,70,70,0,2,8,2,0,allow,1,0,Potential Threat
53652,57503,44187,57503,492,306,186,8,15,5,3,allow,1,0,Potential Threat
62194,50584,0,0,66,66,0,1,0,1,0,deny,1,1,High Risk
4323,64147,0,0,62,62,0,1,0,1,0,deny,1,1,High Risk
64320,53,61236,53,199,102,97,2,30,1,1,allow,1,0,Potential Threat
9307,443,6375,443,4458,1022,3436,16,26,9,7,allow,1,0,Potential Threat
51946,9407,60623,9407,70,70,0,1,4,1,0,allow,1,0,Potential Threat
49907,53,31143,53,363,98,265,4,54,2,2,allow,0,0,Normal
50888,80,61019,80,538995,15959,523036,552,140,201,351,allow,1,0,Potential Threat
53301,445,0,0,66,66,0,1,0,1,0,drop,0,1,Known Attack
59278,443,45402,443,10495,9044,1451,29,35,18,11,allow,1,0,Potential Threat
49198,443,22902,443,533813,25885,507928,678,50,308,370,allow,1,0,Potential Threat
54830,445,0,0,66,66,0,1,0,1,0,drop,0,1,Known Attack
60325,80,16267,80,3697,2062,1635,16,61,9,7,allow,1,0,Potential Threat
49948,80,2205,80,19740,993,18747,28,15,12,16,allow,1,0,Potential Threat
59476,445,0,0,70,70,0,1,0,1,0,drop,0,1,Known Attack
56824,55829,39772,55829,70,70,0,1,5,1,0,allow,1,0,Potential Threat
50574,80,28738,80,318,192,126,6,25,4,2,allow,0,0,Normal
1025,35447,0,0,62,62,0,1,0,1,0,deny,1,1,High Risk
55220,53,55080,53,758,96,662,2,30,1,1,allow,0,0,Normal
63640,57866,0,0,66,66,0,1,0,1,0,deny,1,1,High Risk
56733,53,13870,53,170,87,83,2,30,1,1,allow,0,0,Normal
50420,443,27192,443,648,210,438,10,27,4,6,allow,0,0,Normal
44242,5228,42163,5228,10823,1636,9187,32,591,11,21,allow,1,0,Potential Threat
55068,53,58274,53,192,98,94,2,31,1,1,allow,0,0,Normal
55336,53,26759,53,199,102,97,2,31,1,1,allow,0,0,Normal
50920,60182,0,0,62,62,0,1,0,1,0,deny,1,1,High Risk
50552,80,50552,80,2887,1776,1111,14,22,8,6,allow,1,0,Potential Threat
19875,30170,0,0,145,145,0,1,0,1,0,deny,1,1,High Risk
52024,25174,0,0,66,66,0,1,0,1,0,deny,0,1,Known Attack
56771,53,26482,53,166,86,80,2,30,1,1,allow,0,0,Normal
37965,63402,11159,63402,2118,858,1260,28,1283,14,14,allow,1,0,Potential Threat
47694,443,24366,443,23751,3197,20554,42,170,19,23,allow,1,0,Potential Threat
8802,80,39611,80,4999,1313,3686,36,667,8,28,allow,1,0,Potential Threat
36456,25174,0,0,146,146,0,1,0,1,0,deny,1,1,High Risk
49335,445,0,0,70,70,0,1,0,1,0,drop,0,1,Known Attack
58327,445,0,0,70,70,0,1,0,1,0,drop,0,1,Known Attack
53931,445,0,0,70,70,0,1,0,1,0,drop,0,1,Known Attack
51054,445,0,0,70,70,0,1,0,1,0,drop,0,1,Known Attack
61398,445,0,0,70,70,0,1,0,1,0,drop,0,1,Known Attack
34257,7275,41230,7275,2845,419,2426,12,15,7,5,allow,1,0,Potential Threat
61334,445,0,0,70,70,0,1,0,1,0,drop,0,1,Known Attack
58638,5900,0,0,62,62,0,1,0,1,0,deny,0,1,Known Attack
35163,30188,0,0,62,62,0,1,0,1,0,deny,0,1,Known Attack
18725,35440,0,0,62,62,0,1,0,1,0,deny,1,1,High Risk
37534,443,60202,443,6927,1883,5044,25,46,14,11,allow,1,0,Potential Threat
49809,445,0,0,70,70,0,1,0,1,0,drop,0,1,Known Attack
60041,443,53446,443,1015,572,443,11,142,6,5,allow,1,0,Potential Threat
65260,53,8952,53,199,102,97,2,30,1,1,allow,0,0,Normal
64091,53,62313,53,178,94,84,2,30,1,1,allow,1,0,Potential Threat
56887,445,0,0,66,66,0,1,0,1,0,drop,0,1,Known Attack
7905,22114,0,0,62,62,0,1,0,1,0,deny,1,1,High Risk
54888,443,50282,443,1775,169,1606,7,122,3,4,allow,1,0,Potential Threat
50800,445,0,0,66,66,0,1,0,1,0,drop,0,1,Known Attack
58154,445,0,0,66,66,0,1,0,1,0,drop,0,1,Known Attack
56775,9200,31796,9200,8223,3066,5157,30,33,15,15,allow,1,0,Potential Threat
6828,64322,0,0,60,60,0,1,0,1,0,deny,1,1,High Risk
61973,53,11068,53,222,94,128,2,30,1,1,allow,0,0,Normal
57820,32753,0,0,361,361,0,1,0,1,0,deny,1,1,High Risk
57108,53,37838,53,193,102,91,2,30,1,1,allow,0,0,Normal
49780,445,0,0,70,70,0,1,0,1,0,drop,0,1,Known Attack
55752,443,54224,443,11823,4029,7794,25,143,12,13,allow,1,0,Potential Threat
1024,57470,0,0,72,72,0,1,0,1,0,deny,1,1,High Risk
37846,443,26954,443,30620,20855,9765,91,112,45,46,allow,1,0,Potential Threat
57137,53,36481,53,279,96,183,4,31,2,2,allow,0,0,Normal
60746,445,0,0,66,66,0,1,0,1,0,drop,0,1,Known Attack
58784,445,0,0,66,66,0,1,0,1,0,drop,0,1,Known Attack
41603,443,56421,443,16028,3246,12782,37,272,19,18,allow,1,0,Potential Threat
43531,53,58732,53,199,94,105,2,30,1,1,allow,0,0,Normal
65189,27015,25924,27015,233,71,162,2,30,1,1,allow,1,0,Potential Threat
58638,5900,0,0,62,62,0,1,0,1,0,deny,0,1,Known Attack
50542,80,60343,80,1607,970,637,8,16,5,3,allow,1,0,Potential Threat
39287,57470,0,0,62,62,0,1,0,1,0,deny,1,1,High Risk
65453,53,27266,53,251,94,157,2,31,1,1,allow,0,0,Normal
51783,445,0,0,66,66,0,1,0,1,0,drop,0,1,Known Attack
61802,445,0,0,70,70,0,1,0,1,0,drop,0,1,Known Attack
62709,57470,0,0,62,62,0,1,0,1,0,deny,1,1,High Risk
57014,80,25497,80,214,140,74,4,30,3,1,allow,0,0,Normal
53915,1026,52746,1026,70,70,0,2,8,2,0,allow,0,0,Normal
65530,53,20918,53,167,86,81,2,29,1,1,allow,0,0,Normal
49291,53,30701,53,759,102,657,2,30,1,1,allow,0,0,Normal
26265,37965,0,0,66,66,0,1,0,1,0,deny,0,1,Known Attack
55254,443,18308,443,8431,2584,5847,25,46,14,11,allow,1,0,Potential Threat
56332,53,27865,53,209,110,99,2,30,1,1,allow,0,0,Normal
49204,443,40475,443,1786,172,1614,7,120,3,4,allow,1,0,Potential Threat
58756,443,10542,443,5168,700,4468,16,15,7,9,allow,1,0,Potential Threat
443,10010,0,0,60,60,0,1,0,1,0,deny,1,1,High Risk
65411,53,35148,53,771,101,670,2,30,1,1,allow,0,0,Normal
58638,5900,0,0,62,62,0,1,0,1,0,deny,0,1,Known Attack
56599,443,36954,443,348780,9144,339636,358,32,123,235,allow,1,0,Potential Threat
27309,6881,0,0,146,146,0,1,0,1,0,deny,0,1,Known Attack
60875,443,9147,443,45373,35377,9996,88,72,48,40,allow,1,0,Potential Threat
61107,445,0,0,70,70,0,1,0,1,0,drop,0,1,Known Attack
1026,30188,0,0,62,62,0,1,0,1,0,deny,1,1,High Risk
50249,443,46250,443,6125,1674,4451,22,81,11,11,allow,1,0,Potential Threat
27005,33051,7331,33051,887,126,761,2,31,1,1,allow,1,0,Potential Threat
34980,443,26995,443,8211,2165,6046,25,361,13,12,allow,1,0,Potential Threat
49737,53,34228,53,184,86,98,2,31,1,1,allow,0,0,Normal
55951,53,4112,53,197,102,95,2,30,1,1,allow,0,0,Normal
39057,53,39057,53,222,90,132,2,30,1,1,allow,0,0,Normal
39426,443,8694,443,903603,21528,882075,858,57,234,624,allow,1,0,Potential Threat
49754,35440,0,0,146,146,0,1,0,1,0,deny,1,1,High Risk
62726,445,0,0,66,66,0,1,0,1,0,drop,0,1,Known Attack
57000,53,37935,53,193,94,99,2,30,1,1,allow,0,0,Normal
52881,445,0,0,70,70,0,1,0,1,0,drop,0,1,Known Attack
59792,80,59792,80,33435,1694,31741,43,20,18,25,allow,1,0,Potential Threat
53355,23117,0,0,66,66,0,1,0,1,0,deny,0,1,Known Attack
56106,53,18399,53,193,102,91,2,30,1,1,allow,0,0,Normal
49953,53,46343,53,214,110,104,2,30,1,1,allow,0,0,Normal
47636,443,43225,443,5921,1018,4903,21,150,11,10,allow,1,0,Potential Threat
52456,445,0,0,66,66,0,1,0,1,0,drop,0,1,Known Attack
48360,443,45618,443,8400,2088,6312,33,20,18,15,allow,1,0,Potential Threat
36983,80,48738,80,1143,401,742,9,360,5,4,allow,1,0,Potential Threat
56054,53,43314,53,740,93,647,2,31,1,1,allow,0,0,Normal
3478,61463,0,0,164,164,0,1,0,1,0,deny,1,1,High Risk
24144,57470,0,0,62,62,0,1,0,1,0,deny,1,1,High Risk
10381,22114,0,0,62,62,0,1,0,1,0,deny,0,1,Known Attack
59957,445,0,0,70,70,0,1,0,1,0,drop,0,1,Known Attack
56708,443,9469,443,6155,919,5236,18,55,10,8,allow,1,0,Potential Threat
56562,443,49879,443,8821,3228,5593,25,60,15,10,allow,1,0,Potential Threat
23519,25174,0,0,146,146,0,1,0,1,0,deny,1,1,High Risk
16979,56205,0,0,62,62,0,1,0,1,0,deny,1,1,High Risk
17750,6881,35389,6881,150,150,0,1,1200,1,0,allow,1,0,Potential Threat
48533,443,47218,443,160,69,91,2,121,1,1,allow,0,0,Normal
61594,445,0,0,66,66,0,1,0,1,0,drop,0,1,Known Attack
61244,445,0,0,70,70,0,1,0,1,0,drop,0,1,Known Attack
57676,445,0,0,66,66,0,1,0,1,0,drop,0,1,Known Attack
64935,53,15324,53,193,102,91,2,31,1,1,allow,0,0,Normal
65460,53,23650,53,184,94,90,2,30,1,1,allow,0,0,Normal
53553,53,53553,53,229,98,131,2,30,1,1,allow,0,0,Normal
55515,445,0,0,70,70,0,1,0,1,0,drop,0,1,Known Attack
53218,443,1969,443,245772,8639,237133,291,66,103,188,allow,1,0,Potential Threat
3608,25773,0,0,146,146,0,1,0,1,0,reset-both,1,1,High Risk
57364,53,57364,53,213,79,134,2,32,1,1,allow,0,0,Normal
65159,37965,0,0,74,74,0,1,0,1,0,deny,0,1,Known Attack
51939,80,10449,80,103732,4081,99651,128,61,55,73,allow,1,0,Potential Threat
65495,53,62386,53,209,110,99,2,31,1,1,allow,1,0,Potential Threat
60414,52559,6876,52559,70,70,0,1,5,1,0,allow,1,0,Potential Threat
30114,65151,0,0,60,60,0,1,0,1,0,deny,1,1,High Risk
55893,53,56779,53,711,87,624,2,30,1,1,allow,0,0,Normal
53375,443,59892,443,4317,1134,3183,16,26,9,7,allow,1,0,Potential Threat
42053,443,49116,443,2351,1546,805,20,40,11,9,allow,1,0,Potential Threat
50568,80,17182,80,318,192,126,6,26,4,2,allow,0,0,Normal
57912,53,13801,53,295,77,218,2,30,1,1,allow,0,0,Normal
61223,37965,0,0,62,62,0,1,0,1,0,deny,0,1,Known Attack
40216,50265,0,0,62,62,0,1,0,1,0,deny,0,1,Known Attack
56618,443,31063,443,3096,1882,1214,19,16,10,9,allow,1,0,Potential Threat
50772,445,0,0,70,70,0,1,0,1,0,drop,0,1,Known Attack
49632,7000,49632,7000,1236,676,560,13,15,7,6,allow,1,0,Potential Threat
61422,80,46677,80,214,140,74,4,41,3,1,allow,0,0,Normal
56261,53,47864,53,184,94,90,2,31,1,1,allow,0,0,Normal
52850,443,36065,443,5743,1339,4404,18,180,8,10,allow,1,0,Potential Threat
56893,53,50861,53,177,94,83,2,30,1,1,allow,0,0,Normal
51903,26467,0,0,62,62,0,1,0,1,0,deny,0,1,Known Attack
63527,445,0,0,66,66,0,1,0,1,0,drop,0,1,Known Attack
51997,14398,23393,14398,130,70,60,2,4,1,1,allow,1,0,Potential Threat
52777,445,0,0,66,66,0,1,0,1,0,drop,0,1,Known Attack
52143,445,0,0,66,66,0,1,0,1,0,drop,0,1,Known Attack
50022,53,26770,53,179,94,85,2,31,1,1,allow,0,0,Normal
60356,445,0,0,66,66,0,1,0,1,0,drop,0,1,Known Attack
63817,50808,64390,50808,70,70,0,1,4,1,0,allow,1,0,Potential Threat
60068,443,63784,443,10192,5090,5102,43,15,24,19,allow,1,0,Potential Threat
58869,443,38937,443,4657,2146,2511,14,135,7,7,allow,1,0,Potential Threat
46707,443,23817,443,9723,1780,7943,35,120,17,18,allow,1,0,Potential Threat
56679,51505,0,0,146,146,0,1,0,1,0,deny,1,1,High Risk
51609,37807,0,0,66,66,0,1,0,1,0,deny,0,1,Known Attack
50210,443,12154,443,6444,1320,5124,31,727,10,21,allow,1,0,Potential Threat
61183,25174,0,0,62,62,0,1,0,1,0,deny,0,1,Known Attack
49662,443,39223,443,2690,1342,1348,23,19,12,11,allow,1,0,Potential Threat
62481,80,55007,80,890,440,450,10,33,6,4,allow,1,0,Potential Threat
56713,25174,0,0,146,146,0,1,0,1,0,deny,1,1,High Risk
52076,28895,42169,28895,70,70,0,2,8,2,0,allow,1,0,Potential Threat
56515,53,8193,53,177,94,83,2,29,1,1,allow,0,0,Normal
54221,443,30528,443,499,425,74,4,0,3,1,allow,0,0,Normal
51501,445,0,0,70,70,0,1,0,1,0,drop,0,1,Known Attack
50581,80,61624,80,2573,1859,714,9,47,5,4,allow,1,0,Potential Threat
54787,445,0,0,70,70,0,1,0,1,0,drop,0,1,Known Attack
50736,445,0,0,66,66,0,1,0,1,0,drop,0,1,Known Attack
52640,64147,0,0,62,62,0,1,0,1,0,deny,1,1,High Risk
49321,53,46028,53,184,94,90,2,30,1,1,allow,0,0,Normal
35055,80,30586,80,3650999,83941,3567058,3541,21,1184,2357,allow,1,0,Potential Threat
54569,445,0,0,70,70,0,1,0,1,0,drop,0,1,Known Attack
57235,443,36461,443,8954,3404,5550,34,46,19,15,allow,1,0,Potential Threat
57987,56125,0,0,90,90,0,1,0,1,0,deny,1,1,High Risk
22300,51505,0,0,66,66,0,1,0,1,0,deny,1,1,High Risk
51851,445,0,0,70,70,0,1,0,1,0,drop,0,1,Known Attack
50440,53,52778,53,458,188,270,6,29,3,3,allow,0,0,Normal
64382,53,40543,53,278,102,176,2,30,1,1,allow,0,0,Normal
58803,443,12977,443,5166,700,4466,16,15,7,9,allow,1,0,Potential Threat
55816,53,28988,53,212,108,104,2,30,1,1,allow,0,0,Normal
50265,21544,58613,21544,390,266,124,6,1200,4,2,allow,1,0,Potential Threat
55646,53,12583,53,780,93,687,2,30,1,1,allow,0,0,Normal
46663,53,46663,53,209,83,126,2,30,1,1,allow,0,0,Normal
19570,50584,0,0,66,66,0,1,0,1,0,deny,1,1,High Risk
39098,51505,0,0,62,62,0,1,0,1,0,deny,0,1,Known Attack
60558,445,0,0,70,70,0,1,0,1,0,drop,0,1,Known Attack
50708,22114,0,0,62,62,0,1,0,1,0,deny,0,1,Known Attack
56275,53,54180,53,177,94,83,2,30,1,1,allow,0,0,Normal
52123,46261,33776,46261,70,70,0,1,4,1,0,allow,1,0,Potential Threat
53043,445,0,0,66,66,0,1,0,1,0,drop,0,1,Known Attack
6881,34190,52438,34190,509,150,359,2,1200,1,1,allow,1,0,Potential Threat
64976,53,35202,53,229,102,127,2,30,1,1,allow,0,0,Normal
55732,53,1656,53,194,102,92,2,30,1,1,allow,0,0,Normal
37336,443,19104,443,995086,50081,945005,1281,216,515,766,allow,1,0,Potential Threat
49788,445,0,0,70,70,0,1,0,1,0,drop,0,1,Known Attack
53920,443,44819,443,499,425,74,4,0,3,1,allow,0,0,Normal
60247,443,21929,443,12256,5443,6813,33,437,18,15,allow,1,0,Potential Threat
56428,80,32588,80,17247,1619,15628,26,25,11,15,allow,1,0,Potential Threat
61732,443,11286,443,8655,2300,6355,24,21,12,12,allow,1,0,Potential Threat
57987,56125,0,0,90,90,0,1,0,1,0,deny,1,1,High Risk
51720,445,0,0,66,66,0,1,0,1,0,drop,0,1,Known Attack
61738,445,0,0,70,70,0,1,0,1,0,drop,0,1,Known Attack
57092,445,0,0,70,70,0,1,0,1,0,drop,0,1,Known Attack
65249,53,21680,53,182,102,80,2,30,1,1,allow,0,0,Normal
51535,44847,0,0,62,62,0,1,0,1,0,deny,0,1,Known Attack
57259,53,43312,53,199,102,97,2,31,1,1,allow,0,0,Normal
56966,35440,0,0,62,62,0,1,0,1,0,deny,0,1,Known Attack
42298,40031,17629,40031,148,86,62,2,30,1,1,allow,1,0,Potential Threat
26900,27017,57216,27017,422,164,258,6,30,3,3,allow,1,0,Potential Threat
53521,8999,10502,8999,312,186,126,5,15,3,2,allow,1,0,Potential Threat
17213,22114,0,0,62,62,0,1,0,1,0,deny,0,1,Known Attack
59965,36237,0,0,66,66,0,1,0,1,0,deny,0,1,Known Attack
51443,445,0,0,66,66,0,1,0,1,0,drop,0,1,Known Attack
56702,53,49433,53,168,78,90,2,30,1,1,allow,0,0,Normal
60537,445,0,0,70,70,0,1,0,1,0,drop,0,1,Known Attack
18655,44847,0,0,66,66,0,1,0,1,0,deny,1,1,High Risk
62743,445,0,0,66,66,0,1,0,1,0,drop,0,1,Known Attack
58701,27030,9286,27030,70,70,0,1,5,1,0,allow,1,0,Potential Threat
49778,53,15143,53,255,102,153,2,29,1,1,allow,0,0,Normal
53037,80,8932,80,2906,1233,1673,24,92,13,11,allow,1,0,Potential Threat
65064,53,44516,53,338,110,228,2,30,1,1,allow,0,0,Normal
6712,5632,0,0,60,60,0,1,0,1,0,deny,0,1,Known Attack
56826,22114,0,0,66,66,0,1,0,1,0,deny,0,1,Known Attack
51733,30688,48958,30688,70,70,0,2,8,2,0,allow,1,0,Potential Threat
52036,80,8626,80,366,240,126,7,24,5,2,allow,0,0,Normal
33215,37965,0,0,62,62,0,1,0,1,0,deny,0,1,Known Attack
49242,445,0,0,70,70,0,1,0,1,0,drop,0,1,Known Attack
53928,15503,0,0,62,62,0,1,0,1,0,deny,0,1,Known Attack
56409,53,61903,53,199,102,97,2,31,1,1,allow,0,0,Normal
0,0,0,0,98,98,0,1,0,1,0,deny,1,1,High Risk
50521,80,1574,80,454,262,192,8,25,5,3,allow,1,0,Potential Threat
63191,445,0,0,70,70,0,1,0,1,0,drop,0,1,Known Attack
36080,26467,0,0,62,62,0,1,0,1,0,deny,0,1,Known Attack
16387,20045,0,0,60,60,0,1,0,1,0,deny,0,1,Known Attack
55443,443,53890,443,12806,2828,9978,55,2983,24,31,allow,1,0,Potential Threat
3764,9694,0,0,66,66,0,1,0,1,0,deny,1,1,High Risk
55356,53,43051,53,756,95,661,2,31,1,1,allow,0,0,Normal
52501,445,0,0,66,66,0,1,0,1,0,drop,0,1,Known Attack
52600,445,0,0,66,66,0,1,0,1,0,drop,0,1,Known Attack
51830,42707,0,0,66,66,0,1,0,1,0,deny,0,1,Known Attack
5223,32965,0,0,66,66,0,1,0,1,0,deny,1,1,High Risk
50178,53,59652,53,178,94,84,2,29,1,1,allow,0,0,Normal
49507,445,0,0,66,66,0,1,0,1,0,drop,0,1,Known Attack
26324,30188,0,0,62,62,0,1,0,1,0,deny,0,1,Known Attack
59964,443,4370,443,48525,4928,43597,111,660,55,56,allow,1,0,Potential Threat
56252,53,39340,53,228,110,118,2,30,1,1,allow,0,0,Normal
42595,443,31051,443,1093,606,487,11,15,7,4,allow,0,0,Normal
50398,445,0,0,70,70,0,1,0,1,0,drop,0,1,Known Attack
64087,50265,0,0,145,145,0,1,0,1,0,deny,1,1,High Risk
49370,443,17640,443,350,210,140,6,16,4,2,allow,0,0,Normal
49404,53,39531,53,253,102,151,2,30,1,1,allow,0,0,Normal
49738,443,52506,443,3085,1404,1681,15,15,7,8,allow,1,0,Potential Threat
56167,445,0,0,70,70,0,1,0,1,0,drop,0,1,Known Attack
60239,53,53135,53,219,102,117,2,30,1,1,allow,0,0,Normal
33525,443,32155,443,8088,2191,5897,28,508,13,15,allow,1,0,Potential Threat
56082,53,50090,53,271,88,183,4,38,2,2,allow,0,0,Normal
53903,51339,21513,51339,70,70,0,2,7,2,0,allow,1,0,Potential Threat
37008,42707,0,0,62,62,0,1,0,1,0,deny,0,1,Known Attack
64255,53,15083,53,260,86,174,2,30,1,1,allow,0,0,Normal
50584,8999,10076,8999,161,161,0,1,1200,1,0,allow,1,0,Potential Threat
65344,46824,0,0,62,62,0,1,0,1,0,deny,1,1,High Risk
15503,42286,2173,42286,480,149,331,2,1200,1,1,allow,1,0,Potential Threat
50572,80,21152,80,132,132,0,2,8,2,0,allow,0,0,Normal
55610,23383,13424,23383,70,70,0,1,5,1,0,allow,1,0,Potential Threat
49538,53,45151,53,748,94,654,2,30,1,1,allow,0,0,Normal
55713,47783,26233,47783,70,70,0,1,5,1,0,allow,1,0,Potential Threat
57013,53,60365,53,172,88,84,2,30,1,1,allow,0,0,Normal
29016,25174,0,0,62,62,0,1,0,1,0,deny,0,1,Known Attack
53232,445,0,0,70,70,0,1,0,1,0,drop,0,1,Known Attack
12694,22114,0,0,66,66,0,1,0,1,0,deny,0,1,Known Attack
26386,53,26386,53,231,90,141,2,30,1,1,allow,0,0,Normal
56327,53,4067,53,178,94,84,2,30,1,1,allow,0,0,Normal
54086,445,0,0,66,66,0,1,0,1,0,drop,0,1,Known Attack
63984,445,0,0,70,70,0,1,0,1,0,drop,0,1,Known Attack
63621,30188,0,0,62,62,0,1,0,1,0,deny,0,1,Known Attack
50265,60276,27315,60276,481,150,331,2,1200,1,1,allow,1,0,Potential Threat
57685,445,0,0,70,70,0,1,0,1,0,drop,0,1,Known Attack
44847,6882,30467,6882,502,150,352,2,1200,1,1,allow,1,0,Potential Threat
42587,443,6188,443,7733,1203,6530,21,15,12,9,allow,1,0,Potential Threat
55897,53,23504,53,770,102,668,2,30,1,1,allow,0,0,Normal
59994,53,59994,53,462,158,304,4,31,2,2,allow,0,0,Normal
59119,53,4964,53,168,78,90,2,30,1,1,allow,0,0,Normal
61066,53,0,0,283,78,205,2,29,1,1,allow,0,0,Normal
55025,53,22515,53,183,94,89,2,30,1,1,allow,0,0,Normal
63628,445,0,0,66,66,0,1,0,1,0,drop,0,1,Known Attack
57595,445,0,0,70,70,0,1,0,1,0,drop,0,1,Known Attack
53607,51631,7980,51631,70,70,0,2,8,2,0,allow,1,0,Potential Threat
55421,53,44471,53,200,102,98,2,30,1,1,allow,0,0,Normal
58638,5900,0,0,62,62,0,1,0,1,0,deny,0,1,Known Attack
57043,53,5828,53,735,88,647,2,31,1,1,allow,0,0,Normal
64255,53,2166,53,332,102,230,2,30,1,1,allow,0,0,Normal
56919,445,0,0,70,70,0,1,0,1,0,drop,0,1,Known Attack
60842,445,0,0,66,66,0,1,0,1,0,drop,0,1,Known Attack
60962,53,0,0,180,80,100,2,31,1,1,allow,0,0,Normal
58177,445,0,0,70,70,0,1,0,1,0,drop,0,1,Known Attack
60610,443,53274,443,187258,9720,177538,225,211,86,139,allow,1,0,Potential Threat
51880,445,0,0,70,70,0,1,0,1,0,drop,0,1,Known Attack
56131,445,0,0,70,70,0,1,0,1,0,drop,0,1,Known Attack
65049,53,51039,53,184,94,90,2,30,1,1,allow,0,0,Normal
49835,53,23738,53,168,86,82,2,30,1,1,allow,0,0,Normal
51244,50432,0,0,100,100,0,1,0,1,0,deny,1,1,High Risk
49892,443,65121,443,1820,1101,719,18,73,10,8,allow,1,0,Potential Threat
64681,35993,0,0,66,66,0,1,0,1,0,deny,0,1,Known Attack
60601,53,19741,53,451,86,365,2,30,1,1,allow,0,0,Normal
50931,80,59351,80,7978844,97517,7881327,6752,120,1393,5359,allow,1,0,Potential Threat
60387,32087,24462,32087,320,140,180,6,7,3,3,allow,1,0,Potential Threat
36400,51505,0,0,62,62,0,1,0,1,0,deny,0,1,Known Attack
56993,80,53078,80,214,140,74,4,35,3,1,allow,0,0,Normal
54438,443,22711,443,8198,1975,6223,24,361,11,13,allow,1,0,Potential Threat
58022,8800,0,0,60,60,0,1,0,1,0,deny,0,1,Known Attack
54263,445,0,0,70,70,0,1,0,1,0,drop,0,1,Known Attack
64534,53,37006,53,214,110,104,2,30,1,1,allow,0,0,Normal
55375,53,47639,53,214,110,104,2,30,1,1,allow,0,0,Normal
59599,445,0,0,66,66,0,1,0,1,0,drop,0,1,Known Attack
33941,37807,0,0,146,146,0,1,0,1,0,deny,1,1,High Risk
3765,64147,0,0,62,62,0,1,0,1,0,deny,1,1,High Risk
42154,80,50458,80,73277,3302,69975,102,16,52,50,allow,1,0,Potential Threat
15819,3389,0,0,60,60,0,1,0,1,0,deny,0,1,Known Attack
64104,22114,0,0,62,62,0,1,0,1,0,deny,0,1,Known Attack
52891,443,27899,443,320255,9207,311048,343,117,107,236,allow,1,0,Potential Threat
55633,53,59677,53,195,102,93,2,30,1,1,allow,0,0,Normal
54955,445,0,0,70,70,0,1,0,1,0,drop,0,1,Known Attack
49159,23,0,0,60,60,0,1,0,1,0,deny,0,1,Known Attack
61570,445,0,0,70,70,0,1,0,1,0,drop,0,1,Known Attack
33418,443,42698,443,4764,1876,2888,22,81,10,12,allow,1,0,Potential Threat
55791,445,0,0,70,70,0,1,0,1,0,drop,0,1,Known Attack
55034,445,0,0,66,66,0,1,0,1,0,drop,0,1,Known Attack
52025,42442,45647,42442,70,70,0,1,4,1,0,allow,1,0,Potential Threat
62141,445,0,0,66,66,0,1,0,1,0,drop,0,1,Known Attack
41815,50265,0,0,146,146,0,1,0,1,0,deny,1,1,High Risk
45908,33330,0,0,60,60,0,1,0,1,0,deny,0,1,Known Attack
63772,35440,0,0,62,62,0,1,0,1,0,deny,0,1,Known Attack
62452,21247,0,0,62,62,0,1,0,1,0,deny,0,1,Known Attack
56582,23718,0,0,66,66,0,1,0,1,0,deny,0,1,Known Attack
65388,445,0,0,70,70,0,1,0,1,0,drop,0,1,Known Attack
55684,53,8013,53,214,110,104,2,30,1,1,allow,0,0,Normal
57013,80,33223,80,526,304,222,8,30,5,3,allow,0,0,Normal
57440,443,35509,443,8200,2465,5735,30,18,14,16,allow,1,0,Potential Threat
65207,445,0,0,66,66,0,1,0,1,0,drop,0,1,Known Attack
64122,53,64122,53,220,90,130,2,30,1,1,allow,1,0,Potential Threat
53674,31724,4834,31724,70,70,0,2,7,2,0,allow,1,0,Potential Threat
60903,443,60903,443,13557,3307,10250,43,47,25,18,allow,1,0,Potential Threat
56289,25174,0,0,66,66,0,1,0,1,0,deny,0,1,Known Attack
61693,443,50704,443,12203,3519,8684,65,18,35,30,allow,1,0,Potential Threat
4910,2149,0,0,66,66,0,1,0,1,0,deny,0,1,Known Attack
39148,443,64587,443,6818,1800,5018,30,271,16,14,allow,1,0,Potential Threat
58638,5900,0,0,62,62,0,1,0,1,0,deny,0,1,Known Attack
49216,53,31679,53,789,110,679,2,29,1,1,allow,0,0,Normal
63935,445,0,0,66,66,0,1,0,1,0,drop,0,1,Known Attack
56163,53,47516,53,265,85,180,4,41,2,2,allow,0,0,Normal
64825,53,38972,53,184,94,90,2,30,1,1,allow,0,0,Normal
62327,443,62327,443,1210,637,573,14,51,7,7,allow,1,0,Potential Threat
54109,36829,0,0,66,66,0,1,0,1,0,deny,0,1,Known Attack
49630,53,20567,53,374,126,248,2,30,1,1,allow,0,0,Normal
63513,445,0,0,66,66,0,1,0,1,0,drop,0,1,Known Attack
49767,53,46615,53,200,102,98,2,31,1,1,allow,0,0,Normal
55031,445,0,0,70,70,0,1,0,1,0,drop,0,1,Known Attack
49483,7000,49483,7000,755531,16955,738576,785,16,265,520,allow,1,0,Potential Threat
41700,443,15367,443,167721,6935,160786,185,77,68,117,allow,1,0,Potential Threat
51635,80,49291,80,318,192,126,6,39,4,2,allow,0,0,Normal
56684,443,53117,443,7907,1918,5989,20,15,11,9,allow,1,0,Potential Threat
49555,53,24625,53,193,102,91,2,30,1,1,allow,0,0,Normal
50558,80,10581,80,318,192,126,6,26,4,2,allow,0,0,Normal
53372,445,0,0,66,66,0,1,0,1,0,drop,0,1,Known Attack
62347,25,62347,25,291,126,165,4,0,2,2,deny,1,1,High Risk
42718,443,45721,443,7341,2111,5230,18,135,8,10,allow,1,0,Potential Threat
49743,80,24003,80,2981,473,2508,9,16,5,4,allow,1,0,Potential Threat
55525,443,64786,443,5200,2825,2375,18,155,9,9,allow,1,0,Potential Threat
38941,443,59649,443,13623,2693,10930,22,123,10,12,allow,1,0,Potential Threat
57260,51221,0,0,66,66,0,1,0,1,0,deny,0,1,Known Attack
55201,26467,0,0,62,62,0,1,0,1,0,deny,0,1,Known Attack
17008,35440,0,0,146,146,0,1,0,1,0,deny,1,1,High Risk
62337,44847,0,0,66,66,0,1,0,1,0,deny,0,1,Known Attack
34112,44847,0,0,66,66,0,1,0,1,0,deny,0,1,Known Attack
10166,44847,0,0,62,62,0,1,0,1,0,deny,1,1,High Risk
55580,53,22194,53,788,108,680,2,30,1,1,allow,0,0,Normal
26900,27017,24961,27017,168,82,86,2,30,1,1,allow,1,0,Potential Threat
63539,445,0,0,70,70,0,1,0,1,0,drop,0,1,Known Attack
61151,443,65420,443,121129,5559,115570,157,640,51,106,allow,1,0,Potential Threat
64535,37965,0,0,66,66,0,1,0,1,0,deny,0,1,Known Attack
64193,445,0,0,70,70,0,1,0,1,0,drop,0,1,Known Attack
50219,445,0,0,70,70,0,1,0,1,0,drop,0,1,Known Attack
50693,443,50693,443,19125,2345,16780,37,128,15,22,allow,1,0,Potential Threat
38320,51505,0,0,66,66,0,1,0,1,0,deny,0,1,Known Attack
64937,53,10087,53,182,93,89,2,31,1,1,allow,0,0,Normal
53090,59356,0,0,66,66,0,1,0,1,0,deny,1,1,High Risk
55145,11392,0,0,66,66,0,1,0,1,0,deny,0,1,Known Attack
54074,443,19199,443,72465,3991,68474,98,169,43,55,allow,1,0,Potential Threat
60857,445,0,0,70,70,0,1,0,1,0,drop,0,1,Known Attack
40500,53,40500,53,203,82,121,2,30,1,1,allow,0,0,Normal
56893,53,37100,53,170,87,83,2,31,1,1,allow,0,0,Normal
22587,30188,0,0,66,66,0,1,0,1,0,deny,0,1,Known Attack
27988,40027,35628,40027,140,78,62,2,30,1,1,allow,1,0,Potential Threat
60473,22170,57823,22170,1599,743,856,13,36,7,6,allow,1,0,Potential Threat
55244,53,5418,53,186,102,84,2,29,1,1,allow,0,0,Normal
49905,443,37995,443,798502,33164,765338,927,103,379,548,allow,1,0,Potential Threat
46423,443,25968,443,1340,760,580,14,39,8,6,allow,1,0,Potential Threat
52184,22114,0,0,66,66,0,1,0,1,0,deny,0,1,Known Attack
50717,80,28545,80,1649,963,686,7,15,5,2,allow,0,0,Normal
53629,445,0,0,66,66,0,1,0,1,0,drop,0,1,Known Attack
59763,443,10249,443,24828,8387,16441,80,111,44,36,allow,1,0,Potential Threat
53734,445,0,0,66,66,0,1,0,1,0,drop,0,1,Known Attack
58638,5900,0,0,62,62,0,1,0,1,0,deny,0,1,Known Attack
64527,53,58780,53,228,102,126,2,30,1,1,allow,0,0,Normal
49628,35440,0,0,66,66,0,1,0,1,0,deny,0,1,Known Attack
57459,51505,0,0,62,62,0,1,0,1,0,deny,0,1,Known Attack
56739,53,56739,53,825,99,726,2,30,1,1,allow,0,0,Normal
49914,53,39261,53,815,95,720,2,30,1,1,allow,0,0,Normal
14997,57470,0,0,72,72,0,1,0,1,0,deny,1,1,High Risk
55454,53,60200,53,202,103,99,2,31,1,1,allow,0,0,Normal
36287,443,35494,443,6419,2962,3457,25,148,12,13,allow,1,0,Potential Threat
46849,36237,0,0,62,62,0,1,0,1,0,deny,0,1,Known Attack
63913,445,0,0,70,70,0,1,0,1,0,drop,0,1,Known Attack
26783,443,21530,443,22489,15918,6571,39,26,21,18,allow,1,0,Potential Threat
56560,53,17987,53,199,102,97,2,30,1,1,allow,0,0,Normal
56581,443,17747,443,4884,1015,3869,17,25,9,8,allow,1,0,Potential Threat
58331,443,26953,443,31515,26798,4717,91,82,49,42,allow,1,0,Potential Threat
22678,443,22678,443,18172,3573,14599,39,26,20,19,allow,1,0,Potential Threat
49667,445,0,0,70,70,0,1,0,1,0,drop,0,1,Known Attack
57223,443,27688,443,24283,14945,9338,46,318,26,20,allow,1,0,Potential Threat
39617,50584,0,0,62,62,0,1,0,1,0,deny,0,1,Known Attack
38427,443,30130,443,12591,2902,9689,40,55,19,21,allow,1,0,Potential Threat
56625,443,59240,443,7888,1899,5989,20,15,11,9,allow,1,0,Potential Threat
41882,443,10450,443,7218,4166,3052,38,133,19,19,allow,1,0,Potential Threat
58858,443,41294,443,318,192,126,6,26,4,2,allow,0,0,Normal
51862,27758,32851,27758,70,70,0,2,7,2,0,allow,1,0,Potential Threat
60939,53,60939,53,237,91,146,2,32,1,1,allow,0,0,Normal
65319,80,8384,80,2284,484,1800,10,133,6,4,allow,1,0,Potential Threat
39869,53,19258,53,394,80,314,4,29,2,2,allow,0,0,Normal
55240,445,0,0,70,70,0,1,0,1,0,drop,0,1,Known Attack
39423,443,60458,443,121145,3578,117567,128,77,39,89,allow,1,0,Potential Threat
56622,53,10987,53,214,110,104,2,30,1,1,allow,0,0,Normal
46349,51505,0,0,70,70,0,1,0,1,0,deny,0,1,Known Attack
16994,57866,0,0,146,146,0,1,0,1,0,deny,1,1,High Risk
50928,443,1946,443,3347,2025,1322,31,34,18,13,allow,1,0,Potential Threat
54874,445,0,0,70,70,0,1,0,1,0,drop,0,1,Known Attack
45860,443,61779,443,12852,3554,9298,35,24,19,16,allow,1,0,Potential Threat
54695,80,64600,80,2001,1107,894,13,150,7,6,allow,1,0,Potential Threat
61988,443,61988,443,4338,1431,2907,19,30,11,8,allow,1,0,Potential Threat
59785,14914,0,0,143,143,0,1,0,1,0,deny,0,1,Known Attack
45908,33330,45908,33330,124,60,64,3,5,2,1,allow,1,0,Potential Threat
56544,53,54094,53,224,102,122,2,30,1,1,allow,0,0,Normal
54011,44847,0,0,66,66,0,1,0,1,0,deny,0,1,Known Attack
64306,53,29347,53,216,110,106,2,31,1,1,allow,0,0,Normal
49303,443,12405,443,10844,5117,5727,42,17,25,17,allow,1,0,Potential Threat
63985,445,0,0,70,70,0,1,0,1,0,drop,0,1,Known Attack
61670,57470,0,0,74,74,0,1,0,1,0,deny,1,1,High Risk
47795,443,48531,443,8708,3949,4759,22,21,11,11,allow,1,0,Potential Threat
50990,23884,0,0,66,66,0,1,0,1,0,deny,0,1,Known Attack
49646,445,0,0,70,70,0,1,0,1,0,drop,0,1,Known Attack
49373,443,19953,443,1857,1218,639,18,104,11,7,allow,1,0,Potential Threat
54204,443,58891,443,499,425,74,4,0,3,1,allow,0,0,Normal
50888,445,0,0,70,70,0,1,0,1,0,drop,0,1,Known Attack
46617,53,46617,53,213,87,126,2,30,1,1,allow,0,0,Normal
55483,445,0,0,70,70,0,1,0,1,0,drop,0,1,Known Attack
45641,443,12763,443,99276,88410,10866,143,333,78,65,allow,1,0,Potential Threat
47595,33439,0,0,106,106,0,1,60,1,0,allow,1,0,Potential Threat
58681,123,50487,123,184,94,90,2,30,1,1,allow,0,0,Normal
60136,56205,0,0,62,62,0,1,0,1,0,deny,1,1,High Risk
27328,21247,0,0,66,66,0,1,0,1,0,deny,0,1,Known Attack
48706,23393,0,0,60,60,0,1,0,1,0,deny,0,1,Known Attack
50485,445,0,0,66,66,0,1,0,1,0,drop,0,1,Known Attack
52164,445,0,0,70,70,0,1,0,1,0,drop,0,1,Known Attack
64339,18375,0,0,62,62,0,1,0,1,0,deny,0,1,Known Attack
58638,5900,0,0,62,62,0,1,0,1,0,deny,0,1,Known Attack
55980,123,7764,123,184,94,90,2,30,1,1,allow,0,0,Normal
27005,27015,49738,27015,893,126,767,2,30,1,1,allow,1,0,Potential Threat
54006,445,0,0,66,66,0,1,0,1,0,drop,0,1,Known Attack
56658,443,31194,443,8007,1987,6020,20,15,11,9,allow,1,0,Potential Threat
54223,445,0,0,66,66,0,1,0,1,0,drop,0,1,Known Attack
49327,53,15373,53,396,102,294,2,30,1,1,allow,0,0,Normal
54021,25174,0,0,146,146,0,1,0,1,0,deny,1,1,High Risk
53814,445,0,0,66,66,0,1,0,1,0,drop,0,1,Known Attack
64688,445,0,0,70,70,0,1,0,1,0,drop,0,1,Known Attack
53431,445,0,0,70,70,0,1,0,1,0,drop,0,1,Known Attack
49982,445,0,0,66,66,0,1,0,1,0,drop,0,1,Known Attack
51608,443,59688,443,4646,2347,2299,17,34,9,8,allow,1,0,Potential Threat
53597,53,0,0,233,85,148,2,30,1,1,allow,0,0,Normal
52337,445,0,0,70,70,0,1,0,1,0,drop,0,1,Known Attack
45937,53,13210,53,241,78,163,2,30,1,1,allow,0,0,Normal
58677,28678,3047,28678,1806,1806,0,22,225,22,0,allow,1,0,Potential Threat
21542,57470,0,0,74,74,0,1,0,1,0,deny,1,1,High Risk
58791,443,11218,443,5167,700,4467,16,15,7,9,allow,1,0,Potential Threat
21998,51221,0,0,62,62,0,1,0,1,0,deny,1,1,High Risk
56186,53,36968,53,198,102,96,2,30,1,1,allow,0,0,Normal
51406,443,38367,443,8186,2146,6040,29,33,16,13,allow,1,0,Potential Threat
52118,445,0,0,70,70,0,1,0,1,0,drop,0,1,Known Attack
59837,80,33837,80,830733,17622,813111,789,66,245,544,allow,1,0,Potential Threat
55752,53,6985,53,200,102,98,2,30,1,1,allow,0,0,Normal
0,0,0,0,98,98,0,1,0,1,0,deny,1,1,High Risk
53448,445,0,0,70,70,0,1,0,1,0,drop,0,1,Known Attack
56782,49135,47020,49135,70,70,0,2,8,2,0,allow,1,0,Potential Threat
51658,80,20246,80,44842,2446,42396,73,255,34,39,allow,1,0,Potential Threat
60485,445,0,0,66,66,0,1,0,1,0,drop,0,1,Known Attack
42566,443,31210,443,10127,4193,5934,30,24,17,13,allow,1,0,Potential Threat
55034,443,55034,443,154907,10748,144159,217,20,101,116,allow,1,0,Potential Threat
53168,23074,22420,23074,958,454,504,14,21,8,6,allow,1,0,Potential Threat
59411,37965,0,0,66,66,0,1,0,1,0,deny,0,1,Known Attack
53212,443,49183,443,4681,2403,2278,19,135,10,9,allow,1,0,Potential Threat
62125,445,0,0,66,66,0,1,0,1,0,drop,0,1,Known Attack
62297,445,0,0,66,66,0,1,0,1,0,drop,0,1,Known Attack
50185,443,5992,443,6350,1071,5279,18,42,10,8,allow,1,0,Potential Threat
50181,64147,0,0,66,66,0,1,0,1,0,deny,1,1,High Risk
41314,80,2894,80,1723,438,1285,10,136,6,4,allow,1,0,Potential Threat
51445,445,0,0,66,66,0,1,0,1,0,drop,0,1,Known Attack
64124,25174,0,0,146,146,0,1,0,1,0,deny,1,1,High Risk
4650,53,4650,53,300,90,210,2,29,1,1,allow,1,0,Potential Threat
53853,39723,8770,39723,1890,1010,880,13,16,8,5,allow,1,0,Potential Threat
53337,445,0,0,70,70,0,1,0,1,0,drop,0,1,Known Attack
27464,53,27464,53,233,90,143,2,32,1,1,allow,0,0,Normal
49554,53,50726,53,210,110,100,2,30,1,1,allow,0,0,Normal
26900,27017,1081,27017,422,164,258,6,29,3,3,allow,1,0,Potential Threat
58338,3369,0,0,60,60,0,1,0,1,0,deny,0,1,Known Attack
52010,445,0,0,70,70,0,1,0,1,0,drop,0,1,Known Attack
65268,445,0,0,66,66,0,1,0,1,0,drop,0,1,Known Attack
53015,445,0,0,70,70,0,1,0,1,0,drop,0,1,Known Attack
57487,443,7890,443,17065,11570,5495,76,218,39,37,allow,1,0,Potential Threat
42745,50011,0,0,62,62,0,1,0,1,0,deny,0,1,Known Attack
52802,443,30052,443,4202,1924,2278,27,80,13,14,allow,1,0,Potential Threat
52430,35440,0,0,62,62,0,1,0,1,0,deny,0,1,Known Attack
50584,49533,38774,49533,161,161,0,1,1200,1,0,allow,1,0,Potential Threat
50226,443,45230,443,7726,4613,3113,21,137,11,10,allow,1,0,Potential Threat
443,41545,0,0,60,60,0,1,0,1,0,deny,1,1,High Risk
54677,5228,25400,5228,6679,2730,3949,43,4309,23,20,allow,1,0,Potential Threat
52781,57470,0,0,66,66,0,1,0,1,0,deny,0,1,Known Attack
50487,80,25708,80,378,192,186,7,21,4,3,allow,0,0,Normal
1238,51505,0,0,146,146,0,1,0,1,0,deny,1,1,High Risk
64289,445,0,0,66,66,0,1,0,1,0,drop,0,1,Known Attack
65083,53,18755,53,198,94,104,2,30,1,1,allow,0,0,Normal
49557,443,57017,443,38022,18448,19574,53,57,27,26,allow,1,0,Potential Threat
15978,50584,0,0,146,146,0,1,0,1,0,deny,1,1,High Risk
64511,53,2785,53,305,102,203,2,30,1,1,allow,0,0,Normal
63569,62413,0,0,66,66,0,1,0,1,0,deny,1,1,High Risk
2437,23117,0,0,146,146,0,1,0,1,0,deny,1,1,High Risk
64613,445,0,0,70,70,0,1,0,1,0,drop,0,1,Known Attack
50509,443,29330,443,9535,1246,8289,29,77,15,14,allow,1,0,Potential Threat
64093,445,0,0,70,70,0,1,0,1,0,drop,0,1,Known Attack
28033,443,38606,443,6305,2124,4181,20,16,10,10,allow,1,0,Potential Threat
50903,80,4352,80,8600,1437,7163,18,144,10,8,allow,1,0,Potential Threat
22835,51221,0,0,62,62,0,1,0,1,0,deny,1,1,High Risk
61463,445,0,0,66,66,0,1,0,1,0,drop,0,1,Known Attack
62108,443,7391,443,9652,2914,6738,22,124,11,11,allow,1,0,Potential Threat
56369,53,3077,53,193,102,91,2,31,1,1,allow,0,0,Normal
33242,443,38172,443,14244,2907,11337,33,17,17,16,allow,1,0,Potential Threat
56217,53,54817,53,182,93,89,2,31,1,1,allow,0,0,Normal
64706,53,11232,53,179,94,85,2,29,1,1,allow,0,0,Normal
17824,53,17824,53,244,98,146,2,32,1,1,allow,0,0,Normal
64602,80,64602,80,18594,5204,13390,42,26,25,17,allow,1,0,Potential Threat
34979,80,8756,80,1150,465,685,14,268,5,9,allow,1,0,Potential Threat
56980,53,42285,53,267,87,180,4,38,2,2,allow,0,0,Normal
51065,445,0,0,70,70,0,1,0,1,0,drop,0,1,Known Attack
61013,445,0,0,70,70,0,1,0,1,0,drop,0,1,Known Attack
52170,45144,16828,45144,70,70,0,2,8,2,0,allow,1,0,Potential Threat
51021,445,0,0,70,70,0,1,0,1,0,drop,0,1,Known Attack
59799,443,59799,443,4666,1759,2907,19,28,11,8,allow,1,0,Potential Threat
60401,30046,28995,30046,70,70,0,2,8,2,0,allow,1,0,Potential Threat
59814,443,30492,443,1560,977,583,15,30,8,7,allow,1,0,Potential Threat
60439,47783,39683,47783,70,70,0,1,5,1,0,allow,1,0,Potential Threat
42895,443,18411,443,600,156,444,8,25,2,6,allow,0,0,Normal
64633,53,20577,53,255,102,153,2,30,1,1,allow,0,0,Normal
59240,53,59240,53,194,87,107,2,30,1,1,allow,0,0,Normal
54238,443,21116,443,499,425,74,4,0,3,1,allow,0,0,Normal
64282,445,0,0,70,70,0,1,0,1,0,drop,0,1,Known Attack
58804,443,5956,443,5167,700,4467,16,15,7,9,allow,1,0,Potential Threat
56933,80,47498,80,486,280,206,8,26,5,3,allow,0,0,Normal
49513,443,49513,443,140969,40311,100658,180,68,92,88,allow,1,0,Potential Threat
64655,443,35493,443,8903,2857,6046,22,135,10,12,allow,1,0,Potential Threat
64756,53,21500,53,195,102,93,2,30,1,1,allow,0,0,Normal
49418,27016,34441,27016,263,78,185,2,29,1,1,allow,1,0,Potential Threat
60412,12965,9031,12965,70,70,0,1,5,1,0,allow,1,0,Potential Threat
44320,443,45352,443,1657,1128,529,15,35,9,6,allow,1,0,Potential Threat
58705,5228,47511,5228,4706,2850,1856,44,6872,25,19,allow,1,0,Potential Threat
64036,23718,0,0,62,62,0,1,0,1,0,deny,0,1,Known Attack
58935,443,64941,443,5167,700,4467,16,15,7,9,allow,1,0,Potential Threat
64379,53,61307,53,333,94,239,2,30,1,1,allow,1,0,Potential Threat
58961,80,54182,80,1674,1360,314,11,15,6,5,allow,1,0,Potential Threat
50362,53,58174,53,214,110,104,2,29,1,1,allow,0,0,Normal
52410,443,38111,443,128802,48896,79906,237,24,121,116,allow,1,0,Potential Threat
54973,53,61675,53,711,87,624,2,30,1,1,allow,1,0,Potential Threat
55365,53,5213,53,214,110,104,2,29,1,1,allow,0,0,Normal
14397,37965,0,0,62,62,0,1,0,1,0,deny,1,1,High Risk
57140,53,49557,53,177,94,83,2,30,1,1,allow,0,0,Normal
53416,445,0,0,70,70,0,1,0,1,0,drop,0,1,Known Attack
52224,445,0,0,70,70,0,1,0,1,0,drop,0,1,Known Attack
64659,53,14647,53,464,99,365,4,39,2,2,allow,0,0,Normal
57314,443,14727,443,134,60,74,3,6,2,1,allow,0,0,Normal
51941,19333,28791,19333,70,70,0,2,8,2,0,allow,1,0,Potential Threat
62175,445,0,0,70,70,0,1,0,1,0,drop,0,1,Known Attack
64997,53,57263,53,166,86,80,2,31,1,1,allow,0,0,Normal
30181,61689,0,0,62,62,0,1,0,1,0,deny,1,1,High Risk
56997,53,32024,53,273,102,171,2,30,1,1,allow,0,0,Normal
60038,80,60038,80,12881,767,12114,21,21,9,12,allow,1,0,Potential Threat
56623,53,18777,53,771,101,670,2,30,1,1,allow,0,0,Normal
51411,443,11555,443,202,70,132,3,11,1,2,allow,0,0,Normal
65187,53,19736,53,392,86,306,2,30,1,1,allow,0,0,Normal
60039,53,37317,53,312,82,230,2,31,1,1,allow,0,0,Normal
46495,4607,0,0,60,60,0,1,0,1,0,deny,0,1,Known Attack
27005,27017,58319,27017,883,126,757,2,30,1,1,allow,1,0,Potential Threat
61772,445,0,0,66,66,0,1,0,1,0,drop,0,1,Known Attack
60783,40010,46411,40010,316,136,180,6,6,3,3,allow,1,0,Potential Threat
58638,5900,0,0,62,62,0,1,0,1,0,deny,0,1,Known Attack
56486,80,1722,80,46682,3447,43235,61,135,27,34,allow,1,0,Potential Threat
32299,40015,23096,40015,188,70,118,2,31,1,1,allow,1,0,Potential Threat
57193,53,40448,53,229,110,119,2,30,1,1,allow,0,0,Normal
52025,443,47252,443,8034,2692,5342,15,16,8,7,allow,1,0,Potential Threat
47625,53,55385,53,168,78,90,2,30,1,1,allow,0,0,Normal
25067,22114,0,0,146,146,0,1,0,1,0,deny,1,1,High Risk
64245,53,47905,53,199,102,97,2,30,1,1,allow,0,0,Normal
53125,443,24442,443,3358,1952,1406,16,360,8,8,allow,1,0,Potential Threat
17415,25174,0,0,62,62,0,1,0,1,0,deny,0,1,Known Attack
51695,37590,12016,37590,70,70,0,1,5,1,0,allow,1,0,Potential Threat
55083,53,24986,53,325,110,215,4,44,2,2,allow,0,0,Normal
63137,47117,19060,47117,574,448,126,10,25,8,2,allow,1,0,Potential Threat
52986,443,58135,443,280,140,140,5,130,3,2,allow,1,0,Potential Threat
62768,443,53717,443,30902,6307,24595,86,269,36,50,allow,1,0,Potential Threat
50130,53,58704,53,183,94,89,2,29,1,1,allow,0,0,Normal
58243,445,0,0,70,70,0,1,0,1,0,drop,0,1,Known Attack
56819,53,1488,53,209,110,99,2,30,1,1,allow,0,0,Normal
52647,445,0,0,66,66,0,1,0,1,0,drop,0,1,Known Attack
3597,11392,0,0,62,62,0,1,0,1,0,deny,1,1,High Risk
62038,80,20471,80,668,224,444,10,18,4,6,allow,1,0,Potential Threat
64577,443,50601,443,24686,1935,22751,36,16,17,19,allow,1,0,Potential Threat
62068,80,36797,80,2806,626,2180,12,15,6,6,allow,1,0,Potential Threat
55065,443,23726,443,13236,4421,8815,28,61,16,12,allow,1,0,Potential Threat
64893,53,31080,53,232,102,130,2,30,1,1,allow,0,0,Normal
8191,51221,0,0,62,62,0,1,0,1,0,deny,1,1,High Risk
51607,53,31669,53,284,86,198,2,30,1,1,allow,0,0,Normal
60759,40010,60253,40010,316,136,180,6,7,3,3,allow,1,0,Potential Threat
52157,23002,50044,23002,70,70,0,1,5,1,0,allow,1,0,Potential Threat
52751,443,8615,443,5378,984,4394,18,17,10,8,allow,1,0,Potential Threat
50007,445,0,0,66,66,0,1,0,1,0,drop,0,1,Known Attack
59051,445,0,0,70,70,0,1,0,1,0,drop,0,1,Known Attack
35052,443,8505,443,4652,3109,1543,25,95,14,11,allow,1,0,Potential Threat
51103,443,36898,443,20280,13177,7103,82,1176,46,36,allow,1,0,Potential Threat
52817,445,0,0,70,70,0,1,0,1,0,drop,0,1,Known Attack
58645,445,0,0,70,70,0,1,0,1,0,drop,0,1,Known Attack
27005,27015,25452,27015,887,126,761,2,30,1,1,allow,1,0,Potential Threat
56574,445,0,0,70,70,0,1,0,1,0,drop,0,1,Known Attack
52846,80,43511,80,3626,1778,1848,36,143,19,17,allow,1,0,Potential Threat
3777,64097,0,0,146,146,0,1,0,1,0,deny,1,1,High Risk
10151,60419,62503,60419,479,150,329,2,1200,1,1,allow,1,0,Potential Threat
18683,26467,0,0,62,62,0,1,0,1,0,deny,0,1,Known Attack
64403,53,35591,53,186,95,91,2,31,1,1,allow,0,0,Normal
52134,445,0,0,70,70,0,1,0,1,0,drop,0,1,Known Attack
53912,3478,60537,3478,3532,1792,1740,58,88,29,29,allow,1,0,Potential Threat
61605,445,0,0,70,70,0,1,0,1,0,drop,0,1,Known Attack
7104,23,0,0,60,60,0,1,0,1,0,deny,0,1,Known Attack
56237,80,56237,80,44949,1017,43932,48,15,15,33,allow,1,0,Potential Threat
57312,53,43620,53,208,106,102,2,30,1,1,allow,0,0,Normal
42558,64147,0,0,62,62,0,1,0,1,0,deny,1,1,High Risk
64985,53,36411,53,192,98,94,2,30,1,1,allow,0,0,Normal
44903,80,37166,80,918,461,457,9,16,6,3,allow,0,0,Normal
62440,445,0,0,66,66,0,1,0,1,0,drop,0,1,Known Attack
52669,443,6202,443,18814,2623,16191,54,25,26,28,allow,1,0,Potential Threat
10097,53,3471,53,259,86,173,2,30,1,1,allow,1,0,Potential Threat
61845,11392,0,0,62,62,0,1,0,1,0,deny,0,1,Known Attack
53773,15459,13024,15459,70,70,0,2,7,2,0,allow,1,0,Potential Threat
59407,443,31789,443,3298,2132,1166,16,15,8,8,allow,1,0,Potential Threat
26792,37965,0,0,62,62,0,1,0,1,0,deny,0,1,Known Attack
29746,53,29746,53,235,90,145,2,32,1,1,allow,0,0,Normal
60794,20010,30261,20010,70,70,0,2,8,2,0,allow,1,0,Potential Threat
61527,51050,0,0,66,66,0,1,0,1,0,deny,1,1,High Risk
53365,80,32049,80,405,285,120,5,15,3,2,allow,0,0,Normal
49641,445,0,0,70,70,0,1,0,1,0,drop,0,1,Known Attack
50192,445,0,0,70,70,0,1,0,1,0,drop,0,1,Known Attack
50072,53,48106,53,172,94,78,2,30,1,1,allow,0,0,Normal
57395,53,64683,53,262,88,174,4,58,2,2,allow,1,0,Potential Threat
55411,53,35188,53,200,94,106,2,30,1,1,allow,0,0,Normal
35752,80,35752,80,871846,24071,847775,900,30,326,574,allow,1,0,Potential Threat
65528,53,44314,53,168,86,82,2,30,1,1,allow,0,0,Normal
55441,53,20729,53,216,110,106,2,30,1,1,allow,0,0,Normal
56333,53,59595,53,209,110,99,2,31,1,1,allow,0,0,Normal
32704,25174,0,0,62,62,0,1,0,1,0,deny,0,1,Known Attack
61180,445,0,0,66,66,0,1,0,1,0,drop,0,1,Known Attack
9304,443,28860,443,3922,552,3370,16,16,8,8,allow,1,0,Potential Threat
56565,53,24401,53,164,86,78,2,30,1,1,allow,0,0,Normal
54325,445,0,0,66,66,0,1,0,1,0,drop,0,1,Known Attack
63996,45759,55251,45759,66,66,0,2,8,2,0,allow,1,0,Potential Threat
39861,80,23505,80,1056,682,374,10,15,6,4,allow,1,0,Potential Threat
65405,445,0,0,70,70,0,1,0,1,0,drop,0,1,Known Attack
37701,23,0,0,60,60,0,1,0,1,0,deny,0,1,Known Attack
49558,53,42255,53,350,93,257,4,42,2,2,allow,0,0,Normal
50394,445,0,0,70,70,0,1,0,1,0,drop,0,1,Known Attack
34452,80,18909,80,6260,696,5564,17,16,9,8,allow,1,0,Potential Threat
49267,445,0,0,66,66,0,1,0,1,0,drop,0,1,Known Attack
58234,445,0,0,70,70,0,1,0,1,0,drop,0,1,Known Attack
59002,53,19057,53,238,94,144,2,30,1,1,allow,0,0,Normal
62887,445,0,0,70,70,0,1,0,1,0,drop,0,1,Known Attack
13911,57470,0,0,60,60,0,1,0,1,0,deny,1,1,High Risk
56066,53,46856,53,208,106,102,2,30,1,1,allow,0,0,Normal
57470,6885,1463,6885,616,414,202,5,1200,3,2,allow,1,0,Potential Threat
49563,443,54610,443,6462,2102,4360,18,180,8,10,allow,1,0,Potential Threat
52170,80,60754,80,362,240,122,7,17,5,2,allow,0,0,Normal
63732,40642,31051,40642,66,66,0,2,7,2,0,allow,1,0,Potential Threat
55488,53,31385,53,210,94,116,2,29,1,1,allow,0,0,Normal
50559,445,0,0,70,70,0,1,0,1,0,drop,0,1,Known Attack
54288,445,0,0,70,70,0,1,0,1,0,drop,0,1,Known Attack
45690,60038,0,0,62,62,0,1,0,1,0,reset-both,1,1,High Risk
65209,57866,0,0,66,66,0,1,0,1,0,deny,1,1,High Risk
62546,443,43210,443,7740,2603,5137,13,120,7,6,allow,1,0,Potential Threat
35400,443,23133,443,11083,4080,7003,38,40,14,24,allow,1,0,Potential Threat
36656,64147,0,0,62,62,0,1,0,1,0,deny,1,1,High Risk
42030,25,0,0,74,74,0,1,0,1,0,deny,0,1,Known Attack
27824,51505,0,0,62,62,0,1,0,1,0,deny,1,1,High Risk
38502,443,34798,443,2378,1126,1252,14,978,7,7,allow,1,0,Potential Threat
21502,44847,0,0,66,66,0,1,0,1,0,deny,1,1,High Risk
51920,30188,0,0,66,66,0,1,0,1,0,deny,0,1,Known Attack
51891,23238,29444,23238,70,70,0,1,5,1,0,allow,1,0,Potential Threat
56603,53,24241,53,179,94,85,2,30,1,1,allow,0,0,Normal
50506,10214,0,0,66,66,0,1,0,1,0,deny,0,1,Known Attack
9605,57470,0,0,62,62,0,1,0,1,0,deny,1,1,High Risk
52714,445,0,0,70,70,0,1,0,1,0,drop,0,1,Known Attack
44509,80,44509,80,84030,4287,79743,107,145,47,60,allow,1,0,Potential Threat
53548,445,0,0,66,66,0,1,0,1,0,drop,0,1,Known Attack
53458,443,20818,443,7584,7094,490,14,123,7,7,allow,1,0,Potential Threat
49503,443,38675,443,1363701,35511,1328190,1382,271,476,906,allow,1,0,Potential Threat
50837,445,0,0,70,70,0,1,0,1,0,drop,0,1,Known Attack
65205,445,0,0,70,70,0,1,0,1,0,drop,0,1,Known Attack
61323,23117,0,0,62,62,0,1,0,1,0,deny,0,1,Known Attack
40501,443,64068,443,6517,1812,4705,21,255,11,10,allow,1,0,Potential Threat
51816,27721,33144,27721,70,70,0,2,8,2,0,allow,1,0,Potential Threat
6666,62078,0,0,60,60,0,1,0,1,0,deny,1,1,High Risk
64209,53,40539,53,291,94,197,2,29,1,1,allow,0,0,Normal
17786,44847,0,0,62,62,0,1,0,1,0,deny,1,1,High Risk
50609,445,0,0,70,70,0,1,0,1,0,drop,0,1,Known Attack
64045,445,0,0,70,70,0,1,0,1,0,drop,0,1,Known Attack
52732,443,31396,443,27467,22472,4995,85,42,45,40,allow,1,0,Potential Threat
65110,445,0,0,70,70,0,1,0,1,0,drop,0,1,Known Attack
65528,445,0,0,70,70,0,1,0,1,0,drop,0,1,Known Attack
62006,445,0,0,66,66,0,1,0,1,0,drop,0,1,Known Attack
53209,443,56508,443,11086,2564,8522,42,186,21,21,allow,1,0,Potential Threat
49172,445,0,0,66,66,0,1,0,1,0,drop,0,1,Known Attack
51918,27015,0,0,67,67,0,1,0,1,0,deny,0,1,Known Attack
43390,53,0,0,184,86,98,2,30,1,1,allow,0,0,Normal
58481,15503,0,0,146,146,0,1,0,1,0,deny,0,1,Known Attack
55577,53,12118,53,199,102,97,2,30,1,1,allow,0,0,Normal
50069,53,5416,53,174,89,85,2,30,1,1,allow,0,0,Normal
50234,53,63121,53,720,94,626,2,30,1,1,allow,1,0,Potential Threat
63646,445,0,0,66,66,0,1,0,1,0,drop,0,1,Known Attack
65020,53,8823,53,184,94,90,2,31,1,1,allow,0,0,Normal
55646,14420,49852,14420,70,70,0,2,8,2,0,allow,1,0,Potential Threat
443,32698,0,0,89,89,0,1,0,1,0,deny,1,1,High Risk
53710,443,55386,443,499,425,74,4,0,3,1,allow,0,0,Normal
26900,443,4352,443,24703,16382,8321,49,21,28,21,allow,1,0,Potential Threat
49722,443,18328,443,9698,3026,6672,54,618,27,27,allow,1,0,Potential Threat
65446,53,45033,53,204,104,100,2,30,1,1,allow,0,0,Normal
58509,21247,0,0,66,66,0,1,0,1,0,deny,0,1,Known Attack
49996,53,8571,53,183,94,89,2,30,1,1,allow,0,0,Normal
39959,23117,0,0,62,62,0,1,0,1,0,deny,0,1,Known Attack
37653,5223,43344,5223,142,142,0,1,5,1,0,allow,1,0,Potential Threat
56112,53,63106,53,199,102,97,2,30,1,1,allow,1,0,Potential Threat
56109,53,22951,53,177,94,83,2,30,1,1,allow,0,0,Normal
50116,22,50116,22,152,66,86,2,9,1,1,allow,0,0,Normal
65372,445,0,0,70,70,0,1,0,1,0,drop,0,1,Known Attack
62236,445,0,0,66,66,0,1,0,1,0,drop,0,1,Known Attack
9267,80,6787,80,318,192,126,6,27,4,2,allow,1,0,Potential Threat
52080,80,40918,80,27100,21684,5416,39,38,25,14,allow,1,0,Potential Threat
57142,445,0,0,66,66,0,1,0,1,0,drop,0,1,Known Attack
54276,37628,0,0,66,66,0,1,0,1,0,deny,0,1,Known Attack
3077,50584,0,0,146,146,0,1,0,1,0,deny,1,1,High Risk
49683,53,44598,53,262,94,168,2,29,1,1,allow,0,0,Normal
56268,44847,0,0,66,66,0,1,0,1,0,deny,0,1,Known Attack
52603,445,0,0,66,66,0,1,0,1,0,drop,0,1,Known Attack
55828,445,0,0,70,70,0,1,0,1,0,drop,0,1,Known Attack
59700,445,0,0,70,70,0,1,0,1,0,drop,0,1,Known Attack
18652,64147,0,0,62,62,0,1,0,1,0,deny,1,1,High Risk
43584,24748,0,0,156,156,0,1,0,1,0,deny,1,1,High Risk
53666,50321,61664,50321,736,490,246,8,17,4,4,allow,1,0,Potential Threat
50458,53,29574,53,177,94,83,2,31,1,1,allow,0,0,Normal
42298,40005,17939,40005,263,182,81,2,30,1,1,allow,1,0,Potential Threat
63716,445,0,0,70,70,0,1,0,1,0,drop,0,1,Known Attack
61614,53,61614,53,257,101,156,2,33,1,1,allow,0,0,Normal
54033,443,63656,443,190,70,120,4,15,2,2,allow,1,0,Potential Threat
46899,443,24525,443,70,70,0,1,5,1,0,allow,0,0,Normal
2305,35440,0,0,62,62,0,1,0,1,0,deny,1,1,High Risk
59833,48817,0,0,107,107,0,1,0,1,0,deny,1,1,High Risk
49592,53,47137,53,177,94,83,2,30,1,1,allow,0,0,Normal
62406,445,0,0,70,70,0,1,0,1,0,drop,0,1,Known Attack
51975,443,14807,443,29510,15378,14132,76,216,35,41,allow,1,0,Potential Threat
50439,64147,0,0,66,66,0,1,0,1,0,deny,1,1,High Risk
3524,25174,0,0,62,62,0,1,0,1,0,deny,1,1,High Risk
60376,443,21896,443,9379,2092,7287,21,126,9,12,allow,1,0,Potential Threat
49678,80,44529,80,1977,921,1056,9,15,5,4,allow,0,0,Normal
46799,443,46799,443,22215,2460,19755,39,198,15,24,allow,1,0,Potential Threat
2541,51505,0,0,62,62,0,1,0,1,0,deny,1,1,High Risk
56470,28678,7618,28678,1806,1806,0,22,224,22,0,allow,1,0,Potential Threat
50622,445,0,0,66,66,0,1,0,1,0,drop,0,1,Known Attack
25348,23,0,0,60,60,0,1,0,1,0,deny,0,1,Known Attack
37672,5223,41244,5223,220,220,0,3,6,3,0,allow,1,0,Potential Threat
49439,443,14852,443,9495,2281,7214,22,78,11,11,allow,1,0,Potential Threat
60474,53,36065,53,195,94,101,2,30,1,1,allow,0,0,Normal
49418,27018,21489,27018,255,78,177,2,31,1,1,allow,1,0,Potential Threat
61280,26467,0,0,62,62,0,1,0,1,0,deny,0,1,Known Attack
61845,11392,0,0,66,66,0,1,0,1,0,deny,0,1,Known Attack
51978,80,26908,80,4612,3409,1203,14,25,9,5,allow,1,0,Potential Threat
58638,5900,0,0,62,62,0,1,0,1,0,deny,0,1,Known Attack
51969,80,59733,80,366,240,126,7,25,5,2,allow,0,0,Normal
52063,7886,16483,7886,70,70,0,1,5,1,0,allow,0,0,Normal
50378,53,26291,53,199,102,97,2,29,1,1,allow,0,0,Normal
11136,19910,0,0,62,62,0,1,0,1,0,deny,0,1,Known Attack
51805,445,0,0,70,70,0,1,0,1,0,drop,0,1,Known Attack
5223,61002,0,0,161,161,0,1,0,1,0,deny,1,1,High Risk
55590,53,20424,53,177,94,83,2,30,1,1,allow,0,0,Normal
61546,443,4493,443,208,60,148,4,13,2,2,allow,0,0,Normal
56724,445,0,0,70,70,0,1,0,1,0,drop,0,1,Known Attack
50788,48817,0,0,66,66,0,1,0,1,0,deny,0,1,Known Attack
49428,445,0,0,66,66,0,1,0,1,0,drop,0,1,Known Attack
33871,34476,0,0,137,137,0,1,0,1,0,deny,1,1,High Risk
57173,445,0,0,66,66,0,1,0,1,0,drop,0,1,Known Attack
50811,443,33324,443,2719275,48822,2670453,2459,127,689,1770,allow,1,0,Potential Threat
65107,53,22367,53,266,87,179,4,35,2,2,allow,0,0,Normal
49742,53,64876,53,223,102,121,2,30,1,1,allow,1,0,Potential Threat
58550,21247,0,0,66,66,0,1,0,1,0,deny,0,1,Known Attack
55069,53,19618,53,195,102,93,2,31,1,1,allow,0,0,Normal
58077,36653,14563,36653,204,64,140,4,10,2,2,allow,1,0,Potential Threat
17750,44597,35749,44597,481,150,331,2,1200,1,1,allow,1,0,Potential Threat
28699,53,53419,53,278,86,192,2,30,1,1,allow,1,0,Potential Threat
56551,53,25599,53,225,102,123,2,30,1,1,allow,0,0,Normal
53791,53,19031,53,102,102,0,1,30,1,0,allow,0,0,Normal
57268,445,0,0,66,66,0,1,0,1,0,drop,0,1,Known Attack
51755,5900,0,0,60,60,0,1,0,1,0,deny,0,1,Known Attack
50413,445,0,0,70,70,0,1,0,1,0,drop,0,1,Known Attack
53987,57470,0,0,66,66,0,1,0,1,0,deny,0,1,Known Attack
64016,53,50450,53,183,94,89,2,30,1,1,allow,0,0,Normal
30303,30303,0,0,181,181,0,1,0,1,0,deny,1,1,High Risk
38118,443,33958,443,574857,27894,546963,745,57,346,399,allow,1,0,Potential Threat
60868,443,49136,443,9660,2402,7258,27,46,15,12,allow,1,0,Potential Threat
50265,64304,32485,64304,970,598,372,14,1201,8,6,allow,1,0,Potential Threat
59962,445,0,0,70,70,0,1,0,1,0,drop,0,1,Known Attack
49168,53,56952,53,196,102,94,2,30,1,1,allow,0,0,Normal
58501,44847,0,0,62,62,0,1,0,1,0,deny,0,1,Known Attack
39802,443,21011,443,3025,1958,1067,26,49,14,12,allow,1,0,Potential Threat
50560,443,20442,443,17710,10880,6830,44,271,25,19,allow,1,0,Potential Threat
52170,443,36243,443,7228,1589,5639,22,362,11,11,allow,1,0,Potential Threat
60666,445,0,0,70,70,0,1,0,1,0,drop,0,1,Known Attack
41210,443,59857,443,78,78,0,1,5,1,0,allow,1,0,Potential Threat
53049,445,0,0,70,70,0,1,0,1,0,drop,0,1,Known Attack
52097,443,1702,443,11181,7329,3852,39,53,20,19,allow,1,0,Potential Threat
56811,44008,31634,44008,3034,1547,1487,12,16,7,5,allow,1,0,Potential Threat
53453,2767,0,0,66,66,0,1,0,1,0,deny,0,1,Known Attack
56786,53,65502,53,817,102,715,2,30,1,1,allow,1,0,Potential Threat
56407,53,58288,53,216,102,114,2,29,1,1,allow,0,0,Normal
57470,31566,19027,31566,481,150,331,2,1199,1,1,allow,1,0,Potential Threat
27081,10197,0,0,62,62,0,1,0,1,0,deny,0,1,Known Attack
51427,80,51427,80,22364,4125,18239,41,26,19,22,allow,1,0,Potential Threat
9104,443,36522,443,6240,1399,4841,24,44,12,12,allow,1,0,Potential Threat
49009,53,49009,53,172,76,96,2,30,1,1,allow,0,0,Normal
61278,56205,0,0,62,62,0,1,0,1,0,deny,1,1,High Risk
49253,53,20812,53,198,101,97,2,30,1,1,allow,0,0,Normal
49608,53,63386,53,198,110,88,2,29,1,1,allow,1,0,Potential Threat
50817,445,0,0,70,70,0,1,0,1,0,drop,0,1,Known Attack
59147,445,0,0,66,66,0,1,0,1,0,drop,0,1,Known Attack
49447,53,25197,53,248,102,146,2,29,1,1,allow,0,0,Normal
58819,1433,58819,1433,124,60,64,2,5,1,1,allow,1,0,Potential Threat
62820,53,62820,53,237,91,146,2,33,1,1,allow,1,0,Potential Threat
53717,445,0,0,70,70,0,1,0,1,0,drop,0,1,Known Attack
39583,37965,0,0,66,66,0,1,0,1,0,deny,0,1,Known Attack
15176,62413,0,0,62,62,0,1,0,1,0,deny,1,1,High Risk
50725,443,41613,443,6593,3522,3071,56,76,33,23,allow,1,0,Potential Threat
50580,80,50580,80,18727,8262,10465,44,18,23,21,allow,1,0,Potential Threat
60390,56494,64175,56494,70,70,0,2,8,2,0,allow,1,0,Potential Threat
50623,443,54546,443,13392,11220,2172,31,53,19,12,allow,1,0,Potential Threat
56131,53,31536,53,245,94,151,2,30,1,1,allow,0,0,Normal
50449,443,5504,443,7588,1850,5738,19,25,10,9,allow,1,0,Potential Threat
47640,443,10100,443,1058,571,487,10,38,6,4,allow,1,0,Potential Threat
64818,53,60686,53,179,94,85,2,30,1,1,allow,0,0,Normal
45601,443,27195,443,5378,984,4394,18,17,10,8,allow,1,0,Potential Threat
16387,64374,0,0,60,60,0,1,61,1,0,allow,1,0,Potential Threat
52611,445,0,0,70,70,0,1,0,1,0,drop,0,1,Known Attack
60469,60092,63327,60092,70,70,0,1,5,1,0,allow,1,0,Potential Threat
65428,53,32499,53,190,97,93,2,31,1,1,allow,0,0,Normal
54374,443,44819,443,9131,3499,5632,39,24,21,18,allow,1,0,Potential Threat
53067,4040,59736,4040,115,115,0,1,31,1,0,allow,1,0,Potential Threat
64472,53,59070,53,183,94,89,2,31,1,1,allow,0,0,Normal
50432,445,0,0,66,66,0,1,0,1,0,drop,0,1,Known Attack
64023,445,0,0,70,70,0,1,0,1,0,drop,0,1,Known Attack
60380,443,29465,443,70,70,0,1,5,1,0,allow,0,0,Normal
51122,445,0,0,66,66,0,1,0,1,0,drop,0,1,Known Attack
0,0,0,0,82,82,0,1,0,1,0,deny,1,1,High Risk
54389,28543,0,0,66,66,0,1,0,1,0,deny,0,1,Known Attack
49238,445,0,0,70,70,0,1,0,1,0,drop,0,1,Known Attack
56067,25174,0,0,62,62,0,1,0,1,0,deny,0,1,Known Attack
64643,53,40117,53,177,94,83,2,30,1,1,allow,0,0,Normal
55940,53,15244,53,168,86,82,2,30,1,1,allow,0,0,Normal
58888,23718,0,0,62,62,0,1,0,1,0,deny,0,1,Known Attack
56742,443,47140,443,8007,1987,6020,20,15,11,9,allow,1,0,Potential Threat
59911,445,0,0,70,70,0,1,0,1,0,drop,0,1,Known Attack
44147,64147,0,0,62,62,0,1,0,1,0,deny,1,1,High Risk
59736,53,9602,53,571,166,405,2,29,1,1,allow,0,0,Normal
38464,443,38464,443,33734,3007,30727,53,90,29,24,allow,1,0,Potential Threat
59101,445,0,0,70,70,0,1,0,1,0,drop,0,1,Known Attack
62902,32468,0,0,66,66,0,1,0,1,0,deny,0,1,Known Attack
44913,443,18458,443,414,140,274,7,27,3,4,allow,0,0,Normal
50907,443,12062,443,124,64,60,2,15,1,1,allow,0,0,Normal
56450,445,0,0,66,66,0,1,0,1,0,drop,0,1,Known Attack
56354,445,0,0,70,70,0,1,0,1,0,drop,0,1,Known Attack
65036,53,28927,53,214,110,104,2,30,1,1,allow,0,0,Normal
53716,443,15837,443,70,70,0,1,5,1,0,allow,0,0,Normal
63171,5228,60967,5228,3535,1973,1562,36,3961,18,18,allow,1,0,Potential Threat
10669,49756,0,0,60,60,0,1,0,1,0,deny,1,1,High Risk
56467,445,0,0,70,70,0,1,0,1,0,drop,0,1,Known Attack
61916,445,0,0,70,70,0,1,0,1,0,drop,0,1,Known Attack
57277,445,0,0,66,66,0,1,0,1,0,drop,0,1,Known Attack
28275,80,28275,80,303421,10894,292527,324,26,116,208,allow,1,0,Potential Threat
55039,443,37835,443,19775,1890,17885,40,80,17,23,allow,1,0,Potential Threat
32909,443,28727,443,160821,7879,152942,201,141,88,113,allow,1,0,Potential Threat
56872,53,25005,53,443,182,261,6,29,3,3,allow,0,0,Normal
62408,50584,0,0,66,66,0,1,0,1,0,deny,1,1,High Risk
58004,445,0,0,70,70,0,1,0,1,0,drop,0,1,Known Attack
64249,53,6288,53,181,94,87,2,33,1,1,allow,0,0,Normal
7634,80,7634,80,1845,523,1322,10,15,6,4,allow,1,0,Potential Threat
58648,445,0,0,66,66,0,1,0,1,0,drop,0,1,Known Attack
62799,445,0,0,70,70,0,1,0,1,0,drop,0,1,Known Attack
53751,22266,31272,22266,754,502,252,11,20,7,4,allow,1,0,Potential Threat
64639,3389,64639,3389,3409,1454,1955,16,16,8,8,allow,1,0,Potential Threat
64022,53,20960,53,194,99,95,2,1,1,1,allow,0,0,Normal
49594,22114,0,0,66,66,0,1,0,1,0,deny,0,1,Known Attack
60251,445,0,0,66,66,0,1,0,1,0,drop,0,1,Known Attack
37420,44847,0,0,62,62,0,1,0,1,0,deny,0,1,Known Attack
59379,443,58325,443,4518,1784,2734,30,23,15,15,allow,1,0,Potential Threat
50392,443,55310,443,1125,595,530,12,29,6,6,allow,1,0,Potential Threat
64569,443,62686,443,9157,2109,7048,27,32,15,12,allow,1,0,Potential Threat
16403,16386,35244,16386,426,186,240,8,30,4,4,allow,1,0,Potential Threat
56787,53,40108,53,209,110,99,2,30,1,1,allow,0,0,Normal
34636,23,0,0,60,60,0,1,0,1,0,deny,0,1,Known Attack
53831,80,61237,80,5774,1483,4291,14,162,8,6,allow,1,0,Potential Threat
54461,80,46042,80,2544,900,1644,12,255,7,5,allow,1,0,Potential Threat
10480,26467,0,0,62,62,0,1,0,1,0,deny,0,1,Known Attack
1025,57470,0,0,62,62,0,1,0,1,0,deny,1,1,High Risk
56458,53,36864,53,192,98,94,2,31,1,1,allow,0,0,Normal
55604,445,0,0,66,66,0,1,0,1,0,drop,0,1,Known Attack
39051,443,15445,443,7082,4527,2555,31,31,16,15,allow,1,0,Potential Threat
56351,53,53304,53,195,102,93,2,33,1,1,allow,0,0,Normal
49769,443,1740,443,13455,1982,11473,29,31,16,13,allow,1,0,Potential Threat
2432,11392,0,0,62,62,0,1,0,1,0,deny,1,1,High Risk
61436,443,20457,443,1401,940,461,11,29,7,4,allow,1,0,Potential Threat
57778,443,43252,443,6182,3879,2303,53,3828,31,22,allow,1,0,Potential Threat
53718,443,3459,443,499,425,74,4,0,3,1,allow,0,0,Normal
41447,64147,0,0,62,62,0,1,0,1,0,deny,1,1,High Risk
63581,445,0,0,66,66,0,1,0,1,0,drop,0,1,Known Attack
64578,53,11531,53,193,102,91,2,30,1,1,allow,0,0,Normal
56171,445,0,0,70,70,0,1,0,1,0,drop,0,1,Known Attack
64335,35440,0,0,62,62,0,1,0,1,0,deny,1,1,High Risk
9158,53,9158,53,237,91,146,2,33,1,1,allow,1,0,Potential Threat
15313,34068,0,0,146,146,0,1,0,1,0,deny,1,1,High Risk
49485,443,26234,443,49823,7236,42587,56,29,20,36,allow,1,0,Potential Threat
57367,443,57367,443,4381,1474,2907,19,29,11,8,allow,1,0,Potential Threat
55632,45682,33177,45682,70,70,0,1,5,1,0,allow,1,0,Potential Threat
50500,53,52272,53,164,84,80,2,30,1,1,allow,0,0,Normal
48300,443,42844,443,7762,2247,5515,21,31,11,10,allow,1,0,Potential Threat
50713,53,50713,53,198,90,108,2,30,1,1,allow,0,0,Normal
57512,80,20735,80,1377,881,496,12,48,7,5,allow,0,0,Normal
49989,445,0,0,70,70,0,1,0,1,0,drop,0,1,Known Attack
53707,445,0,0,66,66,0,1,0,1,0,drop,0,1,Known Attack
55028,443,52319,443,6791,1415,5376,19,51,12,7,allow,1,0,Potential Threat
30496,57470,0,0,62,62,0,1,0,1,0,deny,1,1,High Risk
65047,53,39231,53,645,185,460,6,40,3,3,allow,1,0,Potential Threat
56507,80,59986,80,1583,712,871,10,136,6,4,allow,1,0,Potential Threat
49452,445,0,0,70,70,0,1,0,1,0,drop,0,1,Known Attack
24227,48817,0,0,160,160,0,1,0,1,0,deny,1,1,High Risk
46026,443,9317,443,8908,3897,5011,19,135,9,10,allow,1,0,Potential Threat
60975,443,27000,443,333131,17461,315670,435,72,211,224,allow,1,0,Potential Threat
56522,53,55041,53,177,94,83,2,30,1,1,allow,0,0,Normal
50637,36237,0,0,66,66,0,1,0,1,0,deny,0,1,Known Attack
52924,443,50522,443,21789,7672,14117,78,115,39,39,allow,1,0,Potential Threat
44388,63874,0,0,66,66,0,1,0,1,0,deny,1,1,High Risk
64877,53,24531,53,309,110,199,2,30,1,1,allow,0,0,Normal
49633,53,21391,53,168,86,82,2,30,1,1,allow,0,0,Normal
53132,29384,28228,29384,70,70,0,2,8,2,0,allow,1,0,Potential Threat
64543,445,0,0,70,70,0,1,0,1,0,drop,0,1,Known Attack
50858,445,0,0,70,70,0,1,0,1,0,drop,0,1,Known Attack
53510,58706,37396,58706,492,306,186,8,16,5,3,allow,1,0,Potential Threat
54204,445,0,0,70,70,0,1,0,1,0,drop,0,1,Known Attack
56312,53,62143,53,711,87,624,2,30,1,1,allow,1,0,Potential Threat
65263,53,53101,53,232,110,122,2,30,1,1,allow,0,0,Normal
50933,80,44380,80,9932735,85391,9847344,7875,123,1237,6638,allow,1,0,Potential Threat
3117,37965,0,0,62,62,0,1,0,1,0,deny,1,1,High Risk
49680,26467,0,0,146,146,0,1,0,1,0,deny,1,1,High Risk
52616,80,52616,80,3366,2547,819,15,49,8,7,allow,1,0,Potential Threat
47166,443,47166,443,4567,1660,2907,19,28,11,8,allow,1,0,Potential Threat
58716,9694,0,0,62,62,0,1,0,1,0,deny,0,1,Known Attack
51869,25355,56016,25355,70,70,0,1,5,1,0,allow,1,0,Potential Threat
50668,443,5052,443,2881,642,2239,13,135,6,7,allow,1,0,Potential Threat
56524,443,60258,443,759397,22470,736927,766,108,270,496,allow,1,0,Potential Threat
53864,24874,8342,24874,320,140,180,6,6,3,3,allow,1,0,Potential Threat
58101,53,12737,53,83,83,0,2,31,2,0,allow,0,0,Normal
63343,53,0,0,74,74,0,1,0,1,0,deny,0,1,Known Attack
64379,445,0,0,70,70,0,1,0,1,0,drop,0,1,Known Attack
56490,443,62341,443,11756,4004,7752,26,121,12,14,allow,1,0,Potential Threat
50378,445,0,0,70,70,0,1,0,1,0,drop,0,1,Known Attack
5231,30114,20445,30114,832,832,0,14,96,14,0,allow,1,0,Potential Threat
3559,30188,0,0,66,66,0,1,0,1,0,deny,1,1,High Risk
34709,443,21963,443,2119,1310,809,21,27,12,9,allow,1,0,Potential Threat
51957,443,52201,443,3516,1732,1784,34,42,19,15,allow,1,0,Potential Threat
52622,445,0,0,70,70,0,1,0,1,0,drop,0,1,Known Attack
56595,445,0,0,70,70,0,1,0,1,0,drop,0,1,Known Attack
53948,445,0,0,70,70,0,1,0,1,0,drop,0,1,Known Attack
57470,1028,19810,1028,350,163,187,2,1200,1,1,allow,1,0,Potential Threat
58638,5900,0,0,62,62,0,1,0,1,0,deny,0,1,Known Attack
54666,36237,0,0,66,66,0,1,0,1,0,deny,0,1,Known Attack
56626,443,26601,443,7941,1952,5989,20,15,11,9,allow,1,0,Potential Threat
53536,445,0,0,70,70,0,1,0,1,0,drop,0,1,Known Attack
60340,80,29761,80,9406,1913,7493,14,16,7,7,allow,1,0,Potential Threat
65266,53,11513,53,754,94,660,2,30,1,1,allow,0,0,Normal
55198,80,49692,80,41822,2038,39784,56,15,27,29,allow,1,0,Potential Threat
64589,445,0,0,70,70,0,1,0,1,0,drop,0,1,Known Attack
52743,15503,0,0,66,66,0,1,0,1,0,deny,0,1,Known Attack
64095,1976,59706,1976,70,70,0,1,5,1,0,allow,1,0,Potential Threat
19473,51413,49212,51413,459,149,310,2,1200,1,1,allow,1,0,Potential Threat
57044,53,35114,53,197,102,95,2,30,1,1,allow,0,0,Normal
43309,80,55504,80,805,665,140,6,32,4,2,allow,1,0,Potential Threat
64364,53,21283,53,193,94,99,2,31,1,1,allow,0,0,Normal
56607,443,33013,443,21604,12969,8635,49,112,28,21,allow,1,0,Potential Threat
59875,445,0,0,70,70,0,1,0,1,0,drop,0,1,Known Attack
50814,53,0,0,82,82,0,1,30,1,0,allow,0,0,Normal
51233,43890,0,0,66,66,0,1,0,1,0,deny,0,1,Known Attack
49701,445,0,0,70,70,0,1,0,1,0,drop,0,1,Known Attack
64128,53,11418,53,186,95,91,2,31,1,1,allow,0,0,Normal
50241,53,32622,53,184,102,82,2,30,1,1,allow,0,0,Normal
17750,39318,52655,39318,481,150,331,2,1200,1,1,allow,1,0,Potential Threat
42959,443,5921,443,795,795,0,2,154,2,0,allow,1,0,Potential Threat
45908,33330,0,0,60,60,0,1,0,1,0,deny,0,1,Known Attack
61387,43890,0,0,66,66,0,1,0,1,0,deny,0,1,Known Attack
64166,35440,0,0,62,62,0,1,0,1,0,deny,1,1,High Risk
50472,80,63342,80,12222,3865,8357,23,22,11,12,allow,1,0,Potential Threat
64995,53,14595,53,210,110,100,2,30,1,1,allow,0,0,Normal
443,31367,0,0,74,74,0,1,0,1,0,deny,1,1,High Risk
2099,53,2099,53,217,82,135,2,33,1,1,allow,1,0,Potential Threat
65304,53,61262,53,209,110,99,2,30,1,1,allow,1,0,Potential Threat
49183,53,55748,53,177,94,83,2,30,1,1,allow,0,0,Normal
43604,53,41746,53,168,78,90,2,30,1,1,allow,0,0,Normal
50356,53,30610,53,180,94,86,2,30,1,1,allow,0,0,Normal
58784,443,58898,443,41305,2456,38849,63,30,29,34,allow,1,0,Potential Threat
52348,62413,0,0,66,66,0,1,0,1,0,deny,1,1,High Risk
55887,53,35825,53,339,98,241,4,47,2,2,allow,0,0,Normal
61332,23,0,0,60,60,0,1,0,1,0,deny,0,1,Known Attack
57093,26467,0,0,66,66,0,1,0,1,0,deny,0,1,Known Attack
1025,35447,0,0,62,62,0,1,0,1,0,deny,1,1,High Risk
49513,53,36009,53,200,102,98,2,30,1,1,allow,0,0,Normal
56260,53,30984,53,177,94,83,2,31,1,1,allow,0,0,Normal
10091,22114,0,0,62,62,0,1,0,1,0,deny,0,1,Known Attack
40122,443,13389,443,8235,2076,6159,24,330,11,13,allow,1,0,Potential Threat
46774,80,26120,80,2074,1375,699,13,83,7,6,allow,1,0,Potential Threat
46763,443,11187,443,11876848,256539,11620309,11266,74,3584,7682,allow,1,0,Potential Threat
5578,53,5578,53,288,83,205,2,31,1,1,allow,1,0,Potential Threat
58638,5900,0,0,62,62,0,1,0,1,0,deny,0,1,Known Attack
27005,27050,14571,27050,1684,126,1558,4,31,2,2,allow,1,0,Potential Threat
1284,50584,0,0,66,66,0,1,0,1,0,deny,1,1,High Risk
64755,445,0,0,70,70,0,1,0,1,0,drop,0,1,Known Attack
51212,445,0,0,70,70,0,1,0,1,0,drop,0,1,Known Attack
16037,25174,0,0,62,62,0,1,0,1,0,deny,0,1,Known Attack
62360,445,0,0,70,70,0,1,0,1,0,drop,0,1,Known Attack
61419,443,21446,443,1664127,116770,1547357,2028,401,736,1292,allow,1,0,Potential Threat
1187,64147,0,0,66,66,0,1,0,1,0,deny,1,1,High Risk
56020,53,34140,53,199,102,97,2,29,1,1,allow,0,0,Normal
52107,443,6381,443,12091,3135,8956,30,49,16,14,allow,1,0,Potential Threat
60611,443,2263,443,478331,21023,457308,573,211,201,372,allow,1,0,Potential Threat
58887,15000,7750,15000,138,78,60,2,6,1,1,allow,1,0,Potential Threat
44934,443,47157,443,416,210,206,7,24,4,3,allow,0,0,Normal
58035,80,7543,80,4168,2906,1262,11,15,6,5,allow,1,0,Potential Threat
34809,57470,0,0,66,66,0,1,0,1,0,deny,1,1,High Risk
42317,443,11761,443,416,210,206,7,27,4,3,allow,0,0,Normal
60818,37965,0,0,66,66,0,1,0,1,0,deny,0,1,Known Attack
59747,443,7939,443,304,86,218,2,29,1,1,allow,0,0,Normal
56265,53,18284,53,733,85,648,2,30,1,1,allow,0,0,Normal
7968,2767,0,0,62,62,0,1,0,1,0,deny,0,1,Known Attack
53800,445,0,0,66,66,0,1,0,1,0,drop,0,1,Known Attack
54993,53,49299,53,410,109,301,4,32,2,2,allow,0,0,Normal
53852,80,48149,80,130,70,60,2,15,1,1,allow,0,0,Normal
52028,80,63717,80,422,240,182,8,24,5,3,allow,1,0,Potential Threat
49482,80,62281,80,378,192,186,7,39,4,3,allow,1,0,Potential Threat
56481,80,14814,80,71347,4788,66559,83,136,34,49,allow,1,0,Potential Threat
64534,53,43156,53,212,108,104,2,31,1,1,allow,0,0,Normal
55927,53,41588,53,720,94,626,2,29,1,1,allow,0,0,Normal
52082,80,6337,80,4560,3934,626,11,29,6,5,allow,1,0,Potential Threat
50951,80,50951,80,514,246,268,9,42,5,4,allow,0,0,Normal
64949,44847,0,0,66,66,0,1,0,1,0,deny,1,1,High Risk
9305,443,52742,443,3616,429,3187,11,16,6,5,allow,1,0,Potential Threat
45964,14444,0,0,60,60,0,1,0,1,0,deny,0,1,Known Attack
56971,53,47465,53,195,102,93,2,30,1,1,allow,0,0,Normal
59168,445,0,0,70,70,0,1,0,1,0,drop,0,1,Known Attack
18653,42707,0,0,66,66,0,1,0,1,0,deny,1,1,High Risk
64245,53,44468,53,199,102,97,2,30,1,1,allow,0,0,Normal
3478,61463,0,0,252,252,0,1,0,1,0,deny,1,1,High Risk
57470,6881,14174,6881,490,163,327,2,1200,1,1,allow,1,0,Potential Threat
17378,44847,0,0,66,66,0,1,0,1,0,deny,1,1,High Risk
43976,80,46864,80,130,70,60,2,15,1,1,allow,0,0,Normal
59035,445,0,0,70,70,0,1,0,1,0,drop,0,1,Known Attack
60159,22114,0,0,62,62,0,1,0,1,0,deny,0,1,Known Attack
26889,50265,0,0,66,66,0,1,0,1,0,deny,1,1,High Risk
42298,40016,11792,40016,148,86,62,2,30,1,1,allow,1,0,Potential Threat
57098,1,0,0,78,78,0,1,0,1,0,deny,0,1,Known Attack
49929,53,53934,53,214,110,104,2,30,1,1,allow,0,0,Normal
443,50238,0,0,331,331,0,1,0,1,0,deny,1,1,High Risk
46149,23,0,0,60,60,0,1,0,1,0,deny,0,1,Known Attack
22904,56205,0,0,62,62,0,1,0,1,0,deny,1,1,High Risk
63379,36237,0,0,62,62,0,1,0,1,0,deny,0,1,Known Attack
61279,443,14356,443,7424,3871,3553,26,160,12,14,allow,1,0,Potential Threat
55098,53,33176,53,474,200,274,6,44,3,3,allow,0,0,Normal
50560,443,29461,443,408090,25873,382217,748,137,354,394,allow,1,0,Potential Threat
39328,80,54036,80,78,78,0,1,5,1,0,allow,0,0,Normal
59772,443,48331,443,181413,11493,169920,167,85,41,126,allow,1,0,Potential Threat
41022,30975,0,0,157,157,0,1,0,1,0,deny,1,1,High Risk
38413,53,37201,53,199,94,105,2,29,1,1,allow,0,0,Normal
56344,53,2417,53,199,102,97,2,30,1,1,allow,0,0,Normal
27005,27017,49070,27017,883,126,757,2,30,1,1,allow,1,0,Potential Threat
38980,17,0,0,60,60,0,1,0,1,0,deny,0,1,Known Attack
64947,53,11296,53,275,96,179,4,41,2,2,allow,0,0,Normal
55077,53,42307,53,179,94,85,2,30,1,1,allow,0,0,Normal
56776,445,0,0,66,66,0,1,0,1,0,drop,0,1,Known Attack
55631,443,58192,443,6897,2509,4388,16,121,8,8,allow,1,0,Potential Threat
53233,445,0,0,70,70,0,1,0,1,0,drop,0,1,Known Attack
52050,11392,0,0,62,62,0,1,0,1,0,deny,0,1,Known Attack
58638,5900,0,0,62,62,0,1,0,1,0,deny,0,1,Known Attack
49253,53,0,0,218,78,140,2,30,1,1,allow,0,0,Normal
61234,48817,0,0,106,106,0,1,0,1,0,deny,1,1,High Risk
57005,53,24332,53,762,98,664,2,30,1,1,allow,0,0,Normal
65024,53,47698,53,179,94,85,2,30,1,1,allow,0,0,Normal
50428,80,50756,80,312,192,120,6,27,4,2,allow,0,0,Normal
50482,445,0,0,66,66,0,1,0,1,0,drop,0,1,Known Attack
31362,23,31362,23,60,60,0,1,5,1,0,allow,0,0,Normal
53260,443,22555,443,23664,2213,21451,41,323,17,24,allow,1,0,Potential Threat
50584,49001,15411,49001,889,161,728,3,1200,2,1,allow,1,0,Potential Threat
993,18732,0,0,129,129,0,1,0,1,0,deny,1,1,High Risk
50066,30188,0,0,66,66,0,1,0,1,0,deny,0,1,Known Attack
64616,53,29802,53,184,80,104,2,30,1,1,allow,0,0,Normal
63968,37264,37420,37264,504,382,122,8,15,6,2,allow,1,0,Potential Threat
49505,443,25913,443,6318,2030,4288,25,270,12,13,allow,1,0,Potential Threat
52914,37965,0,0,66,66,0,1,0,1,0,deny,0,1,Known Attack
53202,443,37949,443,6043,1568,4475,11,120,4,7,allow,1,0,Potential Threat
56734,80,64954,80,194,128,66,4,25,3,1,allow,1,0,Potential Threat
57287,445,0,0,70,70,0,1,0,1,0,drop,0,1,Known Attack
59298,443,18109,443,20971,2840,18131,52,89,24,28,allow,1,0,Potential Threat
12226,37965,0,0,62,62,0,1,0,1,0,deny,1,1,High Risk
51904,51883,50262,51883,70,70,0,1,5,1,0,allow,1,0,Potential Threat
27679,37965,0,0,62,62,0,1,0,1,0,deny,0,1,Known Attack
57129,53,59540,53,265,94,171,2,30,1,1,allow,0,0,Normal
50579,80,48781,80,265114,13651,251463,346,76,161,185,allow,1,0,Potential Threat
56340,53,40288,53,198,102,96,2,30,1,1,allow,0,0,Normal
55551,53,64054,53,180,94,86,2,29,1,1,allow,1,0,Potential Threat
61779,445,0,0,70,70,0,1,0,1,0,drop,0,1,Known Attack
65116,445,0,0,66,66,0,1,0,1,0,drop,0,1,Known Attack
60893,443,56200,443,4252,1594,2658,13,135,6,7,allow,1,0,Potential Threat
51406,443,19359,443,5360,3775,1585,22,35,13,9,allow,1,0,Potential Threat
16387,64660,0,0,60,60,0,1,0,1,0,deny,1,1,High Risk
3290,57470,0,0,145,145,0,1,0,1,0,deny,1,1,High Risk
55427,445,0,0,66,66,0,1,0,1,0,drop,0,1,Known Attack
55715,53,57381,53,168,86,82,2,30,1,1,allow,0,0,Normal
65307,53,36094,53,811,94,717,2,29,1,1,allow,0,0,Normal
55454,53,12163,53,168,86,82,2,32,1,1,allow,0,0,Normal
64979,27050,52278,27050,735,462,273,2,30,1,1,allow,1,0,Potential Threat
57698,64147,0,0,66,66,0,1,0,1,0,deny,1,1,High Risk
51966,25174,0,0,62,62,0,1,0,1,0,deny,0,1,Known Attack
63827,445,0,0,70,70,0,1,0,1,0,drop,0,1,Known Attack
64072,80,14418,80,314,192,122,6,15,4,2,allow,0,0,Normal
1848,53,1848,53,832,106,726,2,29,1,1,allow,1,0,Potential Threat
54838,445,0,0,66,66,0,1,0,1,0,drop,0,1,Known Attack
45060,37965,0,0,62,62,0,1,0,1,0,deny,0,1,Known Attack
54778,22114,0,0,66,66,0,1,0,1,0,deny,0,1,Known Attack
49636,53,23682,53,180,94,86,2,30,1,1,allow,0,0,Normal
56785,39004,0,0,145,145,0,1,0,1,0,deny,1,1,High Risk
56561,53,63189,53,167,86,81,2,30,1,1,allow,1,0,Potential Threat
60857,61689,0,0,146,146,0,1,0,1,0,deny,1,1,High Risk
64380,53,30464,53,196,102,94,2,32,1,1,allow,0,0,Normal
42298,40035,3337,40035,207,85,122,4,30,2,2,allow,1,0,Potential Threat
58638,5900,0,0,62,62,0,1,0,1,0,deny,0,1,Known Attack
38633,51221,0,0,66,66,0,1,0,1,0,deny,0,1,Known Attack
63759,443,31179,443,7995,2096,5899,18,120,8,10,allow,1,0,Potential Threat
49415,53,16500,53,194,102,92,2,30,1,1,allow,0,0,Normal
64997,53,32660,53,771,102,669,2,29,1,1,allow,0,0,Normal
55063,80,20796,80,2776,1333,1443,12,37,7,5,allow,0,0,Normal
3667,56205,0,0,62,62,0,1,0,1,0,deny,1,1,High Risk
16057,51050,0,0,66,66,0,1,0,1,0,deny,1,1,High Risk
55311,53,15716,53,298,101,197,4,31,2,2,allow,0,0,Normal
49469,53,2393,53,185,102,83,2,30,1,1,allow,0,0,Normal
27997,80,36977,80,3683,591,3092,11,45,6,5,allow,1,0,Potential Threat
55596,53,61686,53,170,87,83,2,30,1,1,allow,0,0,Normal
53259,123,17557,123,184,94,90,2,31,1,1,allow,0,0,Normal
60416,37965,0,0,66,66,0,1,0,1,0,deny,0,1,Known Attack
63956,38211,0,0,62,62,0,1,0,1,0,deny,0,1,Known Attack
63060,445,0,0,70,70,0,1,0,1,0,drop,0,1,Known Attack
56565,443,50266,443,52157,3066,49091,65,80,26,39,allow,1,0,Potential Threat
52474,445,0,0,70,70,0,1,0,1,0,drop,0,1,Known Attack
80,53945,0,0,60,60,0,1,0,1,0,deny,1,1,High Risk
38667,443,44334,443,496852,12216,484636,499,16,167,332,allow,1,0,Potential Threat
59780,443,27949,443,19224,2358,16866,38,28,15,23,allow,1,0,Potential Threat
56680,53,8517,53,211,102,109,2,30,1,1,allow,0,0,Normal
65372,53,40284,53,198,102,96,2,30,1,1,allow,0,0,Normal
56337,53,29643,53,268,89,179,4,45,2,2,allow,0,0,Normal
61681,23,0,0,60,60,0,1,0,1,0,deny,0,1,Known Attack
59784,443,16677,443,6698,1606,5092,23,19,13,10,allow,1,0,Potential Threat
63930,44330,64385,44330,66,66,0,2,7,2,0,allow,1,0,Potential Threat
58000,80,21507,80,48253,13664,34589,66,75,25,41,allow,1,0,Potential Threat
46488,443,7780,443,87129,6924,80205,126,258,49,77,allow,1,0,Potential Threat
58882,445,0,0,66,66,0,1,0,1,0,drop,0,1,Known Attack
54036,443,30085,443,43295,8391,34904,66,49,32,34,allow,1,0,Potential Threat
51508,4545,51508,4545,156,156,0,3,8,3,0,allow,1,0,Potential Threat
56892,445,0,0,70,70,0,1,0,1,0,drop,0,1,Known Attack
59336,80,59336,80,24437,12718,11719,41,15,16,25,allow,1,0,Potential Threat
49639,445,0,0,66,66,0,1,0,1,0,drop,0,1,Known Attack
61135,445,0,0,70,70,0,1,0,1,0,drop,0,1,Known Attack
58387,445,0,0,70,70,0,1,0,1,0,drop,0,1,Known Attack
19662,22114,0,0,62,62,0,1,0,1,0,deny,0,1,Known Attack
59128,44847,0,0,66,66,0,1,0,1,0,deny,0,1,Known Attack
55570,53,24983,53,168,86,82,2,29,1,1,allow,0,0,Normal
62037,445,0,0,70,70,0,1,0,1,0,drop,0,1,Known Attack
6721,37965,0,0,66,66,0,1,0,1,0,deny,1,1,High Risk
55587,32217,8141,32217,320,140,180,6,6,3,3,allow,1,0,Potential Threat
49545,443,58325,443,7189,1694,5495,31,131,14,17,allow,1,0,Potential Threat
49542,443,22517,443,9824,1839,7985,27,172,13,14,allow,1,0,Potential Threat
63280,445,0,0,70,70,0,1,0,1,0,drop,0,1,Known Attack
38863,443,38863,443,36313,5931,30382,72,108,36,36,allow,1,0,Potential Threat
28973,30188,0,0,66,66,0,1,0,1,0,deny,0,1,Known Attack
57312,53,16678,53,1385,85,1300,4,42,2,2,allow,0,0,Normal
53899,45682,27773,45682,70,70,0,2,7,2,0,allow,1,0,Potential Threat
52220,65128,1362,65128,70,70,0,1,5,1,0,allow,1,0,Potential Threat
49364,80,47748,80,2168,1031,1137,8,166,5,3,allow,1,0,Potential Threat
47147,443,62760,443,70,70,0,1,5,1,0,allow,1,0,Potential Threat
56252,53,46494,53,531,90,441,4,41,2,2,allow,0,0,Normal
61477,57470,0,0,66,66,0,1,0,1,0,deny,1,1,High Risk
7892,50584,0,0,62,62,0,1,0,1,0,deny,1,1,High Risk
19790,35440,0,0,146,146,0,1,0,1,0,deny,1,1,High Risk
64587,443,60822,443,24686,1935,22751,36,18,17,19,allow,1,0,Potential Threat
55760,445,0,0,66,66,0,1,0,1,0,drop,0,1,Known Attack
61339,445,0,0,66,66,0,1,0,1,0,drop,0,1,Known Attack
51404,443,29692,443,9076,2650,6426,35,247,15,20,allow,1,0,Potential Threat
59171,445,0,0,66,66,0,1,0,1,0,drop,0,1,Known Attack
49845,53,6637,53,188,96,92,2,31,1,1,allow,0,0,Normal
57204,53,58502,53,182,93,89,2,30,1,1,allow,0,0,Normal
55392,445,0,0,70,70,0,1,0,1,0,drop,0,1,Known Attack
49723,53,9926,53,209,110,99,2,30,1,1,allow,0,0,Normal
55867,53,63583,53,184,94,90,2,31,1,1,allow,1,0,Potential Threat
50466,80,60136,80,1718,1247,471,9,15,5,4,allow,1,0,Potential Threat
55223,53,62144,53,168,86,82,2,30,1,1,allow,0,0,Normal
61811,445,0,0,70,70,0,1,0,1,0,drop,0,1,Known Attack
64539,53,5433,53,170,87,83,2,31,1,1,allow,0,0,Normal
49418,27015,55530,27015,244,78,166,2,30,1,1,allow,1,0,Potential Threat
61898,50584,0,0,66,66,0,1,0,1,0,deny,1,1,High Risk
50772,35440,0,0,62,62,0,1,0,1,0,deny,0,1,Known Attack
57470,6890,10619,6890,520,166,354,2,1199,1,1,allow,1,0,Potential Threat
52103,7172,60174,7172,70,70,0,1,5,1,0,allow,1,0,Potential Threat
57750,37965,0,0,146,146,0,1,0,1,0,deny,1,1,High Risk
53814,6725,2877,6725,70,70,0,2,7,2,0,allow,1,0,Potential Threat
52940,445,0,0,66,66,0,1,0,1,0,drop,0,1,Known Attack
58726,53,60102,53,247,102,145,2,30,1,1,allow,0,0,Normal
49326,445,0,0,66,66,0,1,0,1,0,drop,0,1,Known Attack
55877,14966,41407,14966,480,149,331,2,1200,1,1,allow,1,0,Potential Threat
58861,445,0,0,70,70,0,1,0,1,0,drop,0,1,Known Attack
64755,31573,0,0,66,66,0,1,0,1,0,deny,0,1,Known Attack
56357,53,43441,53,819,102,717,2,30,1,1,allow,0,0,Normal
42922,80,41285,80,234,234,0,4,12,4,0,allow,0,0,Normal
6881,43642,35387,43642,150,150,0,1,1201,1,0,allow,1,0,Potential Threat
64334,25174,0,0,66,66,0,1,0,1,0,deny,0,1,Known Attack
65254,53,46437,53,459,94,365,4,45,2,2,allow,0,0,Normal
64892,53,50035,53,252,102,150,2,29,1,1,allow,0,0,Normal
56621,80,4891,80,234,234,0,4,12,4,0,allow,0,0,Normal
56627,53,58271,53,193,102,91,2,29,1,1,allow,0,0,Normal
56940,53,36969,53,200,102,98,2,31,1,1,allow,0,0,Normal
63900,42641,18797,42641,504,382,122,8,16,6,2,allow,1,0,Potential Threat
59552,445,0,0,66,66,0,1,0,1,0,drop,0,1,Known Attack
63194,50265,0,0,66,66,0,1,0,1,0,deny,1,1,High Risk
44454,443,1457,443,7092,1495,5597,22,31,12,10,allow,1,0,Potential Threat
51746,25174,0,0,66,66,0,1,0,1,0,deny,0,1,Known Attack
65007,53,25080,53,180,86,94,2,30,1,1,allow,0,0,Normal
57403,445,0,0,66,66,0,1,0,1,0,drop,0,1,Known Attack
62338,50011,0,0,66,66,0,1,0,1,0,deny,1,1,High Risk
54125,443,18046,443,170665,9296,161369,227,116,102,125,allow,1,0,Potential Threat
53727,445,0,0,70,70,0,1,0,1,0,drop,0,1,Known Attack
52541,53,60922,53,242,78,164,2,29,1,1,allow,0,0,Normal
60900,443,23820,443,134,60,74,3,6,2,1,allow,0,0,Normal
60748,445,0,0,70,70,0,1,0,1,0,drop,0,1,Known Attack
51658,445,0,0,70,70,0,1,0,1,0,drop,0,1,Known Attack
44246,80,45320,80,5584,2543,3041,20,27,11,9,allow,1,0,Potential Threat
35657,48637,0,0,62,62,0,1,0,1,0,deny,0,1,Known Attack
49639,443,62054,443,5776,1079,4697,15,53,8,7,allow,1,0,Potential Threat
59820,445,0,0,70,70,0,1,0,1,0,drop,0,1,Known Attack
38766,53,38766,53,371,237,134,3,32,2,1,allow,0,0,Normal
56166,53,15271,53,193,102,91,2,30,1,1,allow,0,0,Normal
46456,443,58612,443,4921,2134,2787,21,95,10,11,allow,1,0,Potential Threat
65394,445,0,0,66,66,0,1,0,1,0,drop,0,1,Known Attack
62066,443,9765,443,3150,831,2319,13,135,6,7,allow,1,0,Potential Threat
58080,443,57943,443,646,358,288,10,133,6,4,allow,1,0,Potential Threat
50956,25174,0,0,146,146,0,1,0,1,0,deny,1,1,High Risk
42843,53,7011,53,168,78,90,2,30,1,1,allow,0,0,Normal
51295,80,40456,80,6702,5879,823,19,135,10,9,allow,1,0,Potential Threat
40082,2222,0,0,60,60,0,1,0,1,0,deny,0,1,Known Attack
60019,443,11836,443,76774,9184,67590,104,143,41,63,allow,1,0,Potential Threat
55856,53,56508,53,265,94,171,2,30,1,1,allow,0,0,Normal
51570,445,0,0,66,66,0,1,0,1,0,drop,0,1,Known Attack
57244,445,0,0,70,70,0,1,0,1,0,drop,0,1,Known Attack
64642,53,2609,53,307,94,213,2,30,1,1,allow,0,0,Normal
56658,53,1646,53,170,87,83,2,30,1,1,allow,0,0,Normal
41269,443,9096,443,78,78,0,1,5,1,0,allow,0,0,Normal
60298,443,32921,443,9565,3317,6248,25,144,14,11,allow,1,0,Potential Threat
1024,35894,0,0,62,62,0,1,0,1,0,deny,1,1,High Risk
57153,445,0,0,66,66,0,1,0,1,0,drop,0,1,Known Attack
56815,445,0,0,70,70,0,1,0,1,0,drop,0,1,Known Attack
49459,443,9422,443,39932,34025,5907,52,21,34,18,allow,1,0,Potential Threat
52079,1024,39803,1024,66,66,0,1,5,1,0,allow,0,0,Normal
45346,443,29212,443,2438,1442,996,21,20,12,9,allow,1,0,Potential Threat
57033,53,22099,53,216,110,106,2,30,1,1,allow,0,0,Normal
41953,443,3719,443,4129,2865,1264,17,361,9,8,allow,1,0,Potential Threat
64845,445,0,0,70,70,0,1,0,1,0,drop,0,1,Known Attack
51582,48817,0,0,66,66,0,1,0,1,0,deny,0,1,Known Attack
65515,53,15950,53,652,209,443,6,50,3,3,allow,1,0,Potential Threat
55466,445,0,0,70,70,0,1,0,1,0,drop,0,1,Known Attack
50663,443,57930,443,7732,3046,4686,22,26,12,10,allow,1,0,Potential Threat
57011,49813,0,0,66,66,0,1,0,1,0,deny,0,1,Known Attack
7105,25174,0,0,66,66,0,1,0,1,0,deny,1,1,High Risk
60370,443,62763,443,6045,1834,4211,21,82,10,11,allow,1,0,Potential Threat
62640,53,62640,53,414,268,146,3,32,2,1,allow,1,0,Potential Threat
21903,443,21903,443,29203,1859,27344,37,18,14,23,allow,1,0,Potential Threat
42338,443,46950,443,4181,998,3183,14,26,7,7,allow,1,0,Potential Threat
51241,445,0,0,66,66,0,1,0,1,0,drop,0,1,Known Attack
42568,443,34410,443,8049,2043,6006,23,360,11,12,allow,1,0,Potential Threat
37802,80,16566,80,1702,1388,314,10,16,5,5,allow,1,0,Potential Threat
49490,443,58298,443,1627,884,743,12,27,6,6,allow,1,0,Potential Threat
64780,53,55734,53,186,95,91,2,31,1,1,allow,0,0,Normal
64796,53,58063,53,184,94,90,2,30,1,1,allow,0,0,Normal
49237,53,48024,53,216,110,106,2,30,1,1,allow,0,0,Normal
63932,63241,5696,63241,436,254,182,7,15,4,3,allow,1,0,Potential Threat
63001,445,0,0,66,66,0,1,0,1,0,drop,0,1,Known Attack
53759,445,0,0,70,70,0,1,0,1,0,drop,0,1,Known Attack
56743,443,40694,443,7789,2275,5514,30,47,16,14,allow,1,0,Potential Threat
51222,35440,0,0,66,66,0,1,0,1,0,deny,0,1,Known Attack
60786,51505,0,0,62,62,0,1,0,1,0,deny,1,1,High Risk
38111,443,61640,443,566856,28278,538578,737,37,351,386,allow,1,0,Potential Threat
42601,443,30864,443,10845900,123386,10722514,8862,139,1081,7781,allow,1,0,Potential Threat
28192,50584,0,0,66,66,0,1,0,1,0,deny,1,1,High Risk
50368,53,63672,53,763,102,661,2,30,1,1,allow,1,0,Potential Threat
64947,445,0,0,70,70,0,1,0,1,0,drop,0,1,Known Attack
50584,6889,8974,6889,166,166,0,1,1200,1,0,allow,1,0,Potential Threat
55607,17820,29778,17820,504,318,186,8,16,5,3,allow,1,0,Potential Threat
63937,53,8865,53,183,94,89,2,30,1,1,allow,0,0,Normal
33545,443,31253,443,9737,3353,6384,27,32,13,14,allow,1,0,Potential Threat
64180,445,0,0,70,70,0,1,0,1,0,drop,0,1,Known Attack
17750,18866,37630,18866,150,150,0,1,1200,1,0,allow,1,0,Potential Threat
62421,445,0,0,70,70,0,1,0,1,0,drop,0,1,Known Attack
49212,53,38007,53,183,94,89,2,29,1,1,allow,0,0,Normal
49418,27015,26473,27015,280,71,209,2,31,1,1,allow,1,0,Potential Threat
54278,445,0,0,66,66,0,1,0,1,0,drop,0,1,Known Attack
64272,53,63528,53,626,190,436,6,60,3,3,allow,1,0,Potential Threat
55834,53,38945,53,184,94,90,2,31,1,1,allow,0,0,Normal
50857,26467,0,0,66,66,0,1,0,1,0,deny,0,1,Known Attack
57075,53,34299,53,212,102,110,2,30,1,1,allow,0,0,Normal
58119,445,0,0,66,66,0,1,0,1,0,drop,0,1,Known Attack
49761,53,14047,53,183,94,89,2,30,1,1,allow,0,0,Normal
62776,62413,0,0,146,146,0,1,0,1,0,deny,1,1,High Risk
57986,443,51773,443,124014,6270,117744,175,27,69,106,allow,1,0,Potential Threat
64726,53,22205,53,231,94,137,2,30,1,1,allow,0,0,Normal
26229,21247,0,0,66,66,0,1,0,1,0,deny,0,1,Known Attack
51837,80,11115,80,242,120,122,5,31,3,2,allow,0,0,Normal
57350,53,37868,53,177,94,83,2,30,1,1,allow,0,0,Normal
49003,53,49003,53,262,106,156,2,32,1,1,allow,0,0,Normal
62104,445,0,0,70,70,0,1,0,1,0,drop,0,1,Known Attack
63893,443,26379,443,3071,804,2267,15,135,7,8,allow,1,0,Potential Threat
64641,53,5011,53,260,102,158,2,30,1,1,allow,0,0,Normal
61514,445,0,0,70,70,0,1,0,1,0,drop,0,1,Known Attack
65166,62413,0,0,66,66,0,1,0,1,0,deny,1,1,High Risk
53063,80,2438,80,2725,1228,1497,24,90,13,11,allow,1,0,Potential Threat
45123,15000,48758,15000,130,70,60,2,6,1,1,allow,1,0,Potential Threat
53403,445,0,0,70,70,0,1,0,1,0,drop,0,1,Known Attack
49177,53,53466,53,735,88,647,2,30,1,1,allow,0,0,Normal
59936,443,17847,443,34167,3638,30529,50,200,23,27,allow,1,0,Potential Threat
35577,443,21477,443,15162,8505,6657,55,197,29,26,allow,1,0,Potential Threat
80,53945,0,0,60,60,0,1,0,1,0,deny,1,1,High Risk
55114,53,53852,53,392,100,292,4,33,2,2,allow,0,0,Normal
57346,53,18432,53,210,110,100,2,29,1,1,allow,0,0,Normal
50985,445,0,0,66,66,0,1,0,1,0,drop,0,1,Known Attack
44854,26467,0,0,62,62,0,1,0,1,0,deny,0,1,Known Attack
58688,53,58261,53,184,78,106,2,30,1,1,allow,0,0,Normal
6666,6001,0,0,60,60,0,1,0,1,0,deny,0,1,Known Attack
37669,443,48889,443,24415,3924,20491,45,48,22,23,allow,1,0,Potential Threat
55394,53,55394,53,197,76,121,2,30,1,1,allow,0,0,Normal
60401,445,0,0,70,70,0,1,0,1,0,drop,0,1,Known Attack
55380,53,60904,53,289,97,192,4,45,2,2,allow,0,0,Normal
50285,445,0,0,70,70,0,1,0,1,0,drop,0,1,Known Attack
57804,445,0,0,70,70,0,1,0,1,0,drop,0,1,Known Attack
50604,443,49840,443,7470,2479,4991,20,135,9,11,allow,1,0,Potential Threat
49416,53,16616,53,185,102,83,2,30,1,1,allow,0,0,Normal
38167,443,36158,443,6150,914,5236,18,16,10,8,allow,1,0,Potential Threat
59468,80,3821,80,1594,1280,314,10,15,5,5,allow,1,0,Potential Threat
55110,445,0,0,66,66,0,1,0,1,0,drop,0,1,Known Attack
54709,445,0,0,66,66,0,1,0,1,0,drop,0,1,Known Attack
52327,445,0,0,70,70,0,1,0,1,0,drop,0,1,Known Attack
55228,445,0,0,66,66,0,1,0,1,0,drop,0,1,Known Attack
45119,15000,61352,15000,130,70,60,2,5,1,1,allow,1,0,Potential Threat
56282,53,56282,53,194,87,107,2,31,1,1,allow,0,0,Normal
61183,445,0,0,70,70,0,1,0,1,0,drop,0,1,Known Attack
50187,443,52959,443,6363,1073,5290,18,38,10,8,allow,1,0,Potential Threat
65263,53,26647,53,356,88,268,4,55,2,2,allow,0,0,Normal
57206,123,21797,123,184,94,90,2,30,1,1,allow,0,0,Normal
59125,445,0,0,66,66,0,1,0,1,0,drop,0,1,Known Attack
58638,5900,0,0,62,62,0,1,0,1,0,deny,0,1,Known Attack
59757,443,13672,443,11663,1141,10522,30,41,14,16,allow,1,0,Potential Threat
58773,445,0,0,66,66,0,1,0,1,0,drop,0,1,Known Attack
65348,53,2839,53,177,94,83,2,30,1,1,allow,0,0,Normal
17781,50265,0,0,62,62,0,1,0,1,0,deny,1,1,High Risk
58779,445,0,0,70,70,0,1,0,1,0,drop,0,1,Known Attack
32971,443,57614,443,300,180,120,4,15,2,2,allow,1,0,Potential Threat
60261,25174,0,0,66,66,0,1,0,1,0,deny,0,1,Known Attack
34454,80,29541,80,2913,633,2280,15,16,8,7,allow,1,0,Potential Threat
65357,53,40859,53,194,102,92,2,29,1,1,allow,0,0,Normal
50132,445,0,0,70,70,0,1,0,1,0,drop,0,1,Known Attack
52461,445,0,0,70,70,0,1,0,1,0,drop,0,1,Known Attack
58011,445,0,0,70,70,0,1,0,1,0,drop,0,1,Known Attack
3478,61463,0,0,164,164,0,1,0,1,0,deny,1,1,High Risk
61293,445,0,0,66,66,0,1,0,1,0,drop,0,1,Known Attack
59312,22,59312,22,327,140,187,4,0,2,2,deny,0,1,Known Attack
2522,64147,0,0,62,62,0,1,0,1,0,deny,1,1,High Risk
59366,35440,0,0,62,62,0,1,0,1,0,deny,0,1,Known Attack
47381,8305,0,0,159,159,0,1,0,1,0,deny,0,1,Known Attack
61462,445,0,0,70,70,0,1,0,1,0,drop,0,1,Known Attack
49296,80,39063,80,1515,481,1034,11,15,6,5,allow,0,0,Normal
49399,53,15486,53,775,102,673,2,30,1,1,allow,0,0,Normal
57275,443,6369,443,22074,3005,19069,58,31,31,27,allow,1,0,Potential Threat
36966,10387,0,0,159,159,0,1,0,1,0,deny,1,1,High Risk
49512,53,53127,53,190,97,93,2,31,1,1,allow,0,0,Normal
38681,15503,0,0,74,74,0,1,0,1,0,deny,0,1,Known Attack
64744,3389,64744,3389,3428,1714,1714,16,33,8,8,allow,1,0,Potential Threat
54976,443,15305,443,10335,2317,8018,24,188,13,11,allow,1,0,Potential Threat
65305,51221,0,0,66,66,0,1,0,1,0,deny,1,1,High Risk
56648,80,59981,80,234,234,0,4,12,4,0,allow,0,0,Normal
31859,33909,0,0,66,66,0,1,0,1,0,deny,0,1,Known Attack
57116,445,0,0,70,70,0,1,0,1,0,drop,0,1,Known Attack
14437,443,4301,443,2589,1443,1146,18,16,8,10,allow,1,0,Potential Threat
64072,53,31241,53,292,110,182,2,30,1,1,allow,0,0,Normal
65463,443,25060,443,92752,4519,88233,105,15,39,66,allow,1,0,Potential Threat
1903,43890,0,0,62,62,0,1,0,1,0,deny,1,1,High Risk
56707,53,58987,53,199,94,105,2,30,1,1,allow,0,0,Normal
56663,443,10408,443,8057,2037,6020,20,15,11,9,allow,1,0,Potential Threat
4427,50584,0,0,62,62,0,1,0,1,0,deny,1,1,High Risk
64935,53,11961,53,186,95,91,2,31,1,1,allow,0,0,Normal
35666,22114,0,0,62,62,0,1,0,1,0,deny,0,1,Known Attack
56587,53,5530,53,184,94,90,2,31,1,1,allow,0,0,Normal
56905,445,0,0,66,66,0,1,0,1,0,drop,0,1,Known Attack
51514,445,0,0,66,66,0,1,0,1,0,drop,0,1,Known Attack
55589,53,33223,53,177,94,83,2,29,1,1,allow,0,0,Normal
65246,53,26370,53,179,94,85,2,30,1,1,allow,0,0,Normal
55722,26192,12187,26192,70,70,0,2,8,2,0,allow,1,0,Potential Threat
49161,53,58630,53,184,102,82,2,30,1,1,allow,0,0,Normal
42213,443,21488,443,4622,926,3696,18,255,10,8,allow,1,0,Potential Threat
10329,7774,0,0,143,143,0,1,0,1,0,deny,1,1,High Risk
56864,53,28207,53,200,102,98,2,30,1,1,allow,0,0,Normal
50098,53,37375,53,199,102,97,2,30,1,1,allow,0,0,Normal
42767,443,1762,443,8995,2498,6497,40,256,19,21,allow,1,0,Potential Threat
41385,53,41385,53,244,98,146,2,34,1,1,allow,0,0,Normal
57987,56125,0,0,90,90,0,1,0,1,0,deny,1,1,High Risk
55388,53,60267,53,170,87,83,2,31,1,1,allow,0,0,Normal
18252,18242,0,0,62,62,0,1,0,1,0,reset-both,0,1,Known Attack
57339,445,0,0,70,70,0,1,0,1,0,drop,0,1,Known Attack
54478,445,0,0,70,70,0,1,0,1,0,drop,0,1,Known Attack
50636,80,12150,80,16521,6496,10025,31,49,16,15,allow,1,0,Potential Threat
35713,443,23137,443,5315,2861,2454,16,135,8,8,allow,1,0,Potential Threat
59424,50265,0,0,70,70,0,1,0,1,0,deny,0,1,Known Attack
51397,445,0,0,70,70,0,1,0,1,0,drop,0,1,Known Attack
51764,33432,6081,33432,70,70,0,1,5,1,0,allow,1,0,Potential Threat
60900,443,51308,443,7426,1877,5549,22,81,13,9,allow,1,0,Potential Threat
7521,20234,0,0,157,157,0,1,0,1,0,deny,1,1,High Risk
58760,445,0,0,70,70,0,1,0,1,0,drop,0,1,Known Attack
15955,48817,0,0,140,140,0,1,0,1,0,deny,1,1,High Risk
64483,53,26683,53,168,86,82,2,31,1,1,allow,0,0,Normal
64502,53,21170,53,199,102,97,2,30,1,1,allow,0,0,Normal
62504,443,1666,443,10385,7051,3334,27,33,15,12,allow,1,0,Potential Threat
52982,25174,0,0,146,146,0,1,0,1,0,deny,1,1,High Risk
56951,53,44679,53,168,86,82,2,29,1,1,allow,0,0,Normal
15266,55783,0,0,145,145,0,1,0,1,0,deny,1,1,High Risk
9234,80,38036,80,318,192,126,6,26,4,2,allow,1,0,Potential Threat
64188,53,49847,53,216,94,122,2,29,1,1,allow,0,0,Normal
59680,445,0,0,66,66,0,1,0,1,0,drop,0,1,Known Attack
49825,53,24008,53,814,110,704,2,29,1,1,allow,0,0,Normal
58316,443,4061,443,7493,1658,5835,22,255,12,10,allow,1,0,Potential Threat
56637,443,17039,443,8865,1819,7046,24,30,14,10,allow,1,0,Potential Threat
60229,443,63895,443,19536,7593,11943,76,151,37,39,allow,1,0,Potential Threat
50467,80,31924,80,197269,14917,182352,254,204,107,147,allow,1,0,Potential Threat
56833,445,0,0,70,70,0,1,0,1,0,drop,0,1,Known Attack
49674,445,0,0,70,70,0,1,0,1,0,drop,0,1,Known Attack
40500,48009,0,0,146,146,0,1,0,1,0,deny,1,1,High Risk
50136,443,32292,443,23193,8487,14706,57,55,28,29,allow,1,0,Potential Threat
56620,53,33976,53,216,110,106,2,31,1,1,allow,0,0,Normal
51760,50584,0,0,66,66,0,1,0,1,0,deny,0,1,Known Attack
11295,40033,39520,40033,213,89,124,4,49,2,2,allow,1,0,Potential Threat
58170,445,0,0,66,66,0,1,0,1,0,drop,0,1,Known Attack
62341,26467,0,0,66,66,0,1,0,1,0,deny,0,1,Known Attack
30960,45752,44974,45752,462,462,0,8,3631,8,0,allow,1,0,Potential Threat
55077,53,49404,53,394,94,300,2,30,1,1,allow,0,0,Normal
9226,57470,0,0,66,66,0,1,0,1,0,deny,1,1,High Risk
8191,51221,0,0,62,62,0,1,0,1,0,deny,1,1,High Risk
63887,80,15748,80,314,192,122,6,15,4,2,allow,0,0,Normal
64403,53,60359,53,198,101,97,2,30,1,1,allow,0,0,Normal
55071,53,28115,53,711,87,624,2,30,1,1,allow,0,0,Normal
38681,15503,0,0,74,74,0,1,0,1,0,deny,0,1,Known Attack
49384,53,2964,53,186,95,91,2,30,1,1,allow,0,0,Normal
56779,53,7300,53,757,98,659,2,30,1,1,allow,0,0,Normal
62892,445,0,0,70,70,0,1,0,1,0,drop,0,1,Known Attack
57330,53,31519,53,228,94,134,2,30,1,1,allow,0,0,Normal
58953,443,9937,443,4051,2587,1464,18,16,9,9,allow,1,0,Potential Threat
62869,445,0,0,66,66,0,1,0,1,0,drop,0,1,Known Attack
52632,443,1395,443,4399,1857,2542,28,136,14,14,allow,1,0,Potential Threat
49889,53,3966,53,310,99,211,4,40,2,2,allow,0,0,Normal
51097,445,0,0,70,70,0,1,0,1,0,drop,0,1,Known Attack
61013,41705,0,0,66,66,0,1,0,1,0,deny,0,1,Known Attack
50334,53,13800,53,216,110,106,2,30,1,1,allow,0,0,Normal
54044,53,15773,53,224,86,138,2,29,1,1,allow,0,0,Normal
56263,53,57350,53,385,134,251,2,31,1,1,allow,0,0,Normal
50012,7000,50012,7000,3132,815,2317,14,16,7,7,allow,1,0,Potential Threat
55704,53,8827,53,177,94,83,2,31,1,1,allow,0,0,Normal
53548,443,53548,443,1386,751,635,15,181,8,7,allow,1,0,Potential Threat
33922,443,8890,443,6084,1842,4242,26,329,14,12,allow,1,0,Potential Threat
9092,26672,0,0,60,60,0,1,0,1,0,deny,1,1,High Risk
51087,445,0,0,70,70,0,1,0,1,0,drop,0,1,Known Attack
60807,40010,25177,40010,316,136,180,6,5,3,3,allow,1,0,Potential Threat
49700,53,14464,53,165,78,87,2,30,1,1,allow,0,0,Normal
7977,25174,0,0,62,62,0,1,0,1,0,deny,1,1,High Risk
53906,443,56748,443,499,425,74,4,0,3,1,allow,0,0,Normal
33611,443,49502,443,9490,1158,8332,24,256,13,11,allow,1,0,Potential Threat
56497,443,18628,443,1343,763,580,14,26,8,6,allow,0,0,Normal
64209,53,25156,53,277,94,183,2,30,1,1,allow,0,0,Normal
63884,53,63884,53,400,257,143,3,33,2,1,allow,1,0,Potential Threat
53336,445,0,0,70,70,0,1,0,1,0,drop,0,1,Known Attack
52219,445,0,0,66,66,0,1,0,1,0,drop,0,1,Known Attack
49312,443,38998,443,3171,2293,878,17,40,10,7,allow,1,0,Potential Threat
16387,24782,0,0,60,60,0,1,0,1,0,deny,0,1,Known Attack
31691,50584,0,0,146,146,0,1,0,1,0,deny,1,1,High Risk
4269,26672,0,0,60,60,0,1,0,1,0,deny,1,1,High Risk
34044,161,0,0,18549,5061,13488,54,30,27,27,allow,1,0,Potential Threat
41803,443,1948,443,11804,4009,7795,41,150,21,20,allow,1,0,Potential Threat
50073,445,0,0,70,70,0,1,0,1,0,drop,0,1,Known Attack
62050,443,56297,443,7955,2503,5452,33,16,19,14,allow,1,0,Potential Threat
5223,7851,0,0,66,66,0,1,0,1,0,deny,0,1,Known Attack
50483,443,61825,443,12462,2612,9850,37,80,19,18,allow,1,0,Potential Threat
61218,445,0,0,70,70,0,1,0,1,0,drop,0,1,Known Attack
50604,443,64927,443,1385,783,602,14,23,8,6,allow,1,0,Potential Threat
10192,25174,0,0,66,66,0,1,0,1,0,deny,0,1,Known Attack
52111,53162,33838,53162,1330,706,624,10,33,6,4,allow,1,0,Potential Threat
60875,50584,0,0,62,62,0,1,0,1,0,deny,1,1,High Risk
53936,443,5510,443,886,70,816,14,166,2,12,allow,1,0,Potential Threat
43814,34476,0,0,146,146,0,1,0,1,0,deny,1,1,High Risk
62532,57354,0,0,159,159,0,1,0,1,0,deny,1,1,High Risk
39802,80,39802,80,424,198,226,7,142,4,3,allow,1,0,Potential Threat
45964,5333,0,0,60,60,0,1,0,1,0,deny,0,1,Known Attack
50552,445,0,0,70,70,0,1,0,1,0,drop,0,1,Known Attack
8893,123,39834,123,94,94,0,1,30,1,0,allow,1,0,Potential Threat
64641,445,0,0,70,70,0,1,0,1,0,drop,0,1,Known Attack
54998,53,33990,53,179,94,85,2,30,1,1,allow,0,0,Normal
55678,445,0,0,66,66,0,1,0,1,0,drop,0,1,Known Attack
61916,64097,0,0,62,62,0,1,0,1,0,deny,1,1,High Risk
54855,445,0,0,66,66,0,1,0,1,0,drop,0,1,Known Attack
52348,445,0,0,70,70,0,1,0,1,0,drop,0,1,Known Attack
59946,443,42319,443,11836,3531,8305,37,121,19,18,allow,1,0,Potential Threat
58564,50432,0,0,66,66,0,1,0,1,0,deny,0,1,Known Attack
18517,31652,0,0,62,62,0,1,0,1,0,reset-both,1,1,High Risk
61347,443,30207,443,5589,2260,3329,36,217,17,19,allow,1,0,Potential Threat
50943,445,0,0,70,70,0,1,0,1,0,drop,0,1,Known Attack
53105,42707,0,0,66,66,0,1,0,1,0,deny,0,1,Known Attack
49676,53,9085,53,200,94,106,2,30,1,1,allow,0,0,Normal
57613,42707,0,0,66,66,0,1,0,1,0,deny,0,1,Known Attack
30574,64147,0,0,62,62,0,1,0,1,0,deny,1,1,High Risk
42298,40042,19672,40042,148,86,62,2,30,1,1,allow,1,0,Potential Threat
51159,443,36632,443,6405463,157088,6248375,6383,90,2146,4237,allow,1,0,Potential Threat
61524,445,0,0,70,70,0,1,0,1,0,drop,0,1,Known Attack
16319,44847,0,0,62,62,0,1,0,1,0,deny,1,1,High Risk
57803,445,0,0,70,70,0,1,0,1,0,drop,0,1,Known Attack
27005,27018,42247,27018,881,126,755,2,30,1,1,allow,1,0,Potential Threat
37647,36237,0,0,66,66,0,1,0,1,0,deny,0,1,Known Attack
57906,80,15891,80,318,192,126,6,26,4,2,allow,0,0,Normal
49525,445,0,0,70,70,0,1,0,1,0,drop,0,1,Known Attack
53889,445,0,0,70,70,0,1,0,1,0,drop,0,1,Known Attack
63205,9571,0,0,66,66,0,1,0,1,0,deny,0,1,Known Attack
63599,445,0,0,66,66,0,1,0,1,0,drop,0,1,Known Attack
49830,443,7649,443,6131,1960,4171,18,15,10,8,allow,1,0,Potential Threat
63741,50584,0,0,66,66,0,1,0,1,0,deny,1,1,High Risk
14331,23,0,0,60,60,0,1,0,1,0,deny,0,1,Known Attack
27063,25174,0,0,62,62,0,1,0,1,0,deny,0,1,Known Attack
49823,53,8034,53,209,110,99,2,29,1,1,allow,0,0,Normal
57109,53,37634,53,168,86,82,2,31,1,1,allow,0,0,Normal
10916,44847,0,0,66,66,0,1,0,1,0,deny,1,1,High Risk
65520,443,22541,443,438102,12780,425322,449,15,157,292,allow,1,0,Potential Threat
62245,445,0,0,70,70,0,1,0,1,0,drop,0,1,Known Attack
50383,445,0,0,70,70,0,1,0,1,0,drop,0,1,Known Attack
53791,16881,2744,16881,70,70,0,1,5,1,0,allow,1,0,Potential Threat
56388,22114,0,0,66,66,0,1,0,1,0,deny,0,1,Known Attack
47196,443,63403,443,2701330,44089,2657241,2230,134,296,1934,allow,1,0,Potential Threat
48817,23456,48817,23456,485,158,327,2,1200,1,1,allow,1,0,Potential Threat
56268,53,23212,53,210,102,108,2,30,1,1,allow,0,0,Normal
65000,53,40784,53,168,86,82,2,30,1,1,allow,0,0,Normal
53263,443,23949,443,11175,1078,10097,25,41,11,14,allow,1,0,Potential Threat
50543,445,0,0,66,66,0,1,0,1,0,drop,0,1,Known Attack
57225,53,63764,53,177,94,83,2,30,1,1,allow,1,0,Potential Threat
65067,53,22984,53,327,102,225,2,30,1,1,allow,0,0,Normal
49608,53,36244,53,177,94,83,2,31,1,1,allow,0,0,Normal
57639,80,57639,80,104868,1493,103375,90,31,17,73,allow,1,0,Potential Threat
51756,64147,0,0,62,62,0,1,0,1,0,deny,1,1,High Risk
17916,23,0,0,60,60,0,1,0,1,0,deny,0,1,Known Attack
46415,53,46415,53,211,80,131,2,30,1,1,allow,0,0,Normal
14360,64147,0,0,62,62,0,1,0,1,0,deny,1,1,High Risk
56328,36237,0,0,66,66,0,1,0,1,0,deny,0,1,Known Attack
51164,64147,0,0,62,62,0,1,0,1,0,deny,1,1,High Risk
52412,445,0,0,66,66,0,1,0,1,0,drop,0,1,Known Attack
64714,53,29165,53,168,86,82,2,32,1,1,allow,0,0,Normal
53797,53,41009,53,260,86,174,2,30,1,1,allow,0,0,Normal
51766,80,8995,80,2190,1284,906,13,74,8,5,allow,1,0,Potential Threat
56945,53,11659,53,180,94,86,2,30,1,1,allow,0,0,Normal
51329,445,0,0,70,70,0,1,0,1,0,drop,0,1,Known Attack
50337,443,21907,443,9653,1740,7913,23,81,12,11,allow,1,0,Potential Threat
64619,53,61367,53,438,89,349,4,44,2,2,allow,1,0,Potential Threat
25054,36827,0,0,66,66,0,1,0,1,0,deny,1,1,High Risk
43840,50265,0,0,72,72,0,1,0,1,0,deny,0,1,Known Attack
49328,445,0,0,70,70,0,1,0,1,0,drop,0,1,Known Attack
60166,53,7820,53,258,94,164,2,30,1,1,allow,0,0,Normal
61420,64097,0,0,66,66,0,1,0,1,0,deny,1,1,High Risk
56308,443,13053,443,1622,1137,485,11,26,7,4,allow,0,0,Normal
57604,32480,0,0,62,62,0,1,0,1,0,deny,0,1,Known Attack
49323,53,50782,53,210,110,100,2,29,1,1,allow,0,0,Normal
56984,53,20901,53,199,102,97,2,29,1,1,allow,0,0,Normal
59582,443,37348,443,22106,5214,16892,23,127,9,14,allow,1,0,Potential Threat
56667,80,26674,80,234,234,0,4,12,4,0,allow,0,0,Normal
51423,445,0,0,66,66,0,1,0,1,0,drop,0,1,Known Attack
58265,445,0,0,70,70,0,1,0,1,0,drop,0,1,Known Attack
49646,445,0,0,70,70,0,1,0,1,0,drop,0,1,Known Attack
58153,445,0,0,70,70,0,1,0,1,0,drop,0,1,Known Attack
63459,445,0,0,66,66,0,1,0,1,0,drop,0,1,Known Attack
58638,5900,0,0,62,62,0,1,0,1,0,deny,0,1,Known Attack
64816,53,50363,53,166,86,80,2,30,1,1,allow,0,0,Normal
34367,443,31324,443,25205,2243,22962,41,149,17,24,allow,1,0,Potential Threat
26900,27017,30170,27017,422,164,258,6,30,3,3,allow,1,0,Potential Threat
62029,36237,0,0,66,66,0,1,0,1,0,deny,0,1,Known Attack
38700,443,53165,443,40207,7892,32315,59,152,23,36,allow,1,0,Potential Threat
49593,445,0,0,70,70,0,1,0,1,0,drop,0,1,Known Attack
65342,53,40557,53,183,94,89,2,30,1,1,allow,0,0,Normal
64198,53,39637,53,321,102,219,2,30,1,1,allow,0,0,Normal
18837,53,18837,53,233,90,143,2,32,1,1,allow,0,0,Normal
37983,443,26799,443,15668921,169545,15499376,12539,161,1284,11255,allow,1,0,Potential Threat
64025,53,10807,53,199,94,105,2,30,1,1,allow,0,0,Normal
59201,51221,0,0,66,66,0,1,0,1,0,deny,0,1,Known Attack
59407,443,59407,443,4736,1829,2907,19,29,11,8,allow,1,0,Potential Threat
65364,53,50447,53,226,110,116,2,29,1,1,allow,0,0,Normal
11552,44847,0,0,146,146,0,1,0,1,0,deny,1,1,High Risk
45628,80,45628,80,1243,530,713,10,20,5,5,allow,1,0,Potential Threat
49728,443,15564,443,7626,1676,5950,29,63,10,19,allow,1,0,Potential Threat
64685,53,15480,53,199,102,97,2,30,1,1,allow,0,0,Normal
56777,53,34621,53,210,94,116,2,30,1,1,allow,0,0,Normal
52905,445,0,0,66,66,0,1,0,1,0,drop,0,1,Known Attack
42135,443,55299,443,6531,1249,5282,24,286,13,11,allow,1,0,Potential Threat
65253,53,8346,53,766,102,664,2,30,1,1,allow,0,0,Normal
60245,445,0,0,66,66,0,1,0,1,0,drop,0,1,Known Attack
57166,53,52593,53,177,94,83,2,30,1,1,allow,0,0,Normal
49520,445,0,0,70,70,0,1,0,1,0,drop,0,1,Known Attack
61674,443,44305,443,6117,1224,4893,21,50,12,9,allow,1,0,Potential Threat
55101,445,0,0,70,70,0,1,0,1,0,drop,0,1,Known Attack
42366,57470,0,0,66,66,0,1,0,1,0,deny,0,1,Known Attack
37959,3855,0,0,72,72,0,1,0,1,0,deny,0,1,Known Attack
49546,443,3244,443,5519,945,4574,15,23,8,7,allow,1,0,Potential Threat
49685,445,0,0,70,70,0,1,0,1,0,drop,0,1,Known Attack
56654,53,7307,53,209,110,99,2,30,1,1,allow,0,0,Normal
57607,21247,0,0,66,66,0,1,0,1,0,deny,0,1,Known Attack
53858,53,53858,53,832,106,726,2,30,1,1,allow,0,0,Normal
49325,443,64992,443,6141,949,5192,17,21,9,8,allow,1,0,Potential Threat
46495,4607,0,0,60,60,0,1,0,1,0,deny,0,1,Known Attack
55413,53,7034,53,779,86,693,2,30,1,1,allow,0,0,Normal
59842,62413,0,0,66,66,0,1,0,1,0,deny,1,1,High Risk
57470,52339,38751,52339,594,594,0,10,1199,10,0,allow,1,0,Potential Threat
37522,22114,0,0,62,62,0,1,0,1,0,deny,0,1,Known Attack
54352,443,22800,443,6854,2318,4536,20,16,11,9,allow,1,0,Potential Threat
53108,445,0,0,70,70,0,1,0,1,0,drop,0,1,Known Attack
53550,1,56985,1,70,70,0,2,8,2,0,allow,0,0,Normal
443,28417,0,0,82,82,0,1,0,1,0,deny,1,1,High Risk
1925,53,9734,53,210,78,132,2,30,1,1,allow,1,0,Potential Threat
50563,37965,0,0,66,66,0,1,0,1,0,deny,0,1,Known Attack
53469,36237,0,0,62,62,0,1,0,1,0,deny,0,1,Known Attack
56396,53,42377,53,183,94,89,2,30,1,1,allow,0,0,Normal
6666,8443,0,0,60,60,0,1,0,1,0,deny,0,1,Known Attack
61483,443,51261,443,107901,5004,102897,127,46,53,74,allow,1,0,Potential Threat
36068,80,51482,80,41269,2915,38354,62,33,32,30,allow,1,0,Potential Threat
56571,53,30480,53,749,94,655,2,31,1,1,allow,0,0,Normal
45941,23386,0,0,60,60,0,1,0,1,0,deny,0,1,Known Attack
56674,443,42391,443,7889,1900,5989,20,15,11,9,allow,1,0,Potential Threat
64618,53,13340,53,410,102,308,2,29,1,1,allow,0,0,Normal
5223,14446,0,0,66,66,0,1,0,1,0,deny,1,1,High Risk
28897,35440,0,0,66,66,0,1,0,1,0,deny,0,1,Known Attack
3478,61463,0,0,1302,1302,0,1,0,1,0,deny,1,1,High Risk
57172,17,0,0,60,60,0,1,0,1,0,deny,0,1,Known Attack
54201,445,0,0,70,70,0,1,0,1,0,drop,0,1,Known Attack
63010,53,14322,53,304,86,218,2,29,1,1,allow,0,0,Normal
48894,53,34771,53,164,78,86,2,31,1,1,allow,0,0,Normal
50584,12754,22956,12754,161,161,0,2,1200,2,0,allow,1,0,Potential Threat
56005,445,0,0,70,70,0,1,0,1,0,drop,0,1,Known Attack
9295,443,22317,443,3837,488,3349,15,15,7,8,allow,1,0,Potential Threat
50635,443,12337,443,8252,1702,6550,26,72,13,13,allow,1,0,Potential Threat
49780,80,65003,80,1429,931,498,10,126,6,4,allow,1,0,Potential Threat
56963,445,0,0,66,66,0,1,0,1,0,drop,0,1,Known Attack
53982,24226,55007,24226,70,70,0,1,4,1,0,allow,1,0,Potential Threat
55489,53,44022,53,185,102,83,2,30,1,1,allow,0,0,Normal
57031,53,13224,53,711,87,624,2,30,1,1,allow,0,0,Normal
62463,443,34613,443,4203,2748,1455,18,33,10,8,allow,1,0,Potential Threat
56469,445,0,0,70,70,0,1,0,1,0,drop,0,1,Known Attack
16393,22114,0,0,66,66,0,1,0,1,0,deny,0,1,Known Attack
55081,443,63191,443,19866,7188,12678,18,151,7,11,allow,1,0,Potential Threat
45964,7778,0,0,60,60,0,1,0,1,0,deny,0,1,Known Attack
9464,443,61543,443,9340,5582,3758,36,38,21,15,allow,1,0,Potential Threat
4607,6004,0,0,70,70,0,1,0,1,0,deny,1,1,High Risk
51314,445,0,0,66,66,0,1,0,1,0,drop,0,1,Known Attack
64980,53,40885,53,274,88,186,4,35,2,2,allow,0,0,Normal
43184,80,44137,80,1972,1464,508,15,16,7,8,allow,1,0,Potential Threat
30797,23,0,0,60,60,0,1,0,1,0,deny,0,1,Known Attack
52075,37919,58563,37919,70,70,0,2,8,2,0,allow,1,0,Potential Threat
53859,34334,7486,34334,492,306,186,8,14,5,3,allow,1,0,Potential Threat
57259,53,43490,53,167,86,81,2,29,1,1,allow,0,0,Normal
57894,80,58107,80,9800,2228,7572,23,24,12,11,allow,1,0,Potential Threat
57999,445,0,0,70,70,0,1,0,1,0,drop,0,1,Known Attack
13235,44847,0,0,66,66,0,1,0,1,0,deny,1,1,High Risk
56624,53,53106,53,259,118,141,2,29,1,1,allow,0,0,Normal
52072,443,62613,443,7737,6531,1206,21,16,12,9,allow,1,0,Potential Threat
51610,445,0,0,70,70,0,1,0,1,0,drop,0,1,Known Attack
50870,5228,4125,5228,7069,1804,5265,20,3602,11,9,allow,1,0,Potential Threat
36194,443,29201,443,5674,1556,4118,23,271,13,10,allow,1,0,Potential Threat
3195,53,3195,53,197,90,107,2,29,1,1,allow,1,0,Potential Threat
64312,53,19518,53,209,110,99,2,30,1,1,allow,0,0,Normal
12614,22,0,0,60,60,0,1,0,1,0,deny,0,1,Known Attack
56849,23745,4233,23745,70,70,0,2,8,2,0,allow,1,0,Potential Threat
38603,5228,52662,5228,3534,1679,1855,30,3640,11,19,allow,1,0,Potential Threat
55482,53,16639,53,822,102,720,2,30,1,1,allow,0,0,Normal
51836,445,0,0,70,70,0,1,0,1,0,drop,0,1,Known Attack
56745,53,50042,53,900,110,790,2,30,1,1,allow,0,0,Normal
50239,53,39194,53,183,94,89,2,30,1,1,allow,0,0,Normal
6881,6881,9262,6881,501,150,351,2,1200,1,1,allow,1,0,Potential Threat
33886,65504,0,0,162,162,0,1,0,1,0,deny,1,1,High Risk
55638,53,1033,53,78,78,0,1,30,1,0,allow,0,0,Normal
44207,44847,0,0,62,62,0,1,0,1,0,deny,0,1,Known Attack
1054,57470,0,0,62,62,0,1,0,1,0,deny,1,1,High Risk
49840,53,47224,53,463,87,376,4,38,2,2,allow,0,0,Normal
57343,445,0,0,70,70,0,1,0,1,0,drop,0,1,Known Attack
11112,43890,0,0,66,66,0,1,0,1,0,deny,1,1,High Risk
43398,25604,0,0,146,146,0,1,0,1,0,deny,1,1,High Risk
63992,53,19496,53,199,102,97,2,30,1,1,allow,0,0,Normal
49539,80,49460,80,378,192,186,7,42,4,3,allow,0,0,Normal
52075,445,0,0,70,70,0,1,0,1,0,drop,0,1,Known Attack
58754,53,0,0,258,80,178,2,30,1,1,allow,0,0,Normal
50544,445,0,0,66,66,0,1,0,1,0,drop,0,1,Known Attack
35078,443,15189,443,7222,1768,5454,22,81,13,9,allow,1,0,Potential Threat
53187,443,36781,443,5244,1925,3319,33,21,17,16,allow,1,0,Potential Threat
60900,445,0,0,66,66,0,1,0,1,0,drop,0,1,Known Attack
49941,53,58431,53,193,102,91,2,30,1,1,allow,0,0,Normal
59809,443,46540,443,35140,3700,31440,67,76,30,37,allow,1,0,Potential Threat
65208,53,46888,53,637,178,459,6,70,3,3,allow,1,0,Potential Threat
59339,445,0,0,66,66,0,1,0,1,0,drop,0,1,Known Attack
55713,25174,0,0,62,62,0,1,0,1,0,deny,0,1,Known Attack
51926,58664,64074,58664,70,70,0,1,5,1,0,allow,1,0,Potential Threat
61533,445,0,0,70,70,0,1,0,1,0,drop,0,1,Known Attack
63447,44847,0,0,66,66,0,1,0,1,0,deny,1,1,High Risk
56824,3389,56824,3389,3910,1805,2105,20,18,12,8,allow,1,0,Potential Threat
63141,445,0,0,70,70,0,1,0,1,0,drop,0,1,Known Attack
64217,53,31853,53,193,102,91,2,29,1,1,allow,0,0,Normal
58638,5900,0,0,62,62,0,1,0,1,0,deny,0,1,Known Attack
57091,445,0,0,66,66,0,1,0,1,0,drop,0,1,Known Attack
54706,443,10559,443,5612,1051,4561,20,16,11,9,allow,1,0,Potential Threat
65233,23117,0,0,66,66,0,1,0,1,0,deny,0,1,Known Attack
53156,57780,14557,57780,320,140,180,6,7,3,3,allow,1,0,Potential Threat
65526,28793,0,0,66,66,0,1,0,1,0,deny,0,1,Known Attack
56100,53,62385,53,211,102,109,2,30,1,1,allow,0,0,Normal
65097,53,14229,53,718,94,624,2,30,1,1,allow,0,0,Normal
64814,53,26949,53,165,86,79,2,31,1,1,allow,0,0,Normal
15176,62413,0,0,66,66,0,1,0,1,0,deny,1,1,High Risk
61911,1,0,0,146,146,0,1,0,1,0,deny,0,1,Known Attack
62678,57470,0,0,62,62,0,1,0,1,0,deny,1,1,High Risk
61404,445,0,0,70,70,0,1,0,1,0,drop,0,1,Known Attack
63741,36776,9191,36776,70,70,0,1,4,1,0,allow,1,0,Potential Threat
62065,443,18237,443,21959,8954,13005,65,63,33,32,allow,1,0,Potential Threat
14255,2767,0,0,146,146,0,1,0,1,0,deny,0,1,Known Attack
51953,37965,0,0,66,66,0,1,0,1,0,deny,0,1,Known Attack
49717,443,12194,443,20576,8959,11617,42,130,24,18,allow,1,0,Potential Threat
55196,53,52555,53,711,87,624,2,30,1,1,allow,0,0,Normal
51023,443,24793,443,26189,8238,17951,72,18,39,33,allow,1,0,Potential Threat
59942,80,31955,80,2241,1549,692,9,15,5,4,allow,1,0,Potential Threat
55590,53,49633,53,177,94,83,2,29,1,1,allow,0,0,Normal
10914,35974,0,0,60,60,0,1,0,1,0,deny,1,1,High Risk
35341,443,55051,443,1473,988,485,12,26,7,5,allow,1,0,Potential Threat
63197,445,0,0,66,66,0,1,0,1,0,drop,0,1,Known Attack
54126,443,11328,443,147104,9481,137623,217,115,111,106,allow,1,0,Potential Threat
58765,443,24675,443,26158,17265,8893,57,19,31,26,allow,1,0,Potential Threat
53754,25306,12188,25306,70,70,0,2,8,2,0,allow,1,0,Potential Threat
51508,443,54920,443,98292,24468,73824,179,52,81,98,allow,1,0,Potential Threat
62497,445,0,0,70,70,0,1,0,1,0,drop,0,1,Known Attack
30580,50265,0,0,66,66,0,1,0,1,0,deny,0,1,Known Attack
50097,445,0,0,70,70,0,1,0,1,0,drop,0,1,Known Attack
49905,53,31462,53,180,94,86,2,29,1,1,allow,0,0,Normal
62081,443,56055,443,3044,1694,1350,23,45,13,10,allow,1,0,Potential Threat
34932,38608,0,0,62,62,0,1,0,1,0,deny,0,1,Known Attack
51733,30688,11073,30688,70,70,0,1,4,1,0,allow,1,0,Potential Threat
0,0,0,0,98,98,0,1,0,1,0,deny,1,1,High Risk
7539,30317,0,0,62,62,0,1,0,1,0,deny,1,1,High Risk
11786,53,11786,53,194,87,107,2,30,1,1,allow,0,0,Normal
63984,25174,0,0,62,62,0,1,0,1,0,deny,0,1,Known Attack
50562,445,0,0,66,66,0,1,0,1,0,drop,0,1,Known Attack
56424,53,8677,53,177,94,83,2,29,1,1,allow,0,0,Normal
52060,443,18866,443,40726,3421,37305,52,121,20,32,allow,1,0,Potential Threat
57470,8999,31471,8999,1577,594,983,20,1614,10,10,allow,1,0,Potential Threat
42865,55839,0,0,137,137,0,1,0,1,0,deny,1,1,High Risk
49615,53,9854,53,276,94,182,2,30,1,1,allow,0,0,Normal
56673,53,10759,53,193,102,91,2,30,1,1,allow,0,0,Normal
38664,37965,0,0,62,62,0,1,0,1,0,deny,0,1,Known Attack
56009,53,38515,53,178,94,84,2,30,1,1,allow,0,0,Normal
49742,53,51185,53,216,110,106,2,30,1,1,allow,0,0,Normal
18224,23,0,0,60,60,0,1,0,1,0,deny,0,1,Known Attack
33070,80,34842,80,3483,1578,1905,17,186,10,7,allow,1,0,Potential Threat
52564,15503,0,0,74,74,0,1,0,1,0,deny,0,1,Known Attack
55339,443,4853,443,2552065,30474,2521591,2074,129,236,1838,allow,1,0,Potential Threat
63614,445,0,0,70,70,0,1,0,1,0,drop,0,1,Known Attack
55940,445,0,0,66,66,0,1,0,1,0,drop,0,1,Known Attack
53875,43611,37582,43611,70,70,0,1,5,1,0,allow,1,0,Potential Threat
60446,6882,2486,6882,70,70,0,2,8,2,0,allow,1,0,Potential Threat
443,48346,0,0,81,81,0,1,0,1,0,deny,1,1,High Risk
53630,64745,62898,64745,70,70,0,2,7,2,0,allow,1,0,Potential Threat
24949,47563,0,0,145,145,0,1,0,1,0,deny,1,1,High Risk
51731,39392,6820,39392,70,70,0,2,8,2,0,allow,1,0,Potential Threat
49730,445,0,0,70,70,0,1,0,1,0,drop,0,1,Known Attack
64698,53,15508,53,763,102,661,2,30,1,1,allow,0,0,Normal
55868,53,39236,53,458,188,270,6,29,3,3,allow,0,0,Normal
443,29326,0,0,82,82,0,1,0,1,0,deny,1,1,High Risk
50031,53,40045,53,181,94,87,2,30,1,1,allow,0,0,Normal
49597,53,63650,53,168,86,82,2,31,1,1,allow,1,0,Potential Threat
57588,53,31636,53,165,78,87,2,30,1,1,allow,0,0,Normal
52126,80,5898,80,3592,2098,1494,26,417,14,12,allow,1,0,Potential Threat
56225,53,16256,53,188,96,92,2,30,1,1,allow,0,0,Normal
55554,22114,0,0,146,146,0,1,0,1,0,deny,1,1,High Risk
21133,33447,47731,33447,481,150,331,2,1199,1,1,allow,1,0,Potential Threat
33990,443,59264,443,11404,1948,9456,30,81,15,15,allow,1,0,Potential Threat
57216,445,0,0,70,70,0,1,0,1,0,drop,0,1,Known Attack
61467,445,0,0,66,66,0,1,0,1,0,drop,0,1,Known Attack
49722,53,29083,53,215,94,121,2,30,1,1,allow,0,0,Normal
49790,53,51287,53,195,102,93,2,30,1,1,allow,0,0,Normal
58577,445,0,0,70,70,0,1,0,1,0,drop,0,1,Known Attack
63379,36237,0,0,66,66,0,1,0,1,0,deny,0,1,Known Attack
50994,35974,0,0,60,60,0,1,0,1,0,deny,0,1,Known Attack
43391,80,44561,80,1560,684,876,10,15,5,5,allow,1,0,Potential Threat
27005,33086,33799,33086,877,126,751,2,30,1,1,allow,1,0,Potential Threat
49250,53,62470,53,298,87,211,4,48,2,2,allow,1,0,Potential Threat
55533,53,56018,53,182,93,89,2,31,1,1,allow,0,0,Normal
2049,32480,0,0,66,66,0,1,0,1,0,deny,1,1,High Risk
61660,64097,0,0,62,62,0,1,0,1,0,deny,1,1,High Risk
55203,445,0,0,70,70,0,1,0,1,0,drop,0,1,Known Attack
57907,53,57907,53,228,97,131,2,31,1,1,allow,0,0,Normal
57885,445,0,0,70,70,0,1,0,1,0,drop,0,1,Known Attack
53799,6881,35241,6881,70,70,0,2,7,2,0,allow,1,0,Potential Threat
38592,57209,0,0,62,62,0,1,0,1,0,deny,1,1,High Risk
50896,80,56677,80,11459959,142694,11317265,9719,135,1994,7725,allow,1,0,Potential Threat
51575,445,0,0,66,66,0,1,0,1,0,drop,0,1,Known Attack
55716,445,0,0,70,70,0,1,0,1,0,drop,0,1,Known Attack
53470,22114,0,0,66,66,0,1,0,1,0,deny,0,1,Known Attack
49791,53,6212,53,777,87,690,2,30,1,1,allow,0,0,Normal
35849,30188,0,0,62,62,0,1,0,1,0,deny,0,1,Known Attack
0,0,0,0,60,60,0,1,0,1,0,deny,1,1,High Risk
58638,5900,0,0,62,62,0,1,0,1,0,deny,0,1,Known Attack
51752,31677,14033,31677,70,70,0,1,5,1,0,allow,1,0,Potential Threat
50226,445,0,0,70,70,0,1,0,1,0,drop,0,1,Known Attack
53214,443,52186,443,526,156,370,8,14,3,5,allow,0,0,Normal
64560,53,40808,53,578,179,399,6,56,3,3,allow,1,0,Potential Threat
23310,22114,0,0,66,66,0,1,0,1,0,deny,0,1,Known Attack
27005,32038,32589,32038,868,126,742,2,31,1,1,allow,1,0,Potential Threat
51448,80,39374,80,214,140,74,4,15,3,1,allow,0,0,Normal
3802,55777,0,0,66,66,0,1,0,1,0,deny,1,1,High Risk
62915,993,36226,993,8257,4187,4070,70,43,42,28,allow,1,0,Potential Threat
50629,443,10461,443,1048,1048,0,9,17,9,0,allow,1,0,Potential Threat
65146,53,65321,53,335,102,233,2,30,1,1,allow,1,0,Potential Threat
58638,5900,58638,5900,62,62,0,1,5,1,0,allow,1,0,Potential Threat
45964,55559,0,0,60,60,0,1,0,1,0,deny,1,1,High Risk
52957,445,0,0,70,70,0,1,0,1,0,drop,0,1,Known Attack
38820,80,32872,80,1150,613,537,10,16,6,4,allow,0,0,Normal
50019,445,0,0,66,66,0,1,0,1,0,drop,0,1,Known Attack
56948,443,19472,443,5601,1203,4398,14,59,9,5,allow,1,0,Potential Threat
5588,5588,0,0,3354,1792,1562,46,195,23,23,allow,1,0,Potential Threat
57357,53,10860,53,231,94,137,2,30,1,1,allow,0,0,Normal
61691,445,0,0,70,70,0,1,0,1,0,drop,0,1,Known Attack
60786,25174,0,0,66,66,0,1,0,1,0,deny,0,1,Known Attack
64742,445,0,0,66,66,0,1,0,1,0,drop,0,1,Known Attack
52459,5555,0,0,60,60,0,1,0,1,0,deny,0,1,Known Attack
56706,443,32876,443,8057,2037,6020,20,15,11,9,allow,1,0,Potential Threat
63715,445,0,0,66,66,0,1,0,1,0,drop,0,1,Known Attack
59724,445,0,0,66,66,0,1,0,1,0,drop,0,1,Known Attack
14950,53,14950,53,414,268,146,3,32,2,1,allow,1,0,Potential Threat
61229,53,16392,53,261,261,0,4,47,4,0,allow,0,0,Normal
52765,443,14674,443,283,163,120,4,16,2,2,allow,0,0,Normal
40204,40021,21562,40021,148,86,62,2,31,1,1,allow,1,0,Potential Threat
58550,445,0,0,66,66,0,1,0,1,0,drop,0,1,Known Attack
31130,30188,0,0,66,66,0,1,0,1,0,deny,0,1,Known Attack
49941,53,57941,53,193,102,91,2,31,1,1,allow,0,0,Normal
57610,443,60687,443,4327,674,3653,14,25,8,6,allow,1,0,Potential Threat
56292,53,41121,53,194,99,95,2,30,1,1,allow,0,0,Normal
29697,51221,0,0,62,62,0,1,0,1,0,deny,1,1,High Risk
56879,445,0,0,70,70,0,1,0,1,0,drop,0,1,Known Attack
39313,37965,0,0,62,62,0,1,0,1,0,deny,0,1,Known Attack
50975,445,0,0,70,70,0,1,0,1,0,drop,0,1,Known Attack
62373,445,0,0,70,70,0,1,0,1,0,drop,0,1,Known Attack
63089,53,1694,53,512,166,346,2,30,1,1,allow,0,0,Normal
41093,53,34774,53,78,78,0,1,30,1,0,allow,0,0,Normal
49758,443,14307,443,17412,6917,10495,38,63,20,18,allow,1,0,Potential Threat
61465,22114,0,0,62,62,0,1,0,1,0,deny,0,1,Known Attack
60138,445,0,0,70,70,0,1,0,1,0,drop,0,1,Known Attack
50497,80,3021,80,19946,10573,9373,29,25,14,15,allow,1,0,Potential Threat
5588,5588,0,0,3354,1792,1562,46,192,23,23,allow,1,0,Potential Threat
50374,443,61017,443,8485,1804,6681,30,316,14,16,allow,1,0,Potential Threat
38885,21247,0,0,62,62,0,1,0,1,0,deny,0,1,Known Attack
55530,53,3862,53,758,93,665,2,31,1,1,allow,0,0,Normal
55022,53,10600,53,190,97,93,2,31,1,1,allow,0,0,Normal
56757,53,3651,53,783,96,687,2,31,1,1,allow,0,0,Normal
54600,6881,0,0,62,62,0,1,0,1,0,deny,0,1,Known Attack
49449,80,49449,80,416,198,218,7,29,4,3,allow,0,0,Normal
50441,80,50441,80,79227,5480,73747,89,19,32,57,allow,1,0,Potential Threat
54021,445,0,0,66,66,0,1,0,1,0,drop,0,1,Known Attack
63265,445,0,0,70,70,0,1,0,1,0,drop,0,1,Known Attack
54752,445,0,0,70,70,0,1,0,1,0,drop,0,1,Known Attack
27517,23,0,0,60,60,0,1,0,1,0,deny,0,1,Known Attack
61879,53,34841,53,207,86,121,2,29,1,1,allow,0,0,Normal
49262,80,49262,80,515211,10976,504235,506,49,169,337,allow,1,0,Potential Threat
49484,443,58905,443,407843,11895,395948,436,271,157,279,allow,1,0,Potential Threat
64333,57470,0,0,78,78,0,1,0,1,0,deny,1,1,High Risk
43546,443,49269,443,5948,1664,4284,21,247,12,9,allow,1,0,Potential Threat
62832,445,0,0,70,70,0,1,0,1,0,drop,0,1,Known Attack
32974,37965,0,0,66,66,0,1,0,1,0,deny,0,1,Known Attack
57870,7635,57870,7635,138,78,60,2,6,1,1,allow,1,0,Potential Threat
49418,27018,53537,27018,256,78,178,2,30,1,1,allow,1,0,Potential Threat
58051,443,3762,443,8930,1529,7401,21,19,9,12,allow,1,0,Potential Threat
55362,53,23060,53,374,97,277,4,32,2,2,allow,0,0,Normal
10480,26467,0,0,62,62,0,1,0,1,0,deny,0,1,Known Attack
58703,50584,0,0,66,66,0,1,0,1,0,deny,0,1,Known Attack
62344,80,50382,80,1892,583,1309,12,16,6,6,allow,1,0,Potential Threat
54268,445,0,0,70,70,0,1,0,1,0,drop,0,1,Known Attack
35509,3389,35509,3389,4224,2055,2169,22,21,13,9,allow,1,0,Potential Threat
53754,445,0,0,66,66,0,1,0,1,0,drop,0,1,Known Attack
20495,53,20495,53,217,90,127,2,30,1,1,allow,0,0,Normal
53927,443,24116,443,495,421,74,4,0,3,1,allow,0,0,Normal
49174,53,10014,53,323,107,216,4,47,2,2,allow,0,0,Normal
46861,15000,42443,15000,130,70,60,2,5,1,1,allow,1,0,Potential Threat
39571,443,44587,443,580560,15724,564836,583,30,187,396,allow,1,0,Potential Threat
61109,445,0,0,70,70,0,1,0,1,0,drop,0,1,Known Attack
51246,445,0,0,70,70,0,1,0,1,0,drop,0,1,Known Attack
35207,53,52779,53,168,78,90,2,30,1,1,allow,0,0,Normal
53206,443,65067,443,3656,2345,1311,18,17,9,9,allow,1,0,Potential Threat
56543,53,18371,53,756,95,661,2,30,1,1,allow,0,0,Normal
57341,3389,57341,3389,3428,1714,1714,16,33,8,8,allow,1,0,Potential Threat
49418,27017,15205,27017,252,78,174,2,30,1,1,allow,1,0,Potential Threat
51700,7000,51700,7000,2163,676,1487,14,15,7,7,allow,1,0,Potential Threat
53684,25933,35129,25933,552,306,246,9,15,5,4,allow,1,0,Potential Threat
52420,445,0,0,66,66,0,1,0,1,0,drop,0,1,Known Attack
56928,53,11160,53,178,94,84,2,31,1,1,allow,0,0,Normal
55167,445,0,0,70,70,0,1,0,1,0,drop,0,1,Known Attack
64803,80,9867,80,5518,527,4991,13,75,6,7,allow,1,0,Potential Threat
22983,443,22983,443,205941,20753,185188,264,30,129,135,allow,1,0,Potential Threat
52049,80,61901,80,34695,17472,17223,55,33,28,27,allow,1,0,Potential Threat
47103,55378,0,0,146,146,0,1,0,1,0,deny,1,1,High Risk
49790,80,49818,80,1769,1271,498,10,126,6,4,allow,1,0,Potential Threat
34366,443,52089,443,520306,17622,502684,582,210,210,372,allow,1,0,Potential Threat
13795,2323,0,0,60,60,0,1,0,1,0,deny,0,1,Known Attack
52719,445,0,0,70,70,0,1,0,1,0,drop,0,1,Known Attack
55179,53,31015,53,178,94,84,2,30,1,1,allow,0,0,Normal
60374,57470,0,0,145,145,0,1,0,1,0,deny,1,1,High Risk
34484,53,27104,53,86,86,0,1,30,1,0,allow,0,0,Normal
22,51051,22,51051,109,109,0,1,5,1,0,allow,1,0,Potential Threat
64609,53,7620,53,250,86,164,4,30,2,2,allow,0,0,Normal
55083,445,0,0,66,66,0,1,0,1,0,drop,0,1,Known Attack
56569,53,35579,53,199,102,97,2,30,1,1,allow,0,0,Normal
61561,445,0,0,70,70,0,1,0,1,0,drop,0,1,Known Attack
59564,57470,0,0,66,66,0,1,0,1,0,deny,1,1,High Risk
55466,53,2778,53,170,87,83,2,30,1,1,allow,0,0,Normal
49825,445,0,0,70,70,0,1,0,1,0,drop,0,1,Known Attack
61140,27520,0,0,62,62,0,1,0,1,0,deny,0,1,Known Attack
63182,445,0,0,70,70,0,1,0,1,0,drop,0,1,Known Attack
33896,57470,0,0,74,74,0,1,0,1,0,deny,1,1,High Risk
64338,53,55215,53,292,102,190,2,29,1,1,allow,0,0,Normal
59350,443,59350,443,4401,1494,2907,19,27,11,8,allow,1,0,Potential Threat
53971,50265,0,0,62,62,0,1,0,1,0,deny,0,1,Known Attack
39966,53,39966,53,235,90,145,2,32,1,1,allow,0,0,Normal
52017,26175,18735,26175,70,70,0,2,9,2,0,allow,1,0,Potential Threat
55012,443,43376,443,7249,1797,5452,29,32,17,12,allow,1,0,Potential Threat
56906,53,55216,53,167,86,81,2,31,1,1,allow,0,0,Normal
62484,445,0,0,70,70,0,1,0,1,0,drop,0,1,Known Attack
50566,443,50394,443,11116,4583,6533,39,256,19,20,allow,1,0,Potential Threat
64582,445,0,0,70,70,0,1,0,1,0,drop,0,1,Known Attack
56272,53,7235,53,193,102,91,2,30,1,1,allow,0,0,Normal
49361,53,45475,53,184,94,90,2,31,1,1,allow,0,0,Normal
59755,44512,0,0,66,66,0,1,0,1,0,deny,0,1,Known Attack
42479,80,8740,80,696,413,283,7,15,5,2,allow,0,0,Normal
53302,445,0,0,66,66,0,1,0,1,0,drop,0,1,Known Attack
11692,25174,0,0,66,66,0,1,0,1,0,deny,0,1,Known Attack
65322,53,28599,53,395,102,293,2,30,1,1,allow,0,0,Normal
63595,443,51163,443,8062,2186,5876,29,136,15,14,allow,1,0,Potential Threat
50863,445,0,0,66,66,0,1,0,1,0,drop,0,1,Known Attack
64645,53,50507,53,391,96,295,4,49,2,2,allow,0,0,Normal
63041,50584,0,0,62,62,0,1,0,1,0,deny,1,1,High Risk
34990,80,36946,80,1534,996,538,10,35,6,4,allow,1,0,Potential Threat
53124,52917,46926,52917,70,70,0,2,8,2,0,allow,1,0,Potential Threat
58759,445,0,0,70,70,0,1,0,1,0,drop,0,1,Known Attack
55478,445,0,0,70,70,0,1,0,1,0,drop,0,1,Known Attack
35542,23,35542,23,124,60,64,2,5,1,1,allow,0,0,Normal
49578,445,0,0,70,70,0,1,0,1,0,drop,0,1,Known Attack
54078,445,0,0,70,70,0,1,0,1,0,drop,0,1,Known Attack
63787,18318,22110,18318,70,70,0,1,5,1,0,allow,1,0,Potential Threat
58911,443,49541,443,23915,4341,19574,37,120,15,22,allow,1,0,Potential Threat
26835,47993,0,0,62,62,0,1,0,1,0,deny,1,1,High Risk
64092,445,0,0,66,66,0,1,0,1,0,drop,0,1,Known Attack
57967,445,0,0,70,70,0,1,0,1,0,drop,0,1,Known Attack
64797,445,0,0,70,70,0,1,0,1,0,drop,0,1,Known Attack
60378,11385,17333,11385,1218,774,444,17,26,10,7,allow,1,0,Potential Threat
65176,53,65083,53,183,94,89,2,30,1,1,allow,1,0,Potential Threat
61045,445,0,0,70,70,0,1,0,1,0,drop,0,1,Known Attack
49257,53,41185,53,166,86,80,2,30,1,1,allow,0,0,Normal
56458,53,9119,53,196,102,94,2,31,1,1,allow,0,0,Normal
55766,443,53751,443,1864,250,1614,8,120,4,4,allow,1,0,Potential Threat
63992,53,39861,53,199,102,97,2,30,1,1,allow,0,0,Normal
37965,46008,3180,46008,132,132,0,3,1200,3,0,allow,1,0,Potential Threat
35894,17,0,0,60,60,0,1,0,1,0,deny,0,1,Known Attack
52261,53,10393,53,195,94,101,2,29,1,1,allow,0,0,Normal
55850,445,0,0,70,70,0,1,0,1,0,drop,0,1,Known Attack
49297,443,47840,443,5341,3636,1705,30,76,16,14,allow,1,0,Potential Threat
62731,443,62731,443,9938,3644,6294,31,18,18,13,allow,1,0,Potential Threat
0,0,0,0,156,156,0,2,0,2,0,allow,1,1,High Risk
55868,53,29665,53,198,110,88,2,29,1,1,allow,0,0,Normal
49952,53,64431,53,195,102,93,2,29,1,1,allow,1,0,Potential Threat
54942,445,0,0,70,70,0,1,0,1,0,drop,0,1,Known Attack
52385,53,0,0,138,69,69,2,30,1,1,allow,0,0,Normal
10262,11392,0,0,62,62,0,1,0,1,0,deny,0,1,Known Attack
49418,27016,26293,27016,257,71,186,2,30,1,1,allow,1,0,Potential Threat
49888,445,0,0,70,70,0,1,0,1,0,drop,0,1,Known Attack
64968,53,11084,53,87,87,0,1,31,1,0,allow,0,0,Normal
49862,53,52956,53,715,94,621,2,31,1,1,allow,0,0,Normal
55447,53,41152,53,194,102,92,2,30,1,1,allow,0,0,Normal
55417,53,60973,53,198,102,96,2,30,1,1,allow,0,0,Normal
56343,443,34805,443,350,210,140,6,27,4,2,allow,0,0,Normal
49968,445,0,0,70,70,0,1,0,1,0,drop,0,1,Known Attack
58638,5900,0,0,62,62,0,1,0,1,0,deny,0,1,Known Attack
50504,443,47105,443,5476,1073,4403,22,78,12,10,allow,1,0,Potential Threat
9087,37965,0,0,62,62,0,1,0,1,0,deny,1,1,High Risk
64069,53,35417,53,183,86,97,2,29,1,1,allow,0,0,Normal
51308,445,0,0,70,70,0,1,0,1,0,drop,0,1,Known Attack
35570,443,64379,443,3221,705,2516,15,135,7,8,allow,1,0,Potential Threat
55283,443,55908,443,2964,1657,1307,18,47,9,9,allow,1,0,Potential Threat
6889,24748,0,0,143,143,0,1,0,1,0,deny,1,1,High Risk
39287,53,1937,53,198,93,105,2,30,1,1,allow,0,0,Normal
27005,27016,2145,27016,883,126,757,2,30,1,1,allow,1,0,Potential Threat
28557,53,28557,53,213,79,134,2,32,1,1,allow,0,0,Normal
22194,31573,0,0,146,146,0,1,0,1,0,deny,1,1,High Risk
58638,5900,0,0,62,62,0,1,0,1,0,deny,0,1,Known Attack
49106,53,49106,53,1415,689,726,3,30,2,1,allow,0,0,Normal
55437,443,17546,443,6622,859,5763,18,15,10,8,allow,1,0,Potential Threat
59974,443,8585,443,7820,1344,6476,24,16,13,11,allow,1,0,Potential Threat
40742,2967,0,0,62,62,0,1,0,1,0,deny,0,1,Known Attack
37004,80,37004,80,13825,1203,12622,22,29,9,13,allow,1,0,Potential Threat
64980,53,51851,53,180,94,86,2,30,1,1,allow,0,0,Normal
22263,30188,0,0,66,66,0,1,0,1,0,deny,0,1,Known Attack
49512,53,64595,53,210,102,108,2,30,1,1,allow,1,0,Potential Threat
51754,18375,0,0,66,66,0,1,0,1,0,deny,0,1,Known Attack
32729,3389,32729,3389,4021,1916,2105,20,18,12,8,allow,1,0,Potential Threat
39186,443,31509,443,8126,2183,5943,29,270,14,15,allow,1,0,Potential Threat
25150,25174,0,0,62,62,0,1,0,1,0,deny,0,1,Known Attack
49369,53,17790,53,246,94,152,2,30,1,1,allow,0,0,Normal
49496,53,27238,53,194,102,92,2,30,1,1,allow,0,0,Normal
59031,25174,0,0,62,62,0,1,0,1,0,deny,0,1,Known Attack
53464,443,61601,443,6550,1555,4995,25,53,13,12,allow,1,0,Potential Threat
58134,445,0,0,70,70,0,1,0,1,0,drop,0,1,Known Attack
46683,443,34091,443,416,210,206,7,28,4,3,allow,0,0,Normal
64997,51221,0,0,66,66,0,1,0,1,0,deny,1,1,High Risk
61902,22114,0,0,66,66,0,1,0,1,0,deny,0,1,Known Attack
5588,5588,0,0,3354,1792,1562,46,193,23,23,allow,1,0,Potential Threat
56040,53,54233,53,761,100,661,2,30,1,1,allow,0,0,Normal
31748,56205,0,0,62,62,0,1,0,1,0,deny,1,1,High Risk
15442,22114,0,0,66,66,0,1,0,1,0,deny,0,1,Known Attack
57340,443,31175,443,1169,616,553,12,16,7,5,allow,0,0,Normal
55323,53,29422,53,279,94,185,2,30,1,1,allow,0,0,Normal
21519,443,21519,443,14483,1152,13331,27,19,12,15,allow,1,0,Potential Threat
61550,5529,0,0,145,145,0,1,0,1,0,deny,0,1,Known Attack
60305,80,11406,80,4419,3852,567,15,144,8,7,allow,1,0,Potential Threat
62588,57470,0,0,146,146,0,1,0,1,0,deny,1,1,High Risk
443,2629,0,0,135,135,0,1,0,1,0,deny,1,1,High Risk
56769,53,50586,53,195,102,93,2,30,1,1,allow,0,0,Normal
55968,56205,0,0,66,66,0,1,0,1,0,deny,0,1,Known Attack
64382,443,26649,443,4017,978,3039,14,53,8,6,allow,1,0,Potential Threat
59179,53,29104,53,260,86,174,2,30,1,1,allow,0,0,Normal
49912,443,43170,443,2048821,56490,1992331,2082,44,522,1560,allow,1,0,Potential Threat
41325,443,52651,443,9669,2488,7181,26,149,11,15,allow,1,0,Potential Threat
43616,5228,36276,5228,2322,1296,1026,15,3600,6,9,allow,1,0,Potential Threat
4323,64147,0,0,66,66,0,1,0,1,0,deny,1,1,High Risk
26900,27017,12614,27017,422,164,258,6,29,3,3,allow,1,0,Potential Threat
59068,49813,0,0,70,70,0,1,0,1,0,deny,0,1,Known Attack
56577,445,0,0,70,70,0,1,0,1,0,drop,0,1,Known Attack
49352,443,43143,443,2118582,46411,2072171,2066,90,617,1449,allow,1,0,Potential Threat
65461,445,0,0,70,70,0,1,0,1,0,drop,0,1,Known Attack
64425,53,23618,53,289,134,155,2,30,1,1,allow,0,0,Normal
64102,445,0,0,70,70,0,1,0,1,0,drop,0,1,Known Attack
48625,443,29976,443,7605,2028,5577,23,159,11,12,allow,1,0,Potential Threat
56767,53,32268,53,177,94,83,2,30,1,1,allow,0,0,Normal
56586,53,39065,53,177,94,83,2,30,1,1,allow,0,0,Normal
0,0,0,0,320,320,0,5,0,5,0,allow,1,0,Potential Threat
56973,53,9162,53,193,102,91,2,30,1,1,allow,0,0,Normal
49513,53,63183,53,200,102,98,2,29,1,1,allow,1,0,Potential Threat
56252,443,19925,443,6728,1775,4953,25,275,13,12,allow,1,0,Potential Threat
55383,53,49153,53,177,94,83,2,29,1,1,allow,0,0,Normal
54445,443,28246,443,2782,1778,1004,20,33,10,10,allow,1,0,Potential Threat
49728,443,36312,443,5037,1135,3902,16,18,9,7,allow,0,0,Normal
52711,443,58119,443,15118,3979,11139,34,353,17,17,allow,1,0,Potential Threat
35702,443,5840,443,6751,1889,4862,24,316,13,11,allow,1,0,Potential Threat
62596,445,0,0,70,70,0,1,0,1,0,drop,0,1,Known Attack
54983,53,35853,53,728,102,626,2,30,1,1,allow,0,0,Normal
52624,445,0,0,70,70,0,1,0,1,0,drop,0,1,Known Attack
56710,53,40167,53,195,102,93,2,31,1,1,allow,0,0,Normal
37135,443,52476,443,16921,7469,9452,40,138,19,21,allow,1,0,Potential Threat
61398,80,61398,80,1917,1468,449,10,19,6,4,allow,1,0,Potential Threat
57323,53,27696,53,194,102,92,2,30,1,1,allow,0,0,Normal
64166,445,0,0,66,66,0,1,0,1,0,drop,0,1,Known Attack
53174,41442,13286,41442,70,70,0,1,5,1,0,allow,1,0,Potential Threat
50880,80,36202,80,395978,13168,382810,411,143,151,260,allow,1,0,Potential Threat
54877,53,59244,53,199,94,105,2,30,1,1,allow,0,0,Normal
65463,53,27388,53,210,102,108,2,30,1,1,allow,0,0,Normal
65098,53,21613,53,740,93,647,2,31,1,1,allow,0,0,Normal
49244,80,49244,80,661753,15722,646031,683,17,235,448,allow,1,0,Potential Threat
49532,53,40570,53,195,102,93,2,30,1,1,allow,0,0,Normal
49300,443,11326,443,10704,4094,6610,52,47,29,23,allow,1,0,Potential Threat
2476,6881,0,0,62,62,0,1,0,1,0,deny,1,1,High Risk
65045,53,56055,53,197,102,95,2,32,1,1,allow,0,0,Normal
37581,443,35670,443,499,425,74,4,0,3,1,allow,0,0,Normal
3093,62413,0,0,62,62,0,1,0,1,0,deny,1,1,High Risk
62072,443,3018,443,6095,1965,4130,26,46,15,11,allow,1,0,Potential Threat
50315,445,0,0,66,66,0,1,0,1,0,drop,0,1,Known Attack
27209,25198,0,0,145,145,0,1,0,1,0,deny,1,1,High Risk
51344,445,0,0,70,70,0,1,0,1,0,drop,0,1,Known Attack
11692,25174,0,0,62,62,0,1,0,1,0,deny,0,1,Known Attack
63836,445,0,0,70,70,0,1,0,1,0,drop,0,1,Known Attack
65229,53,45181,53,195,102,93,2,31,1,1,allow,0,0,Normal
56919,445,0,0,66,66,0,1,0,1,0,drop,0,1,Known Attack
38000,49152,22175,49152,156,156,0,3,8,3,0,allow,1,0,Potential Threat
45941,23387,0,0,60,60,0,1,0,1,0,deny,0,1,Known Attack
49590,57470,0,0,78,78,0,1,0,1,0,deny,1,1,High Risk
43851,53,43851,53,227,90,137,2,30,1,1,allow,0,0,Normal
49369,445,0,0,70,70,0,1,0,1,0,drop,0,1,Known Attack
50866,445,0,0,70,70,0,1,0,1,0,drop,0,1,Known Attack
54537,80,39580,80,4096,3455,641,13,15,8,5,allow,1,0,Potential Threat
64036,445,0,0,66,66,0,1,0,1,0,drop,0,1,Known Attack
50826,80,48832,80,35970,11674,24296,108,265,55,53,allow,1,0,Potential Threat
59335,80,59335,80,107776,4213,103563,177,16,60,117,allow,1,0,Potential Threat
45079,31573,0,0,66,66,0,1,0,1,0,deny,0,1,Known Attack
57442,2258,57442,2258,156,156,0,3,8,3,0,allow,1,0,Potential Threat
34822,31573,0,0,62,62,0,1,0,1,0,deny,0,1,Known Attack
22220,25174,0,0,62,62,0,1,0,1,0,deny,0,1,Known Attack
64326,53,53148,53,323,107,216,4,38,2,2,allow,0,0,Normal
63586,445,0,0,66,66,0,1,0,1,0,drop,0,1,Known Attack
56018,53,52062,53,762,97,665,2,30,1,1,allow,0,0,Normal
64093,443,64093,443,5663,2416,3247,26,159,14,12,allow,1,0,Potential Threat
50476,445,0,0,70,70,0,1,0,1,0,drop,0,1,Known Attack
50629,445,0,0,66,66,0,1,0,1,0,drop,0,1,Known Attack
36302,25174,0,0,146,146,0,1,0,1,0,deny,1,1,High Risk
53355,23117,0,0,62,62,0,1,0,1,0,deny,0,1,Known Attack
33196,53,25269,53,181,86,95,2,30,1,1,allow,0,0,Normal
63586,46824,0,0,62,62,0,1,0,1,0,deny,1,1,High Risk
64872,53,24466,53,730,102,628,2,29,1,1,allow,0,0,Normal
53119,58118,15448,58118,70,70,0,2,8,2,0,allow,1,0,Potential Threat
50282,445,0,0,70,70,0,1,0,1,0,drop,0,1,Known Attack
64856,445,0,0,66,66,0,1,0,1,0,drop,0,1,Known Attack
52526,30188,0,0,62,62,0,1,0,1,0,deny,0,1,Known Attack
63231,443,12369,443,7124,3843,3281,42,126,20,22,allow,1,0,Potential Threat
51123,445,0,0,66,66,0,1,0,1,0,drop,0,1,Known Attack
56663,53,41717,53,181,94,87,2,33,1,1,allow,0,0,Normal
62973,51505,0,0,62,62,0,1,0,1,0,deny,1,1,High Risk
14112,443,14112,443,25629,5823,19806,44,179,25,19,allow,1,0,Potential Threat
50692,445,0,0,70,70,0,1,0,1,0,drop,0,1,Known Attack
57027,53,37270,53,177,94,83,2,30,1,1,allow,0,0,Normal
50338,80,9655,80,2668,870,1798,13,47,7,6,allow,1,0,Potential Threat
60341,443,14614,443,54103,3190,50913,68,362,27,41,allow,1,0,Potential Threat
13285,29892,0,0,145,145,0,1,0,1,0,deny,1,1,High Risk
58638,5900,0,0,62,62,0,1,0,1,0,deny,0,1,Known Attack
51957,56737,56106,56737,316,136,180,6,6,3,3,allow,1,0,Potential Threat
62721,445,0,0,70,70,0,1,0,1,0,drop,0,1,Known Attack
50636,443,49176,443,7332,1611,5721,17,15,9,8,allow,1,0,Potential Threat
50628,80,46976,80,1658,1247,411,8,14,5,3,allow,0,0,Normal
58638,5900,0,0,62,62,0,1,0,1,0,deny,0,1,Known Attack
55372,53,36344,53,199,102,97,2,30,1,1,allow,0,0,Normal
64555,53,55605,53,167,86,81,2,30,1,1,allow,0,0,Normal
55031,5222,39174,5222,6192,3767,2425,53,64,29,24,allow,1,0,Potential Threat
11236,53,11236,53,197,90,107,2,30,1,1,allow,0,0,Normal
60381,26312,40513,26312,70,70,0,1,5,1,0,allow,1,0,Potential Threat
57946,443,19612,443,2791,1800,991,26,185,15,11,allow,1,0,Potential Threat
58858,443,49748,443,208,60,148,4,10,2,2,allow,0,0,Normal
37589,443,25099,443,499,425,74,4,0,3,1,allow,0,0,Normal
38524,443,15396,443,5846879,177697,5669182,6043,41,2261,3782,allow,1,0,Potential Threat
28580,64147,0,0,62,62,0,1,0,1,0,deny,1,1,High Risk
50298,53,38554,53,164,86,78,2,30,1,1,allow,0,0,Normal
63866,17623,35380,17623,66,66,0,2,8,2,0,allow,1,0,Potential Threat
32096,55108,0,0,139,139,0,1,0,1,0,deny,1,1,High Risk
5894,44847,0,0,66,66,0,1,0,1,0,deny,1,1,High Risk
55698,445,0,0,70,70,0,1,0,1,0,drop,0,1,Known Attack
55476,445,0,0,66,66,0,1,0,1,0,drop,0,1,Known Attack
44710,25174,0,0,62,62,0,1,0,1,0,deny,0,1,Known Attack
54905,445,0,0,70,70,0,1,0,1,0,drop,0,1,Known Attack
51015,80,51015,80,1905,1456,449,10,20,6,4,allow,1,0,Potential Threat
49823,53,39316,53,388,102,286,2,30,1,1,allow,0,0,Normal
56104,445,0,0,70,70,0,1,0,1,0,drop,0,1,Known Attack
39588,25174,0,0,66,66,0,1,0,1,0,deny,0,1,Known Attack
55828,53,29834,53,181,94,87,2,31,1,1,allow,0,0,Normal
58576,445,0,0,70,70,0,1,0,1,0,drop,0,1,Known Attack
54552,64147,0,0,62,62,0,1,0,1,0,deny,1,1,High Risk
63883,445,0,0,70,70,0,1,0,1,0,drop,0,1,Known Attack
53870,24535,51626,24535,70,70,0,1,5,1,0,allow,1,0,Potential Threat
42298,40039,50865,40039,602,86,516,2,30,1,1,allow,1,0,Potential Threat
49828,53,44800,53,733,86,647,2,29,1,1,allow,0,0,Normal
52740,51505,0,0,66,66,0,1,0,1,0,deny,0,1,Known Attack
55027,48051,0,0,62,62,0,1,0,1,0,deny,0,1,Known Attack
1319,443,12846,443,448,256,192,8,25,5,3,allow,1,0,Potential Threat
34713,22114,0,0,146,146,0,1,0,1,0,deny,1,1,High Risk
44714,25174,0,0,146,146,0,1,0,1,0,deny,1,1,High Risk
64003,38926,55687,38926,66,66,0,1,5,1,0,allow,1,0,Potential Threat
56687,445,0,0,70,70,0,1,0,1,0,drop,0,1,Known Attack
64744,53,61506,53,770,102,668,2,29,1,1,allow,1,0,Potential Threat
10006,64147,0,0,62,62,0,1,0,1,0,deny,1,1,High Risk
64715,53,61600,53,209,110,99,2,30,1,1,allow,1,0,Potential Threat
60114,443,25008,443,268,120,148,5,10,3,2,allow,0,0,Normal
50306,445,0,0,70,70,0,1,0,1,0,drop,0,1,Known Attack
62977,445,0,0,70,70,0,1,0,1,0,drop,0,1,Known Attack
53318,56648,63034,56648,672,432,240,10,142,6,4,allow,1,0,Potential Threat
63092,443,8576,443,4771341,155341,4616000,5024,147,1667,3357,allow,1,0,Potential Threat
52838,443,36112,443,14518,10453,4065,43,120,21,22,allow,1,0,Potential Threat
33638,443,11926,443,1784,1010,774,16,185,9,7,allow,1,0,Potential Threat
1033,35440,0,0,146,146,0,1,0,1,0,deny,1,1,High Risk
28580,64147,0,0,62,62,0,1,0,1,0,deny,1,1,High Risk
68,67,0,0,346,346,0,1,0,1,0,deny,1,1,High Risk
35408,53,57895,53,168,78,90,2,30,1,1,allow,0,0,Normal
64242,53,41761,53,180,94,86,2,30,1,1,allow,0,0,Normal
30188,64511,50224,64511,854,150,704,4,1200,2,2,allow,1,0,Potential Threat
55771,80,55771,80,3538,701,2837,11,20,6,5,allow,1,0,Potential Threat
51151,64147,0,0,66,66,0,1,0,1,0,deny,1,1,High Risk
57063,53,6247,53,193,102,91,2,29,1,1,allow,0,0,Normal
9084,53,9084,53,224,88,136,2,30,1,1,allow,1,0,Potential Threat
21133,54508,26359,54508,323,150,173,2,1199,1,1,allow,1,0,Potential Threat
2541,51505,0,0,66,66,0,1,0,1,0,deny,1,1,High Risk
60017,443,51690,443,134,60,74,3,10,2,1,allow,0,0,Normal
64353,445,0,0,66,66,0,1,0,1,0,drop,0,1,Known Attack
44383,30188,0,0,66,66,0,1,0,1,0,deny,0,1,Known Attack
63816,2073,59297,2073,70,70,0,1,4,1,0,allow,1,0,Potential Threat
49972,53,25100,53,328,110,218,4,57,2,2,allow,0,0,Normal
51464,443,29786,443,575,326,249,10,15,6,4,allow,0,0,Normal
54859,443,24991,443,6677,1006,5671,19,26,11,8,allow,1,0,Potential Threat
56480,445,0,0,70,70,0,1,0,1,0,drop,0,1,Known Attack
60351,50584,0,0,62,62,0,1,0,1,0,deny,1,1,High Risk
50475,443,44824,443,3893,1910,1983,36,255,17,19,allow,1,0,Potential Threat
4772,37965,0,0,66,66,0,1,0,1,0,deny,1,1,High Risk
54822,445,0,0,70,70,0,1,0,1,0,drop,0,1,Known Attack
64804,53,26105,53,182,102,80,2,30,1,1,allow,0,0,Normal
49379,80,26229,80,6307,2851,3456,18,150,9,9,allow,1,0,Potential Threat
55134,53,17370,53,214,110,104,2,30,1,1,allow,0,0,Normal
62586,445,0,0,70,70,0,1,0,1,0,drop,0,1,Known Attack
46512,63836,0,0,148,148,0,1,0,1,0,deny,1,1,High Risk
60763,445,0,0,66,66,0,1,0,1,0,drop,0,1,Known Attack
55293,53,52510,53,230,110,120,2,30,1,1,allow,0,0,Normal
42770,443,4955,443,8820,2996,5824,27,95,14,13,allow,1,0,Potential Threat
1027,11392,0,0,62,62,0,1,0,1,0,deny,1,1,High Risk
49438,443,56148,443,180,60,120,4,15,2,2,allow,0,0,Normal
56068,53,2215,53,752,93,659,2,30,1,1,allow,0,0,Normal
53248,443,8243,443,5995,974,5021,19,66,10,9,allow,1,0,Potential Threat
58774,443,43846,443,5167,700,4467,16,15,7,9,allow,1,0,Potential Threat
23296,23,0,0,60,60,0,1,0,1,0,deny,0,1,Known Attack
55432,445,0,0,70,70,0,1,0,1,0,drop,0,1,Known Attack
58843,443,44716,443,6033,770,5263,18,16,8,10,allow,1,0,Potential Threat
43886,5223,33165,5223,3721,1173,2548,18,257,11,7,allow,1,0,Potential Threat
42298,40028,40095,40028,563,86,477,2,30,1,1,allow,1,0,Potential Threat
58744,443,37896,443,42954,12409,30545,154,319,67,87,allow,1,0,Potential Threat
64845,53,4147,53,289,110,179,2,30,1,1,allow,0,0,Normal
49232,445,0,0,70,70,0,1,0,1,0,drop,0,1,Known Attack
58672,43890,0,0,62,62,0,1,0,1,0,deny,0,1,Known Attack
22568,37965,0,0,66,66,0,1,0,1,0,deny,1,1,High Risk
443,45788,0,0,332,332,0,1,0,1,0,deny,1,1,High Risk
56736,443,56736,443,120441,7846,112595,167,61,76,91,allow,1,0,Potential Threat
50990,23884,0,0,62,62,0,1,0,1,0,deny,0,1,Known Attack
56628,443,8752,443,6654,3821,2833,60,3037,30,30,allow,1,0,Potential Threat
34134,30188,0,0,62,62,0,1,0,1,0,deny,0,1,Known Attack
52139,38259,57318,38259,70,70,0,2,7,2,0,allow,1,0,Potential Threat
64964,53,38711,53,197,102,95,2,30,1,1,allow,0,0,Normal
22439,25174,0,0,66,66,0,1,0,1,0,deny,0,1,Known Attack
57862,445,0,0,70,70,0,1,0,1,0,drop,0,1,Known Attack
59975,443,17092,443,7875,3100,4775,42,24,22,20,allow,1,0,Potential Threat
50321,23684,0,0,143,143,0,1,0,1,0,deny,1,1,High Risk
0,0,0,0,1188,1188,0,2,0,2,0,allow,1,0,Potential Threat
54652,53,54652,53,216,98,118,2,30,1,1,allow,0,0,Normal
59418,443,19462,443,7222,1633,5589,24,201,13,11,allow,1,0,Potential Threat
53668,50678,10621,50678,70,70,0,1,5,1,0,allow,1,0,Potential Threat
9335,443,4512,443,674,128,546,12,45,3,9,allow,1,0,Potential Threat
64996,53,37849,53,547,91,456,4,35,2,2,allow,0,0,Normal
61741,443,4502,443,68851,3430,65421,93,121,35,58,allow,1,0,Potential Threat
55063,445,0,0,70,70,0,1,0,1,0,drop,0,1,Known Attack
1081,64910,0,0,146,146,0,1,0,1,0,deny,1,1,High Risk
58118,445,0,0,70,70,0,1,0,1,0,drop,0,1,Known Attack
55524,46232,0,0,66,66,0,1,0,1,0,deny,0,1,Known Attack
43439,443,4737,443,13482,3731,9751,40,500,17,23,allow,1,0,Potential Threat
53603,53796,63183,53796,70,70,0,2,7,2,0,allow,1,0,Potential Threat
49163,22114,0,0,62,62,0,1,0,1,0,deny,0,1,Known Attack
64555,53,10175,53,469,97,372,4,49,2,2,allow,0,0,Normal
53871,37965,0,0,66,66,0,1,0,1,0,deny,0,1,Known Attack
1054,57470,0,0,62,62,0,1,0,1,0,deny,1,1,High Risk
44805,443,37165,443,6975,2168,4807,20,15,11,9,allow,1,0,Potential Threat
54895,445,0,0,70,70,0,1,0,1,0,drop,0,1,Known Attack
63150,443,63150,443,6792,1521,5271,18,28,11,7,allow,1,0,Potential Threat
50263,445,0,0,66,66,0,1,0,1,0,drop,0,1,Known Attack
50573,22114,0,0,62,62,0,1,0,1,0,deny,0,1,Known Attack
30960,45689,37422,45689,330,330,0,6,3609,6,0,allow,1,0,Potential Threat
55666,53,48851,53,728,96,632,2,30,1,1,allow,0,0,Normal
49477,53,9524,53,271,88,183,4,59,2,2,allow,0,0,Normal
56974,53,21612,53,814,110,704,2,30,1,1,allow,0,0,Normal
49782,443,62911,443,70,70,0,1,5,1,0,allow,1,0,Potential Threat
38672,443,23620,443,4478,1133,3345,13,35,8,5,allow,1,0,Potential Threat
49812,445,0,0,66,66,0,1,0,1,0,drop,0,1,Known Attack
53879,43702,31911,43702,320,140,180,6,6,3,3,allow,1,0,Potential Threat
33525,53,23050,53,168,78,90,2,31,1,1,allow,0,0,Normal
64813,53,11826,53,335,90,245,4,35,2,2,allow,0,0,Normal
56222,445,0,0,70,70,0,1,0,1,0,drop,0,1,Known Attack
63423,445,0,0,70,70,0,1,0,1,0,drop,0,1,Known Attack
42917,52952,0,0,62,62,0,1,0,1,0,deny,0,1,Known Attack
54883,51505,0,0,66,66,0,1,0,1,0,deny,0,1,Known Attack
63204,443,63204,443,9340,4256,5084,24,16,13,11,allow,1,0,Potential Threat
56569,53,23106,53,182,93,89,2,31,1,1,allow,0,0,Normal
49495,53,39798,53,758,102,656,2,31,1,1,allow,0,0,Normal
49385,53,7961,53,214,102,112,2,30,1,1,allow,0,0,Normal
49558,53,29414,53,177,94,83,2,30,1,1,allow,0,0,Normal
64331,53,61619,53,179,94,85,2,30,1,1,allow,1,0,Potential Threat
30188,14991,3855,14991,501,150,351,2,1200,1,1,allow,1,0,Potential Threat
52058,8329,7251,8329,66,66,0,1,5,1,0,allow,1,0,Potential Threat
51749,1408,51950,1408,70,70,0,1,5,1,0,allow,0,0,Normal
57224,445,0,0,70,70,0,1,0,1,0,drop,0,1,Known Attack
36993,443,63240,443,7768,3071,4697,23,17,12,11,allow,1,0,Potential Threat
58290,445,0,0,70,70,0,1,0,1,0,drop,0,1,Known Attack
64882,53,62094,53,343,134,209,2,30,1,1,allow,1,0,Potential Threat
61354,445,0,0,70,70,0,1,0,1,0,drop,0,1,Known Attack
51505,443,46771,443,645662,22326,623336,743,41,299,444,allow,1,0,Potential Threat
53010,445,0,0,70,70,0,1,0,1,0,drop,0,1,Known Attack
55435,25174,0,0,62,62,0,1,0,1,0,deny,0,1,Known Attack
12986,64147,0,0,62,62,0,1,0,1,0,deny,1,1,High Risk
55304,53,64050,53,711,87,624,2,30,1,1,allow,1,0,Potential Threat
55692,53,51127,53,198,102,96,2,30,1,1,allow,0,0,Normal
23218,62413,0,0,66,66,0,1,0,1,0,deny,1,1,High Risk
59659,445,0,0,70,70,0,1,0,1,0,drop,0,1,Known Attack
57777,445,0,0,70,70,0,1,0,1,0,drop,0,1,Known Attack
52063,80,12503,80,366,240,126,7,26,5,2,allow,0,0,Normal
52309,445,0,0,70,70,0,1,0,1,0,drop,0,1,Known Attack
52030,443,43838,443,9090,1914,7176,24,25,13,11,allow,1,0,Potential Threat
65114,53,35237,53,192,98,94,2,30,1,1,allow,0,0,Normal
58444,445,0,0,70,70,0,1,0,1,0,drop,0,1,Known Attack
56433,80,35239,80,17188,1559,15629,25,25,10,15,allow,1,0,Potential Threat
49767,53,22379,53,177,94,83,2,31,1,1,allow,0,0,Normal
55704,53,41998,53,193,102,91,2,30,1,1,allow,0,0,Normal
64758,443,35347,443,5066,2558,2508,26,127,13,13,allow,1,0,Potential Threat
55251,53,16099,53,212,110,102,2,30,1,1,allow,0,0,Normal
54535,80,13360,80,4162,3455,707,14,15,8,6,allow,1,0,Potential Threat
6881,6881,13981,6881,150,150,0,1,1200,1,0,allow,1,0,Potential Threat
60216,80,20321,80,3606,2572,1034,14,151,8,6,allow,1,0,Potential Threat
23843,26467,0,0,62,62,0,1,0,1,0,deny,0,1,Known Attack
26229,80,26229,80,7372,954,6418,17,18,9,8,allow,1,0,Potential Threat
49218,53,22762,53,195,102,93,2,31,1,1,allow,0,0,Normal
58189,445,0,0,70,70,0,1,0,1,0,drop,0,1,Known Attack
55905,53,39225,53,754,94,660,2,30,1,1,allow,0,0,Normal
16037,25174,0,0,62,62,0,1,0,1,0,deny,0,1,Known Attack
45937,443,35765,443,4592,697,3895,14,25,8,6,allow,1,0,Potential Threat
51348,25174,0,0,66,66,0,1,0,1,0,deny,0,1,Known Attack
56177,53,33735,53,184,94,90,2,30,1,1,allow,0,0,Normal
50375,1,0,0,74,74,0,1,91,1,0,allow,0,0,Normal
57498,445,0,0,70,70,0,1,0,1,0,drop,0,1,Known Attack
57874,26467,0,0,62,62,0,1,0,1,0,deny,0,1,Known Attack
59393,443,45183,443,1664,914,750,15,275,7,8,allow,1,0,Potential Threat
64035,25174,0,0,62,62,0,1,0,1,0,deny,0,1,Known Attack
46448,30170,0,0,159,159,0,1,0,1,0,deny,1,1,High Risk
50126,23117,0,0,62,62,0,1,0,1,0,deny,0,1,Known Attack
52432,50265,0,0,66,66,0,1,0,1,0,deny,0,1,Known Attack
63670,64097,0,0,66,66,0,1,0,1,0,deny,1,1,High Risk
64469,445,0,0,70,70,0,1,0,1,0,drop,0,1,Known Attack
49553,443,65490,443,6074,865,5209,16,15,9,7,allow,1,0,Potential Threat
58286,37965,0,0,66,66,0,1,0,1,0,deny,0,1,Known Attack
57626,443,3957,443,3858,1277,2581,12,120,6,6,allow,1,0,Potential Threat
55429,25174,0,0,66,66,0,1,0,1,0,deny,0,1,Known Attack
54826,56205,0,0,66,66,0,1,0,1,0,deny,0,1,Known Attack
56430,443,5643,443,2274816,85295,2189521,2305,127,825,1480,allow,1,0,Potential Threat
65425,80,38267,80,366,180,186,7,29,4,3,allow,1,0,Potential Threat
48424,53,48424,53,220,90,130,2,30,1,1,allow,0,0,Normal
64587,53,36595,53,167,86,81,2,31,1,1,allow,0,0,Normal
56564,9571,0,0,78,78,0,1,0,1,0,deny,0,1,Known Attack
27005,27111,65327,27111,913,126,787,2,30,1,1,allow,1,0,Potential Threat
22125,23,0,0,60,60,0,1,0,1,0,deny,0,1,Known Attack
18116,37807,0,0,66,66,0,1,0,1,0,deny,1,1,High Risk
23131,25174,0,0,62,62,0,1,0,1,0,deny,0,1,Known Attack
26900,27017,32007,27017,422,164,258,6,30,3,3,allow,1,0,Potential Threat
15465,64147,0,0,62,62,0,1,0,1,0,deny,1,1,High Risk
65453,53,23093,53,311,94,217,2,30,1,1,allow,0,0,Normal
52570,80,52570,80,3886,696,3190,13,142,6,7,allow,1,0,Potential Threat
443,22323,0,0,61,61,0,1,0,1,0,deny,1,1,High Risk
57470,16288,57203,16288,924,924,0,15,1200,15,0,allow,1,0,Potential Threat
18203,23,0,0,60,60,0,1,0,1,0,deny,0,1,Known Attack
55111,39004,0,0,66,66,0,1,0,1,0,deny,0,1,Known Attack
50464,80,22574,80,8453,2011,6442,17,21,8,9,allow,1,0,Potential Threat
57412,445,0,0,70,70,0,1,0,1,0,drop,0,1,Known Attack
39858,443,36124,443,167,107,60,2,5,1,1,allow,0,0,Normal
56357,53,8894,53,168,86,82,2,30,1,1,allow,0,0,Normal
65115,53,14088,53,167,86,81,2,30,1,1,allow,0,0,Normal
55966,35440,0,0,66,66,0,1,0,1,0,deny,0,1,Known Attack
58468,37965,0,0,66,66,0,1,0,1,0,deny,0,1,Known Attack
64937,53,3891,53,360,118,242,2,30,1,1,allow,0,0,Normal
55960,445,0,0,70,70,0,1,0,1,0,drop,0,1,Known Attack
49792,443,3776,443,6089,799,5290,16,126,8,8,allow,1,0,Potential Threat
8734,56205,0,0,66,66,0,1,0,1,0,deny,1,1,High Risk
65312,53,52827,53,182,94,88,2,30,1,1,allow,0,0,Normal
59174,445,0,0,70,70,0,1,0,1,0,drop,0,1,Known Attack
53252,445,0,0,66,66,0,1,0,1,0,drop,0,1,Known Attack
3478,61463,0,0,804,804,0,1,0,1,0,deny,1,1,High Risk
50193,3389,50193,3389,3409,1454,1955,16,16,8,8,allow,1,0,Potential Threat
50922,443,21315,443,6180,1241,4939,18,982,8,10,allow,1,0,Potential Threat
7030,80,7030,80,115811,3862,111949,123,38,44,79,allow,1,0,Potential Threat
19623,25174,0,0,62,62,0,1,0,1,0,deny,0,1,Known Attack
49328,53,46932,53,748,94,654,2,30,1,1,allow,0,0,Normal
52782,445,0,0,70,70,0,1,0,1,0,drop,0,1,Known Attack
45754,80,60037,80,1282,650,632,9,127,5,4,allow,1,0,Potential Threat
55102,53,13108,53,195,102,93,2,29,1,1,allow,0,0,Normal
42308,443,54120,443,433261,34730,398531,604,279,258,346,allow,1,0,Potential Threat
34726,53,62948,53,168,78,90,2,30,1,1,allow,1,0,Potential Threat
53450,443,34036,443,10139,3656,6483,29,128,14,15,allow,1,0,Potential Threat
54954,445,0,0,66,66,0,1,0,1,0,drop,0,1,Known Attack
49272,7000,49272,7000,3132,815,2317,14,15,7,7,allow,1,0,Potential Threat
54376,445,0,0,70,70,0,1,0,1,0,drop,0,1,Known Attack
60578,445,0,0,70,70,0,1,0,1,0,drop,0,1,Known Attack
62400,35993,0,0,62,62,0,1,0,1,0,deny,0,1,Known Attack
61370,445,0,0,70,70,0,1,0,1,0,drop,0,1,Known Attack
50684,445,0,0,70,70,0,1,0,1,0,drop,0,1,Known Attack
53541,443,39871,443,10583,1889,8694,28,251,10,18,allow,1,0,Potential Threat
50019,80,29484,80,814,674,140,6,28,4,2,allow,0,0,Normal
59481,41182,0,0,66,66,0,1,0,1,0,deny,0,1,Known Attack
12471,31573,0,0,62,62,0,1,0,1,0,deny,1,1,High Risk
55323,53,20826,53,178,94,84,2,30,1,1,allow,0,0,Normal
64020,53,44407,53,192,98,94,2,31,1,1,allow,0,0,Normal
50236,443,16316,443,4954,1768,3186,18,143,9,9,allow,1,0,Potential Threat
50432,445,0,0,70,70,0,1,0,1,0,drop,0,1,Known Attack
61804,51505,0,0,66,66,0,1,0,1,0,deny,1,1,High Risk
62972,445,0,0,66,66,0,1,0,1,0,drop,0,1,Known Attack
52941,443,58388,443,14630,5941,8689,52,115,26,26,allow,1,0,Potential Threat
51997,443,19517,443,2648,1797,851,19,22,11,8,allow,0,0,Normal
65452,445,0,0,66,66,0,1,0,1,0,drop,0,1,Known Attack
55159,53,6565,53,200,102,98,2,30,1,1,allow,0,0,Normal
61603,445,0,0,70,70,0,1,0,1,0,drop,0,1,Known Attack
53017,443,37363,443,15038,4142,10896,48,108,24,24,allow,1,0,Potential Threat
56987,53,30832,53,192,98,94,2,31,1,1,allow,0,0,Normal
34179,80,3058,80,2137,1258,879,11,150,6,5,allow,1,0,Potential Threat
54091,445,0,0,66,66,0,1,0,1,0,drop,0,1,Known Attack
52132,55014,27986,55014,70,70,0,1,4,1,0,allow,1,0,Potential Threat
63962,10115,25745,10115,66,66,0,1,5,1,0,allow,1,0,Potential Threat
9147,443,1443,443,6334,840,5494,19,29,10,9,allow,1,0,Potential Threat
56519,53,20744,53,167,86,81,2,29,1,1,allow,0,0,Normal
55666,36653,26608,36653,70,70,0,2,8,2,0,allow,1,0,Potential Threat
64959,53,12491,53,209,110,99,2,30,1,1,allow,0,0,Normal
5588,5588,0,0,3562,1936,1626,48,194,24,24,allow,1,0,Potential Threat
56951,53,25030,53,168,86,82,2,29,1,1,allow,0,0,Normal
58638,5900,0,0,62,62,0,1,0,1,0,deny,0,1,Known Attack
57424,53,34088,53,177,94,83,2,30,1,1,allow,0,0,Normal
5688,44847,0,0,62,62,0,1,0,1,0,deny,1,1,High Risk
58638,5900,0,0,62,62,0,1,0,1,0,deny,0,1,Known Attack
52152,80,10469,80,366,240,126,7,32,5,2,allow,0,0,Normal
64551,53,37333,53,495,127,368,4,33,2,2,allow,0,0,Normal
58248,53,0,0,633,83,550,2,30,1,1,allow,0,0,Normal
51966,443,55026,443,35199,15909,19290,70,152,34,36,allow,1,0,Potential Threat
48713,80,47813,80,1767,751,1016,10,15,6,4,allow,0,0,Normal
44402,443,62685,443,196732,11940,184792,257,139,103,154,allow,1,0,Potential Threat
37749,15503,0,0,62,62,0,1,0,1,0,deny,0,1,Known Attack
14409,7363,0,0,145,145,0,1,0,1,0,deny,1,1,High Risk
50132,443,60688,443,8162,1364,6798,22,16,11,11,allow,1,0,Potential Threat
52118,443,25040,443,22072,2166,19906,44,49,22,22,allow,1,0,Potential Threat
55154,53,45659,53,184,94,90,2,30,1,1,allow,0,0,Normal
58638,5900,0,0,62,62,0,1,0,1,0,deny,0,1,Known Attack
53801,445,0,0,70,70,0,1,0,1,0,drop,0,1,Known Attack
58638,5900,0,0,62,62,0,1,0,1,0,deny,0,1,Known Attack
49481,7000,49481,7000,3066,1675,1391,16,14,9,7,allow,1,0,Potential Threat
60526,443,60526,443,1462,863,599,15,37,9,6,allow,1,0,Potential Threat
50086,53,18970,53,816,102,714,2,30,1,1,allow,0,0,Normal
57794,53,57794,53,825,99,726,2,30,1,1,allow,0,0,Normal
58627,25174,0,0,62,62,0,1,0,1,0,deny,0,1,Known Attack
51905,65253,13795,65253,70,70,0,2,8,2,0,allow,1,0,Potential Threat
61878,445,0,0,66,66,0,1,0,1,0,drop,0,1,Known Attack
65064,30188,0,0,66,66,0,1,0,1,0,deny,0,1,Known Attack
11574,51505,0,0,62,62,0,1,0,1,0,deny,1,1,High Risk
60750,42707,0,0,66,66,0,1,0,1,0,deny,0,1,Known Attack
45652,10214,0,0,62,62,0,1,0,1,0,deny,0,1,Known Attack
41577,53,41577,53,265,111,154,2,0,1,1,allow,0,0,Normal
58157,445,0,0,70,70,0,1,0,1,0,drop,0,1,Known Attack
59452,445,0,0,66,66,0,1,0,1,0,drop,0,1,Known Attack
65395,53,34335,53,754,94,660,2,30,1,1,allow,0,0,Normal
40620,443,2727,443,7049,1412,5637,24,16,14,10,allow,1,0,Potential Threat
65321,53,36858,53,167,86,81,2,29,1,1,allow,0,0,Normal
54048,25174,0,0,66,66,0,1,0,1,0,deny,0,1,Known Attack
50563,443,65476,443,1313,876,437,11,26,6,5,allow,1,0,Potential Threat
19361,23117,0,0,66,66,0,1,0,1,0,deny,0,1,Known Attack
57392,445,0,0,70,70,0,1,0,1,0,drop,0,1,Known Attack
56006,53,14148,53,200,102,98,2,30,1,1,allow,0,0,Normal
50584,445,0,0,70,70,0,1,0,1,0,drop,0,1,Known Attack
49863,53,59500,53,200,86,114,2,30,1,1,allow,0,0,Normal
53165,445,0,0,70,70,0,1,0,1,0,drop,0,1,Known Attack
59995,445,0,0,70,70,0,1,0,1,0,drop,0,1,Known Attack
64078,54561,7261,54561,66,66,0,2,7,2,0,allow,1,0,Potential Threat
49296,53,53194,53,193,102,91,2,31,1,1,allow,0,0,Normal
53747,21698,30276,21698,320,140,180,6,7,3,3,allow,1,0,Potential Threat
42117,80,40456,80,1056,682,374,10,15,6,4,allow,1,0,Potential Threat
53979,443,21511,443,3566,871,2695,11,120,5,6,allow,1,0,Potential Threat
18642,42707,0,0,62,62,0,1,0,1,0,deny,1,1,High Risk
60393,46347,14352,46347,320,140,180,6,7,3,3,allow,1,0,Potential Threat
60886,443,34294,443,3855,2679,1176,28,45,15,13,allow,1,0,Potential Threat
5588,5588,0,0,3354,1792,1562,46,194,23,23,allow,1,0,Potential Threat
51221,1950,25491,1950,870,330,540,12,1316,6,6,allow,1,0,Potential Threat
1027,57866,0,0,62,62,0,1,0,1,0,deny,1,1,High Risk
52714,64147,0,0,62,62,0,1,0,1,0,deny,1,1,High Risk
61875,445,0,0,66,66,0,1,0,1,0,drop,0,1,Known Attack
53213,443,51742,443,8451,2320,6131,25,104,13,12,allow,1,0,Potential Threat
56314,53,22045,53,183,94,89,2,30,1,1,allow,0,0,Normal
55774,53,26343,53,701,88,613,2,30,1,1,allow,0,0,Normal
56660,443,12588,443,1579,988,591,13,25,7,6,allow,0,0,Normal
53241,443,45177,443,1950,1176,774,18,103,11,7,allow,1,0,Potential Threat
58638,5900,0,0,62,62,0,1,0,1,0,deny,0,1,Known Attack
46167,80,23731,80,234,234,0,4,11,4,0,allow,0,0,Normal
57608,445,0,0,66,66,0,1,0,1,0,drop,0,1,Known Attack
44414,23718,0,0,62,62,0,1,0,1,0,deny,0,1,Known Attack
59701,44847,0,0,66,66,0,1,0,1,0,deny,0,1,Known Attack
52938,64097,0,0,66,66,0,1,0,1,0,deny,1,1,High Risk
52575,22114,0,0,62,62,0,1,0,1,0,deny,0,1,Known Attack
27272,64147,0,0,62,62,0,1,0,1,0,deny,1,1,High Risk
2572,17546,0,0,66,66,0,1,0,1,0,deny,1,1,High Risk
58638,5900,0,0,62,62,0,1,0,1,0,deny,0,1,Known Attack
51789,80,62386,80,28433,1668,26765,39,20,18,21,allow,1,0,Potential Threat
50059,445,0,0,70,70,0,1,0,1,0,drop,0,1,Known Attack
50265,12348,24050,12348,858,858,0,14,1200,14,0,allow,1,0,Potential Threat
54948,443,58033,443,493685,14728,478957,612,316,213,399,allow,1,0,Potential Threat
55661,53,42015,53,213,102,111,2,30,1,1,allow,0,0,Normal
52415,445,0,0,66,66,0,1,0,1,0,drop,0,1,Known Attack
63895,44847,0,0,62,62,0,1,0,1,0,deny,1,1,High Risk
50095,53,54067,53,146,75,71,2,31,1,1,allow,0,0,Normal
44048,443,44048,443,4401,1494,2907,19,29,11,8,allow,1,0,Potential Threat
49514,65504,0,0,162,162,0,1,0,1,0,deny,1,1,High Risk
13581,51505,0,0,66,66,0,1,0,1,0,deny,1,1,High Risk
51767,59158,21535,59158,70,70,0,2,8,2,0,allow,1,0,Potential Threat
52532,445,0,0,66,66,0,1,0,1,0,drop,0,1,Known Attack
56491,445,0,0,70,70,0,1,0,1,0,drop,0,1,Known Attack
54165,443,54165,443,147750,13521,134229,182,92,84,98,allow,1,0,Potential Threat
51914,5222,1180,5222,5141,2331,2810,41,144,24,17,allow,1,0,Potential Threat
58006,80,48045,80,318,192,126,6,21,4,2,allow,0,0,Normal
51562,445,0,0,70,70,0,1,0,1,0,drop,0,1,Known Attack
60075,41705,0,0,62,62,0,1,0,1,0,deny,0,1,Known Attack
56283,53,17978,53,315,102,213,2,30,1,1,allow,0,0,Normal
49741,53,17465,53,177,94,83,2,30,1,1,allow,0,0,Normal
56330,53,41814,53,271,95,176,4,47,2,2,allow,0,0,Normal
27005,27016,51582,27016,1626,126,1500,4,30,2,2,allow,1,0,Potential Threat
49840,53,48921,53,277,102,175,2,30,1,1,allow,0,0,Normal
54199,445,0,0,66,66,0,1,0,1,0,drop,0,1,Known Attack
21585,443,21585,443,14344,1146,13198,25,19,11,14,allow,1,0,Potential Threat
56532,53,29846,53,291,88,203,4,50,2,2,allow,0,0,Normal
50982,445,0,0,66,66,0,1,0,1,0,drop,0,1,Known Attack
64904,53,63887,53,199,102,97,2,30,1,1,allow,1,0,Potential Threat
49914,53,31140,53,215,86,129,2,30,1,1,allow,0,0,Normal
37308,43890,0,0,62,62,0,1,0,1,0,deny,0,1,Known Attack
55994,53,19158,53,182,93,89,2,31,1,1,allow,0,0,Normal
54179,443,27953,443,5037,2002,3035,14,120,7,7,allow,1,0,Potential Threat
60755,443,57914,443,61151,2474,58677,61,25,16,45,allow,1,0,Potential Threat
49488,53,49488,53,823,98,725,2,30,1,1,allow,0,0,Normal
49860,443,20445,443,10754,2778,7976,38,59,19,19,allow,1,0,Potential Threat
51095,445,0,0,70,70,0,1,0,1,0,drop,0,1,Known Attack
56913,53,30099,53,772,103,669,2,31,1,1,allow,0,0,Normal
61407,443,5972,443,6248,829,5419,17,29,9,8,allow,1,0,Potential Threat
64952,445,0,0,70,70,0,1,0,1,0,drop,0,1,Known Attack
64770,53,63194,53,93,93,0,1,31,1,0,allow,1,0,Potential Threat
49894,80,26822,80,1409,735,674,12,17,5,7,allow,1,0,Potential Threat
60440,53830,1700,53830,320,140,180,6,6,3,3,allow,1,0,Potential Threat
63243,53,40178,53,330,228,102,3,33,2,1,allow,0,0,Normal
443,44683,0,0,83,83,0,1,0,1,0,deny,1,1,High Risk
56364,443,28728,443,10427,6311,4116,33,234,20,13,allow,1,0,Potential Threat
60368,445,0,0,70,70,0,1,0,1,0,drop,0,1,Known Attack
41734,57470,0,0,62,62,0,1,0,1,0,deny,0,1,Known Attack
57090,53,28237,53,198,102,96,2,30,1,1,allow,0,0,Normal
52786,443,34018,443,8160,2216,5944,22,38,14,8,allow,1,0,Potential Threat
25565,55690,0,0,60,60,0,1,0,1,0,deny,1,1,High Risk
18461,19473,0,0,66,66,0,1,0,1,0,deny,0,1,Known Attack
57434,50584,0,0,62,62,0,1,0,1,0,deny,0,1,Known Attack
53918,443,16862,443,499,425,74,4,0,3,1,allow,0,0,Normal
64813,53,4341,53,180,94,86,2,30,1,1,allow,0,0,Normal
53144,58987,40200,58987,70,70,0,1,5,1,0,allow,1,0,Potential Threat
0,0,0,0,320,320,0,5,0,5,0,allow,1,0,Potential Threat
65231,53,37315,53,200,102,98,2,31,1,1,allow,0,0,Normal
59728,53,43809,53,304,86,218,2,30,1,1,allow,0,0,Normal
64112,445,0,0,70,70,0,1,0,1,0,drop,0,1,Known Attack
51630,445,0,0,70,70,0,1,0,1,0,drop,0,1,Known Attack
51702,33451,34580,33451,70,70,0,1,5,1,0,allow,1,0,Potential Threat
57013,53,50114,53,178,94,84,2,29,1,1,allow,0,0,Normal
6882,24271,34047,24271,228,118,110,2,1200,1,1,allow,1,0,Potential Threat
51915,443,2041,443,362,180,182,7,28,4,3,allow,0,0,Normal
50274,445,0,0,70,70,0,1,0,1,0,drop,0,1,Known Attack
55889,53,31264,53,177,94,83,2,29,1,1,allow,0,0,Normal
49418,27017,43664,27017,259,71,188,2,31,1,1,allow,1,0,Potential Threat
60372,445,0,0,66,66,0,1,0,1,0,drop,0,1,Known Attack
50052,65008,0,0,60,60,0,1,0,1,0,deny,1,1,High Risk
55934,53,23725,53,182,102,80,2,30,1,1,allow,0,0,Normal
50429,445,0,0,70,70,0,1,0,1,0,drop,0,1,Known Attack
56493,80,12499,80,65864,3286,62578,76,135,30,46,allow,1,0,Potential Threat
50822,50584,0,0,62,62,0,1,0,1,0,deny,0,1,Known Attack
33995,443,61498,443,6419,995,5424,21,361,11,10,allow,1,0,Potential Threat
61682,80,36902,80,1804,884,920,12,49,6,6,allow,1,0,Potential Threat
56784,445,0,0,66,66,0,1,0,1,0,drop,0,1,Known Attack
33328,25174,0,0,146,146,0,1,0,1,0,deny,1,1,High Risk
26742,53,26742,53,237,91,146,2,33,1,1,allow,0,0,Normal
53136,5228,42128,5228,26821,4295,22526,95,5045,40,55,allow,1,0,Potential Threat
40801,443,33203,443,3289,1265,2024,13,32,7,6,allow,1,0,Potential Threat
24592,50584,0,0,62,62,0,1,0,1,0,deny,1,1,High Risk
50551,445,0,0,70,70,0,1,0,1,0,drop,0,1,Known Attack
64574,443,40988,443,9151,2109,7042,27,30,15,12,allow,1,0,Potential Threat
57470,51413,34007,51413,460,150,310,2,1199,1,1,allow,1,0,Potential Threat
56876,30188,0,0,62,62,0,1,0,1,0,deny,0,1,Known Attack
34809,57470,0,0,66,66,0,1,0,1,0,deny,1,1,High Risk
64251,53,24532,53,177,94,83,2,30,1,1,allow,0,0,Normal
27005,27015,41826,27015,868,126,742,2,30,1,1,allow,1,0,Potential Threat
60868,445,0,0,70,70,0,1,0,1,0,drop,0,1,Known Attack
51807,443,51807,443,1466,856,610,13,27,6,7,allow,1,0,Potential Threat
63847,45598,22596,45598,376,254,122,6,15,4,2,allow,1,0,Potential Threat
64348,53,23011,53,321,102,219,2,30,1,1,allow,0,0,Normal
58223,445,0,0,70,70,0,1,0,1,0,drop,0,1,Known Attack
63988,53,50282,53,559,193,366,6,67,3,3,allow,1,0,Potential Threat
53628,50514,36687,50514,70,70,0,1,4,1,0,allow,1,0,Potential Threat
59888,443,28259,443,1401,864,537,12,28,6,6,allow,1,0,Potential Threat
60136,56205,0,0,66,66,0,1,0,1,0,deny,1,1,High Risk
56192,53,47862,53,177,94,83,2,30,1,1,allow,0,0,Normal
44884,443,49689,443,296,78,218,4,19,1,3,allow,0,0,Normal
55735,50584,0,0,62,62,0,1,0,1,0,deny,0,1,Known Attack
52990,443,9852,443,7093,2235,4858,39,111,20,19,allow,1,0,Potential Threat
27005,29999,13147,29999,876,126,750,2,31,1,1,allow,1,0,Potential Threat
56901,445,0,0,66,66,0,1,0,1,0,drop,0,1,Known Attack
57398,445,0,0,70,70,0,1,0,1,0,drop,0,1,Known Attack
55760,53,35277,53,182,94,88,2,31,1,1,allow,0,0,Normal
52413,53,24477,53,168,78,90,2,30,1,1,allow,0,0,Normal
53646,445,0,0,70,70,0,1,0,1,0,drop,0,1,Known Attack
51971,80,13099,80,60753,2612,58141,76,46,34,42,allow,1,0,Potential Threat
49760,80,49760,80,613303,16858,596445,666,143,251,415,allow,1,0,Potential Threat
51901,15860,21103,15860,316,136,180,6,6,3,3,allow,1,0,Potential Threat
57208,53,19470,53,183,94,89,2,30,1,1,allow,0,0,Normal
56158,445,0,0,70,70,0,1,0,1,0,drop,0,1,Known Attack
49203,53,46082,53,168,86,82,2,31,1,1,allow,0,0,Normal
64689,53,60672,53,183,94,89,2,30,1,1,allow,0,0,Normal
65107,53,27622,53,193,102,91,2,30,1,1,allow,0,0,Normal
44482,443,27809,443,16517,3254,13263,37,271,18,19,allow,1,0,Potential Threat
54369,445,0,0,70,70,0,1,0,1,0,drop,0,1,Known Attack
16387,25619,0,0,60,60,0,1,0,1,0,deny,0,1,Known Attack
54991,53,42971,53,253,87,166,4,29,2,2,allow,0,0,Normal
50084,80,12971,80,2173,616,1557,10,15,6,4,allow,0,0,Normal
50356,53,7944,53,176,90,86,2,31,1,1,allow,0,0,Normal
57262,443,38202,443,43771,18333,25438,105,126,49,56,allow,1,0,Potential Threat
60575,443,23365,443,5994,1594,4400,23,42,12,11,allow,1,0,Potential Threat
50020,443,25948,443,9175,2213,6962,37,121,19,18,allow,1,0,Potential Threat
11821,64147,0,0,62,62,0,1,0,1,0,deny,1,1,High Risk
57470,1031,51778,1031,402,132,270,6,1209,3,3,allow,1,0,Potential Threat
48219,55442,0,0,66,66,0,1,0,1,0,deny,0,1,Known Attack
15503,55878,37795,55878,481,150,331,2,1200,1,1,allow,1,0,Potential Threat
26053,33720,0,0,160,160,0,1,0,1,0,deny,1,1,High Risk
54828,445,0,0,70,70,0,1,0,1,0,drop,0,1,Known Attack
58638,5900,0,0,62,62,0,1,0,1,0,deny,0,1,Known Attack
56746,80,35139,80,876072,26350,849722,935,27,335,600,allow,1,0,Potential Threat
61903,445,0,0,66,66,0,1,0,1,0,drop,0,1,Known Attack
42298,40033,43978,40033,245,182,63,2,30,1,1,allow,1,0,Potential Threat
53651,443,17075,443,9485,2173,7312,32,27,17,15,allow,1,0,Potential Threat
61744,443,1594,443,3743,1654,2089,10,121,5,5,allow,1,0,Potential Threat
65503,445,0,0,70,70,0,1,0,1,0,drop,0,1,Known Attack
61550,5529,0,0,145,145,0,1,0,1,0,deny,0,1,Known Attack
52159,16297,42997,16297,70,70,0,1,5,1,0,allow,1,0,Potential Threat
57337,64147,0,0,66,66,0,1,0,1,0,deny,1,1,High Risk
57732,445,0,0,70,70,0,1,0,1,0,drop,0,1,Known Attack
50675,56205,0,0,66,66,0,1,0,1,0,deny,0,1,Known Attack
43601,443,18392,443,10274,3806,6468,26,413,14,12,allow,1,0,Potential Threat
56258,443,7050,443,3325,1067,2258,13,135,6,7,allow,1,0,Potential Threat
21133,39263,6580,39263,323,150,173,2,1200,1,1,allow,1,0,Potential Threat
52292,443,35142,443,21680,2897,18783,35,120,15,20,allow,1,0,Potential Threat
55290,53,19726,53,198,94,104,2,30,1,1,allow,0,0,Normal
61933,445,0,0,70,70,0,1,0,1,0,drop,0,1,Known Attack
51295,443,27138,443,7448,1737,5711,24,201,13,11,allow,1,0,Potential Threat
65431,53,63045,53,210,102,108,2,30,1,1,allow,1,0,Potential Threat
61312,445,0,0,70,70,0,1,0,1,0,drop,0,1,Known Attack
51205,443,62572,443,8857,2827,6030,52,17,29,23,allow,1,0,Potential Threat
60921,443,60921,443,4886,1530,3356,17,17,10,7,allow,1,0,Potential Threat
56365,53,8027,53,199,102,97,2,30,1,1,allow,0,0,Normal
65258,53,25267,53,193,102,91,2,30,1,1,allow,0,0,Normal
11692,25174,0,0,66,66,0,1,0,1,0,deny,0,1,Known Attack
59413,51505,0,0,66,66,0,1,0,1,0,deny,0,1,Known Attack
53939,9504,53453,9504,492,306,186,8,15,5,3,allow,1,0,Potential Threat
38725,80,37134,80,130,70,60,2,15,1,1,allow,0,0,Normal
56478,53,14582,53,200,102,98,2,30,1,1,allow,0,0,Normal
55791,53,4698,53,811,94,717,2,30,1,1,allow,0,0,Normal
55153,53,36786,53,733,94,639,2,30,1,1,allow,0,0,Normal
0,0,0,0,244,244,0,2,0,2,0,allow,1,0,Potential Threat
56962,445,0,0,66,66,0,1,0,1,0,drop,0,1,Known Attack
64219,53,37826,53,264,102,162,2,30,1,1,allow,0,0,Normal
57747,80,27520,80,2754,1602,1152,17,22,9,8,allow,1,0,Potential Threat
60855,35440,0,0,66,66,0,1,0,1,0,deny,0,1,Known Attack
23331,53,23331,53,242,98,144,2,30,1,1,allow,0,0,Normal
60804,445,0,0,70,70,0,1,0,1,0,drop,0,1,Known Attack
49532,80,7798,80,4577,3951,626,11,25,6,5,allow,1,0,Potential Threat
52033,50584,0,0,66,66,0,1,0,1,0,deny,0,1,Known Attack
1943,48817,0,0,62,62,0,1,0,1,0,deny,1,1,High Risk
58627,64097,0,0,66,66,0,1,0,1,0,deny,1,1,High Risk
56518,53,9053,53,170,87,83,2,30,1,1,allow,0,0,Normal
60446,6882,37809,6882,70,70,0,1,5,1,0,allow,1,0,Potential Threat
51132,80,62444,80,426,240,186,8,21,5,3,allow,1,0,Potential Threat
63944,30188,0,0,66,66,0,1,0,1,0,deny,0,1,Known Attack
57470,32517,51554,32517,166,166,0,1,1199,1,0,allow,1,0,Potential Threat
51453,80,39611,80,214,140,74,4,15,3,1,allow,0,0,Normal
65465,53,17852,53,755,102,653,2,29,1,1,allow,0,0,Normal
52094,443,12498,443,2960,1982,978,15,16,9,6,allow,1,0,Potential Threat
49941,53,13341,53,193,102,91,2,30,1,1,allow,0,0,Normal
49126,443,33194,443,3800867,77753,3723114,3263,625,478,2785,allow,1,0,Potential Threat
45941,23386,0,0,60,60,0,1,0,1,0,deny,0,1,Known Attack
49923,80,28185,80,1126,609,517,11,15,6,5,allow,0,0,Normal
51843,80,51843,80,35384,3225,32159,49,26,20,29,allow,1,0,Potential Threat
35350,443,47252,443,13168,2505,10663,21,121,9,12,allow,1,0,Potential Threat
27005,50003,14417,50003,887,126,761,2,31,1,1,allow,1,0,Potential Threat
55525,53,40797,53,210,102,108,2,30,1,1,allow,0,0,Normal
57432,445,0,0,66,66,0,1,0,1,0,drop,0,1,Known Attack
62792,53,0,0,88,88,0,1,0,1,0,deny,0,1,Known Attack
60301,443,3566,443,7515,2022,5493,21,144,11,10,allow,1,0,Potential Threat
57014,445,0,0,66,66,0,1,0,1,0,drop,0,1,Known Attack
49687,53,9331,53,184,102,82,2,30,1,1,allow,0,0,Normal
51457,443,1251,443,334,70,264,5,17,1,4,allow,0,0,Normal
62407,445,0,0,70,70,0,1,0,1,0,drop,0,1,Known Attack
35178,8635,35178,8635,138,78,60,2,5,1,1,allow,1,0,Potential Threat
57470,51413,59920,51413,528,528,0,9,1199,9,0,allow,1,0,Potential Threat
52106,41632,7529,41632,70,70,0,2,9,2,0,allow,1,0,Potential Threat
63943,53,24441,53,509,176,333,6,56,3,3,allow,1,0,Potential Threat
52074,53,21333,53,199,94,105,2,30,1,1,allow,0,0,Normal
50938,443,19392,443,37198,29093,8105,64,17,34,30,allow,1,0,Potential Threat
60883,443,40215,443,11586,5435,6151,46,46,25,21,allow,1,0,Potential Threat
39636,80,39636,80,4774,553,4221,13,20,6,7,allow,1,0,Potential Threat
64499,445,0,0,70,70,0,1,0,1,0,drop,0,1,Known Attack
25523,35974,0,0,62,62,0,1,0,1,0,deny,1,1,High Risk
13963,50584,0,0,66,66,0,1,0,1,0,deny,1,1,High Risk
50682,80,30834,80,5036,4332,704,11,25,6,5,allow,1,0,Potential Threat
58671,445,0,0,70,70,0,1,0,1,0,drop,0,1,Known Attack
53814,443,6695,443,499,425,74,4,0,3,1,allow,0,0,Normal
64671,445,0,0,70,70,0,1,0,1,0,drop,0,1,Known Attack
56663,443,26392,443,9691,2221,7470,16,120,8,8,allow,1,0,Potential Threat
58638,5900,0,0,62,62,0,1,0,1,0,deny,0,1,Known Attack
65289,25174,0,0,66,66,0,1,0,1,0,deny,0,1,Known Attack
53250,445,0,0,70,70,0,1,0,1,0,drop,0,1,Known Attack
34454,80,32778,80,1638,1324,314,10,14,5,5,allow,1,0,Potential Threat
11488,22114,0,0,62,62,0,1,0,1,0,deny,0,1,Known Attack
27005,27016,11653,27016,876,126,750,3,31,2,1,allow,1,0,Potential Threat
54865,443,54865,443,125282,21435,103847,162,20,80,82,allow,1,0,Potential Threat
51818,43942,60184,43942,156,66,90,2,5,1,1,allow,1,0,Potential Threat
44060,443,59243,443,9734,1614,8120,24,170,11,13,allow,1,0,Potential Threat
41052,80,7228,80,1056,682,374,10,15,6,4,allow,1,0,Potential Threat
55593,53,42641,53,193,102,91,2,29,1,1,allow,0,0,Normal
38684,443,33741,443,90449,3289,87160,93,16,28,65,allow,1,0,Potential Threat
50319,53,41804,53,188,96,92,2,31,1,1,allow,0,0,Normal
50641,80,49164,80,1658,1247,411,8,15,5,3,allow,0,0,Normal
50881,50584,0,0,66,66,0,1,0,1,0,deny,0,1,Known Attack
50377,53,9572,53,167,78,89,2,30,1,1,allow,0,0,Normal
59889,30188,0,0,66,66,0,1,0,1,0,deny,0,1,Known Attack
58638,5900,0,0,62,62,0,1,0,1,0,deny,0,1,Known Attack
58801,445,0,0,70,70,0,1,0,1,0,drop,0,1,Known Attack
52888,5223,32740,5223,12302,5509,6793,43,1061,16,27,allow,1,0,Potential Threat
60720,23718,0,0,66,66,0,1,0,1,0,deny,0,1,Known Attack
56104,445,0,0,70,70,0,1,0,1,0,drop,0,1,Known Attack
56820,53,17754,53,199,94,105,2,30,1,1,allow,0,0,Normal
35722,30188,0,0,146,146,0,1,0,1,0,deny,1,1,High Risk
49966,53,59809,53,166,86,80,2,30,1,1,allow,0,0,Normal
55757,53,50237,53,177,94,83,2,30,1,1,allow,0,0,Normal
61078,445,0,0,70,70,0,1,0,1,0,drop,0,1,Known Attack
58897,443,22242,443,5167,700,4467,16,14,7,9,allow,1,0,Potential Threat
12471,48817,0,0,62,62,0,1,0,1,0,deny,1,1,High Risk
33017,443,34545,443,130,70,60,3,4,2,1,allow,0,0,Normal
58865,443,1630,443,505070,16437,488633,543,45,187,356,allow,1,0,Potential Threat
61569,445,0,0,70,70,0,1,0,1,0,drop,0,1,Known Attack
53618,1025,19237,1025,320,140,180,6,7,3,3,allow,0,0,Normal
27005,23010,35544,23010,881,126,755,2,29,1,1,allow,1,0,Potential Threat
20682,57470,0,0,62,62,0,1,0,1,0,deny,1,1,High Risk
51558,37965,0,0,72,72,0,1,0,1,0,deny,0,1,Known Attack
51878,9999,7906,9999,66,66,0,1,5,1,0,allow,1,0,Potential Threat
57288,443,16066,443,7427,2084,5343,24,361,12,12,allow,1,0,Potential Threat
63929,443,53771,443,14647,2365,12282,22,136,10,12,allow,1,0,Potential Threat
61142,445,0,0,70,70,0,1,0,1,0,drop,0,1,Known Attack
65488,53,4906,53,232,110,122,2,29,1,1,allow,0,0,Normal
49311,445,0,0,66,66,0,1,0,1,0,drop,0,1,Known Attack
51800,443,3294,443,36048,2364,33684,54,28,23,31,allow,1,0,Potential Threat
63347,445,0,0,70,70,0,1,0,1,0,drop,0,1,Known Attack
64024,22114,0,0,66,66,0,1,0,1,0,deny,0,1,Known Attack
34787,443,34308,443,13074,2439,10635,46,279,22,24,allow,1,0,Potential Threat
63090,53,11762,53,510,164,346,2,31,1,1,allow,0,0,Normal
10916,44847,0,0,62,62,0,1,0,1,0,deny,1,1,High Risk
47130,80,63322,80,613,539,74,7,15,6,1,allow,1,0,Potential Threat
59486,445,0,0,66,66,0,1,0,1,0,drop,0,1,Known Attack
49402,445,0,0,66,66,0,1,0,1,0,drop,0,1,Known Attack
63459,443,63459,443,4506,1599,2907,19,28,11,8,allow,1,0,Potential Threat
55633,53,30545,53,195,102,93,2,30,1,1,allow,0,0,Normal
63826,80,41744,80,314,192,122,6,15,4,2,allow,0,0,Normal
52757,445,0,0,66,66,0,1,0,1,0,drop,0,1,Known Attack
65481,53,17512,53,168,86,82,2,30,1,1,allow,0,0,Normal
49192,80,39568,80,2807,587,2220,13,16,7,6,allow,0,0,Normal
50987,445,0,0,70,70,0,1,0,1,0,drop,0,1,Known Attack
52917,443,10403,443,5583,1390,4193,19,14,9,10,allow,1,0,Potential Threat
53865,445,0,0,66,66,0,1,0,1,0,drop,0,1,Known Attack
52361,23718,0,0,66,66,0,1,0,1,0,deny,0,1,Known Attack
65332,56205,0,0,66,66,0,1,0,1,0,deny,1,1,High Risk
62077,443,1621,443,17761,7207,10554,44,46,25,19,allow,1,0,Potential Threat
55123,53,62052,53,762,97,665,2,31,1,1,allow,1,0,Potential Threat
45345,443,9986,443,2438,1442,996,21,27,12,9,allow,1,0,Potential Threat
2572,35440,0,0,62,62,0,1,0,1,0,deny,1,1,High Risk
55786,53,43858,53,177,94,83,2,31,1,1,allow,0,0,Normal
51938,80,16530,80,4424,3281,1143,12,27,8,4,allow,1,0,Potential Threat
52474,443,15526,443,14908,4027,10881,28,136,11,17,allow,1,0,Potential Threat
61862,445,0,0,70,70,0,1,0,1,0,drop,0,1,Known Attack
50863,445,0,0,66,66,0,1,0,1,0,drop,0,1,Known Attack
55176,53,15853,53,181,94,87,2,30,1,1,allow,0,0,Normal
51602,22114,0,0,66,66,0,1,0,1,0,deny,0,1,Known Attack
27998,443,50249,443,5515,1388,4127,18,15,9,9,allow,1,0,Potential Threat
59750,443,51830,443,2633,1179,1454,20,74,8,12,allow,1,0,Potential Threat
56652,53,12784,53,198,102,96,2,30,1,1,allow,0,0,Normal
59507,445,0,0,70,70,0,1,0,1,0,drop,0,1,Known Attack
62439,443,62439,443,4507,1600,2907,19,26,11,8,allow,1,0,Potential Threat
55272,53,55902,53,198,110,88,2,30,1,1,allow,0,0,Normal
53427,445,0,0,66,66,0,1,0,1,0,drop,0,1,Known Attack
65099,53,38778,53,199,102,97,2,29,1,1,allow,0,0,Normal
61711,35440,0,0,66,66,0,1,0,1,0,deny,0,1,Known Attack
21542,57470,0,0,74,74,0,1,0,1,0,deny,1,1,High Risk
58638,5900,0,0,62,62,0,1,0,1,0,deny,0,1,Known Attack
44246,5228,57956,5228,19678,4762,14916,98,9851,54,44,allow,1,0,Potential Threat
41996,5900,0,0,60,60,0,1,0,1,0,deny,0,1,Known Attack
54033,443,51149,443,43491,8521,34970,69,50,34,35,allow,1,0,Potential Threat
47453,443,47453,443,4475,1568,2907,19,28,11,8,allow,1,0,Potential Threat
51189,53,6847,53,312,78,234,2,30,1,1,allow,0,0,Normal
50319,443,50669,443,9933,2306,7627,27,82,13,14,allow,1,0,Potential Threat
52029,52093,64487,52093,70,70,0,1,5,1,0,allow,1,0,Potential Threat
60365,443,29839,443,13649,6567,7082,29,127,14,15,allow,1,0,Potential Threat
35106,443,63708,443,309321,13076,296245,368,189,150,218,allow,1,0,Potential Threat
64324,53,8144,53,179,94,85,2,30,1,1,allow,0,0,Normal
63811,445,0,0,70,70,0,1,0,1,0,drop,0,1,Known Attack
54663,443,5282,443,18311,11567,6744,43,363,21,22,allow,1,0,Potential Threat
53564,63344,20702,63344,1721,971,750,15,16,8,7,allow,1,0,Potential Threat
39313,37965,0,0,62,62,0,1,0,1,0,deny,0,1,Known Attack
62102,443,60782,443,3182,1568,1614,8,121,4,4,allow,1,0,Potential Threat
51737,53,3505,53,231,78,153,2,30,1,1,allow,0,0,Normal
50539,80,55226,80,5912,3532,2380,15,31,8,7,allow,1,0,Potential Threat
51886,35965,10726,35965,70,70,0,2,8,2,0,allow,1,0,Potential Threat
50584,16526,25996,16526,166,166,0,1,1199,1,0,allow,1,0,Potential Threat
55689,443,55689,443,177498,9805,167693,244,80,119,125,allow,1,0,Potential Threat
50584,2775,5247,2775,150,150,0,1,1200,1,0,allow,1,0,Potential Threat
56578,25174,0,0,66,66,0,1,0,1,0,deny,0,1,Known Attack
46495,4607,0,0,60,60,0,1,0,1,0,deny,0,1,Known Attack
51795,80,9427,80,3955,2325,1630,18,47,11,7,allow,1,0,Potential Threat
19924,53,19924,53,235,90,145,2,32,1,1,allow,0,0,Normal
1955,35974,0,0,60,60,0,1,0,1,0,deny,1,1,High Risk
39343,443,19498,443,8562,1634,6928,27,26,13,14,allow,1,0,Potential Threat
63895,43729,42252,43729,66,66,0,2,7,2,0,allow,1,0,Potential Threat
65344,445,0,0,70,70,0,1,0,1,0,drop,0,1,Known Attack
33231,443,11220,443,1067,650,417,10,35,6,4,allow,1,0,Potential Threat
51652,80,52729,80,32942,2548,30394,58,255,28,30,allow,1,0,Potential Threat
39473,443,25041,443,11226,3340,7886,28,16,16,12,allow,1,0,Potential Threat
5588,5588,0,0,3562,1936,1626,48,193,24,24,allow,1,0,Potential Threat
58638,5900,0,0,62,62,0,1,0,1,0,deny,0,1,Known Attack
50575,80,13060,80,318,192,126,6,25,4,2,allow,0,0,Normal
32578,443,32578,443,25033,2433,22600,42,25,21,21,allow,1,0,Potential Threat
53733,443,35168,443,499,425,74,4,0,3,1,allow,0,0,Normal
51236,445,0,0,70,70,0,1,0,1,0,drop,0,1,Known Attack
56567,53,28811,53,194,102,92,2,31,1,1,allow,0,0,Normal
63253,445,0,0,70,70,0,1,0,1,0,drop,0,1,Known Attack
52190,29765,3143,29765,70,70,0,2,8,2,0,allow,1,0,Potential Threat
53406,50584,0,0,66,66,0,1,0,1,0,deny,0,1,Known Attack
56948,53,61880,53,183,94,89,2,30,1,1,allow,0,0,Normal
56594,53,16703,53,167,86,81,2,30,1,1,allow,0,0,Normal
62624,443,17860,443,6990,2057,4933,19,121,9,10,allow,1,0,Potential Threat
63336,445,0,0,66,66,0,1,0,1,0,drop,0,1,Known Attack
64982,53,55675,53,215,102,113,2,30,1,1,allow,0,0,Normal
55666,35440,0,0,60,60,0,1,0,1,0,deny,0,1,Known Attack
53447,44847,0,0,66,66,0,1,0,1,0,deny,0,1,Known Attack
50853,50584,0,0,66,66,0,1,0,1,0,deny,0,1,Known Attack
0,0,0,0,600,306,294,6,0,3,3,allow,1,0,Potential Threat
58638,5900,0,0,62,62,0,1,0,1,0,deny,0,1,Known Attack
35187,443,44307,443,27553,21226,6327,57,216,31,26,allow,1,0,Potential Threat
51944,56205,0,0,66,66,0,1,0,1,0,deny,0,1,Known Attack
53766,3596,64680,3596,70,70,0,2,8,2,0,allow,1,0,Potential Threat
53647,16194,65302,16194,70,70,0,2,8,2,0,allow,1,0,Potential Threat
24281,23,0,0,60,60,0,1,0,1,0,deny,0,1,Known Attack
56020,53,46192,53,199,102,97,2,30,1,1,allow,0,0,Normal
56681,53,9758,53,195,102,93,2,30,1,1,allow,0,0,Normal
59155,445,0,0,66,66,0,1,0,1,0,drop,0,1,Known Attack
443,10010,0,0,60,60,0,1,0,1,0,deny,1,1,High Risk
56388,53,30178,53,165,86,79,2,30,1,1,allow,0,0,Normal
47824,53,65037,53,199,94,105,2,30,1,1,allow,1,0,Potential Threat
57023,53,64217,53,174,89,85,2,31,1,1,allow,1,0,Potential Threat
57418,53,27035,53,758,96,662,2,31,1,1,allow,0,0,Normal
53710,80,64568,80,2499,531,1968,11,75,6,5,allow,1,0,Potential Threat
49727,443,62181,443,1461,761,700,15,130,8,7,allow,1,0,Potential Threat
50695,80,16857,80,1426,865,561,9,15,5,4,allow,0,0,Normal
35132,53,35132,53,86,86,0,1,30,1,0,allow,0,0,Normal
57386,53,9687,53,186,95,91,2,31,1,1,allow,0,0,Normal
55646,53,23408,53,182,93,89,2,31,1,1,allow,0,0,Normal
55907,445,0,0,70,70,0,1,0,1,0,drop,0,1,Known Attack
50604,80,39550,80,1658,1247,411,8,15,5,3,allow,0,0,Normal
63516,445,0,0,70,70,0,1,0,1,0,drop,0,1,Known Attack
36036,443,36036,443,261234,32183,229051,326,212,153,173,allow,1,0,Potential Threat
52506,445,0,0,70,70,0,1,0,1,0,drop,0,1,Known Attack
49907,53,52196,53,199,102,97,2,30,1,1,allow,0,0,Normal
51967,12110,50176,12110,70,70,0,2,7,2,0,allow,1,0,Potential Threat
53103,443,15301,443,130,70,60,2,15,1,1,allow,0,0,Normal
50022,53,60834,53,174,89,85,2,31,1,1,allow,0,0,Normal
46887,443,50848,443,118,118,0,1,30,1,0,allow,0,0,Normal
443,62451,0,0,199,199,0,1,0,1,0,deny,1,1,High Risk
64724,53,10875,53,190,97,93,2,31,1,1,allow,0,0,Normal
38643,443,16669,443,2540,1317,1223,17,28,9,8,allow,1,0,Potential Threat
57396,53,7718,53,184,94,90,2,30,1,1,allow,0,0,Normal
55932,53,42862,53,193,102,91,2,30,1,1,allow,0,0,Normal
60864,5223,21557,5223,6278,2408,3870,27,3600,15,12,allow,1,0,Potential Threat
38211,443,38211,443,4653,1746,2907,19,26,11,8,allow,1,0,Potential Threat
57594,80,6266,80,486,280,206,8,25,5,3,allow,0,0,Normal
64546,53,11850,53,183,94,89,2,29,1,1,allow,0,0,Normal
64880,445,0,0,70,70,0,1,0,1,0,drop,0,1,Known Attack
63118,7000,63118,7000,3310,1535,1775,15,15,8,7,allow,1,0,Potential Threat
27005,27015,17359,27015,878,126,752,2,30,1,1,allow,1,0,Potential Threat
50374,53,63648,53,755,102,653,2,29,1,1,allow,1,0,Potential Threat
65102,53,35796,53,183,94,89,2,30,1,1,allow,0,0,Normal
58912,443,7357,443,7941,5160,2781,25,17,13,12,allow,1,0,Potential Threat
46654,80,33249,80,1518,954,564,14,320,8,6,allow,1,0,Potential Threat
49323,53,45688,53,192,98,94,2,30,1,1,allow,0,0,Normal
14641,443,14641,443,254281,66535,187746,336,317,183,153,allow,1,0,Potential Threat
49480,80,65349,80,6811,3791,3020,23,115,13,10,allow,1,0,Potential Threat
15131,50584,0,0,62,62,0,1,0,1,0,deny,1,1,High Risk
27005,37569,24512,37569,880,126,754,2,30,1,1,allow,1,0,Potential Threat
44907,5900,44907,5900,130,66,64,2,4,1,1,allow,1,0,Potential Threat
52364,445,0,0,66,66,0,1,0,1,0,drop,0,1,Known Attack
51892,46647,6843,46647,70,70,0,1,5,1,0,allow,1,0,Potential Threat
45458,443,14560,443,7144,4917,2227,36,561,18,18,allow,1,0,Potential Threat
65477,443,34529,443,409770,12150,397620,421,16,148,273,allow,1,0,Potential Threat
49834,445,0,0,70,70,0,1,0,1,0,drop,0,1,Known Attack
59794,443,46382,443,408,78,330,6,25,1,5,allow,0,0,Normal
52093,443,48994,443,3687037,41923,3645114,3002,34,534,2468,allow,1,0,Potential Threat
55036,443,33915,443,36364,9639,26725,62,53,31,31,allow,1,0,Potential Threat
62800,80,25172,80,1437,659,778,11,45,6,5,allow,1,0,Potential Threat
64743,443,34069,443,31480,1953,29527,54,196,20,34,allow,1,0,Potential Threat
61210,445,0,0,70,70,0,1,0,1,0,drop,0,1,Known Attack
8999,42873,0,0,146,146,0,1,0,1,0,deny,1,1,High Risk
56000,53,40530,53,170,87,83,2,31,1,1,allow,0,0,Normal
59923,53,29358,53,197,78,119,2,30,1,1,allow,0,0,Normal
52636,445,0,0,70,70,0,1,0,1,0,drop,0,1,Known Attack
27450,443,32260,443,10099,1635,8464,31,83,14,17,allow,1,0,Potential Threat
55856,53,9134,53,1410,93,1317,4,59,2,2,allow,0,0,Normal
65474,53,42125,53,197,94,103,2,29,1,1,allow,0,0,Normal
64089,53,25036,53,188,96,92,2,31,1,1,allow,0,0,Normal
63973,53,57018,53,346,98,248,4,31,2,2,allow,0,0,Normal
64618,53,41913,53,305,100,205,4,54,2,2,allow,0,0,Normal
50346,445,0,0,66,66,0,1,0,1,0,drop,0,1,Known Attack
52447,443,48925,443,7980,5952,2028,22,99,12,10,allow,1,0,Potential Threat
51585,443,25112,443,2840,330,2510,12,135,5,7,allow,1,0,Potential Threat
56951,53,31366,53,168,86,82,2,29,1,1,allow,0,0,Normal
57231,53,57692,53,168,86,82,2,32,1,1,allow,0,0,Normal
64114,443,8780,443,1411,852,559,13,24,7,6,allow,1,0,Potential Threat
53249,443,44486,443,11150,2012,9138,29,67,14,15,allow,1,0,Potential Threat
65521,443,8234,443,92427,4519,87908,105,15,39,66,allow,1,0,Potential Threat
52847,445,0,0,70,70,0,1,0,1,0,drop,0,1,Known Attack
56323,53,5698,53,152,78,74,2,30,1,1,allow,0,0,Normal
58638,5900,0,0,62,62,0,1,0,1,0,deny,0,1,Known Attack
6881,6882,26617,6882,231,111,120,2,1200,1,1,allow,1,0,Potential Threat
48840,443,52863,443,3297,2327,970,22,51,11,11,allow,1,0,Potential Threat
49665,53,15025,53,168,86,82,2,29,1,1,allow,0,0,Normal
49097,80,63676,80,1739,740,999,17,235,5,12,allow,1,0,Potential Threat
55106,53,60018,53,184,94,90,2,29,1,1,allow,0,0,Normal
22408,22114,0,0,66,66,0,1,0,1,0,deny,0,1,Known Attack
55679,445,0,0,66,66,0,1,0,1,0,drop,0,1,Known Attack
59437,445,0,0,70,70,0,1,0,1,0,drop,0,1,Known Attack
64789,53,27915,53,199,102,97,2,30,1,1,allow,0,0,Normal
57500,23,0,0,60,60,0,1,0,1,0,deny,0,1,Known Attack
52034,26467,0,0,62,62,0,1,0,1,0,deny,0,1,Known Attack
51620,56205,0,0,66,66,0,1,0,1,0,deny,0,1,Known Attack
64995,27023,24538,27023,1773,924,849,6,30,3,3,allow,1,0,Potential Threat
53124,443,9153,443,64407,55712,8695,92,364,58,34,allow,1,0,Potential Threat
58126,443,22478,443,3179,954,2225,10,120,5,5,allow,1,0,Potential Threat
45682,25604,0,0,62,62,0,1,0,1,0,deny,0,1,Known Attack
39615,443,10074,443,6133,1343,4790,22,275,12,10,allow,1,0,Potential Threat
64034,445,0,0,66,66,0,1,0,1,0,drop,0,1,Known Attack
49745,443,54598,443,4043,1781,2262,19,128,11,8,allow,1,0,Potential Threat
51032,445,0,0,66,66,0,1,0,1,0,drop,0,1,Known Attack
57343,53,25885,53,181,94,87,2,30,1,1,allow,0,0,Normal
62405,445,0,0,70,70,0,1,0,1,0,drop,0,1,Known Attack
63381,443,50807,443,11344,5681,5663,34,3601,20,14,allow,1,0,Potential Threat
57028,8080,10225,8080,78,78,0,2,8,2,0,allow,1,0,Potential Threat
55678,32468,0,0,66,66,0,1,0,1,0,deny,0,1,Known Attack
60129,80,34372,80,2910,1439,1471,12,31,7,5,allow,1,0,Potential Threat
34999,25864,0,0,74,74,0,1,0,1,0,deny,0,1,Known Attack
64686,445,0,0,70,70,0,1,0,1,0,drop,0,1,Known Attack
56611,443,45204,443,7983,1963,6020,20,15,11,9,allow,1,0,Potential Threat
53760,45682,20604,45682,70,70,0,1,4,1,0,allow,1,0,Potential Threat
55079,25174,0,0,62,62,0,1,0,1,0,deny,0,1,Known Attack
49181,53,15171,53,491,98,393,4,40,2,2,allow,0,0,Normal
45304,64147,0,0,72,72,0,1,0,1,0,deny,1,1,High Risk
38562,443,38562,443,4611,1704,2907,19,28,11,8,allow,1,0,Potential Threat
46518,44847,0,0,62,62,0,1,0,1,0,deny,0,1,Known Attack
37612,443,15502,443,499,425,74,4,0,3,1,allow,0,0,Normal
57244,443,45761,443,230914,10401,220513,290,76,121,169,allow,1,0,Potential Threat
37636,443,48056,443,9658,2602,7056,32,66,14,18,allow,1,0,Potential Threat
64459,53,56371,53,251,94,157,2,29,1,1,allow,0,0,Normal
56673,53,13818,53,186,95,91,2,31,1,1,allow,0,0,Normal
61730,25320,0,0,62,62,0,1,0,1,0,deny,0,1,Known Attack
50307,443,61889,443,1786,172,1614,7,120,3,4,allow,1,0,Potential Threat
56257,53,40398,53,177,94,83,2,29,1,1,allow,0,0,Normal
51271,37965,0,0,66,66,0,1,0,1,0,deny,0,1,Known Attack
53214,445,0,0,70,70,0,1,0,1,0,drop,0,1,Known Attack
4862,37965,0,0,66,66,0,1,0,1,0,deny,1,1,High Risk
42414,50939,0,0,148,148,0,1,0,1,0,deny,1,1,High Risk
64099,55470,5838,55470,66,66,0,2,8,2,0,allow,1,0,Potential Threat
51982,443,54748,443,9010,2779,6231,30,361,15,15,allow,1,0,Potential Threat
47013,37965,0,0,62,62,0,1,0,1,0,deny,0,1,Known Attack
54721,445,0,0,70,70,0,1,0,1,0,drop,0,1,Known Attack
21274,30188,0,0,62,62,0,1,0,1,0,deny,0,1,Known Attack
63731,26467,0,0,66,66,0,1,0,1,0,deny,0,1,Known Attack
61203,445,0,0,70,70,0,1,0,1,0,drop,0,1,Known Attack
65183,445,0,0,70,70,0,1,0,1,0,drop,0,1,Known Attack
49403,53,28281,53,228,102,126,2,29,1,1,allow,0,0,Normal
50920,443,56379,443,3440,2371,1069,17,96,10,7,allow,1,0,Potential Threat
60265,443,40784,443,11048,3161,7887,26,24,15,11,allow,1,0,Potential Threat
56773,53,53330,53,183,94,89,2,29,1,1,allow,0,0,Normal
53161,443,30923,443,2731,1895,836,18,28,10,8,allow,0,0,Normal
64520,53,30136,53,198,102,96,2,31,1,1,allow,0,0,Normal
64995,53,32093,53,199,102,97,2,30,1,1,allow,0,0,Normal
49910,53,38613,53,218,94,124,2,30,1,1,allow,0,0,Normal
55095,53,28399,53,194,102,92,2,30,1,1,allow,0,0,Normal
26698,57470,0,0,62,62,0,1,0,1,0,deny,1,1,High Risk
56773,28093,43311,28093,70,70,0,1,5,1,0,allow,1,0,Potential Threat
63917,57826,24551,57826,66,66,0,2,7,2,0,allow,1,0,Potential Threat
57562,445,0,0,70,70,0,1,0,1,0,drop,0,1,Known Attack
57625,443,18316,443,4751,909,3842,15,16,9,6,allow,1,0,Potential Threat
64822,445,0,0,70,70,0,1,0,1,0,drop,0,1,Known Attack
55478,53,55747,53,177,94,83,2,30,1,1,allow,0,0,Normal
50882,80,51896,80,207895,10483,197412,229,141,90,139,allow,1,0,Potential Threat
46569,443,56973,443,6409,984,5425,21,360,11,10,allow,1,0,Potential Threat
5757,80,5757,80,104444,4047,100397,122,126,52,70,allow,1,0,Potential Threat
30960,45741,31412,45741,330,330,0,6,3609,6,0,allow,1,0,Potential Threat
27005,27015,51947,27015,879,126,753,2,30,1,1,allow,1,0,Potential Threat
52829,443,52829,443,4613,1706,2907,19,30,11,8,allow,1,0,Potential Threat
64637,53,39523,53,194,102,92,2,31,1,1,allow,0,0,Normal
50749,443,38979,443,4749,1897,2852,16,124,8,8,allow,1,0,Potential Threat
60057,445,0,0,70,70,0,1,0,1,0,drop,0,1,Known Attack
55223,443,2473,443,1118883,33814,1085069,1206,48,451,755,allow,1,0,Potential Threat
51827,48432,37555,48432,164,70,94,2,4,1,1,allow,1,0,Potential Threat
65529,53,6825,53,198,102,96,2,29,1,1,allow,0,0,Normal
55755,53,57482,53,779,86,693,2,30,1,1,allow,0,0,Normal
60350,51505,0,0,66,66,0,1,0,1,0,deny,0,1,Known Attack
56713,53,30137,53,226,110,116,2,30,1,1,allow,0,0,Normal
65321,445,0,0,66,66,0,1,0,1,0,drop,0,1,Known Attack
64089,53,3452,53,194,102,92,2,31,1,1,allow,0,0,Normal
50588,80,50588,80,2765,1835,930,14,21,8,6,allow,1,0,Potential Threat
14263,22114,0,0,62,62,0,1,0,1,0,deny,0,1,Known Attack
65231,50584,0,0,66,66,0,1,0,1,0,deny,1,1,High Risk
56972,53,24503,53,177,94,83,2,30,1,1,allow,0,0,Normal
55975,53,65159,53,190,97,93,2,30,1,1,allow,1,0,Potential Threat
57071,53,59373,53,166,86,80,2,30,1,1,allow,0,0,Normal
61911,3855,0,0,146,146,0,1,0,1,0,deny,0,1,Known Attack
49418,27015,63355,27015,244,78,166,2,30,1,1,allow,1,0,Potential Threat
60889,443,46801,443,9959,2430,7529,27,46,16,11,allow,1,0,Potential Threat
56654,53,22372,53,209,110,99,2,30,1,1,allow,0,0,Normal
56665,443,40335,443,8058,2038,6020,20,15,11,9,allow,1,0,Potential Threat
37185,443,49991,443,14035,8420,5615,31,256,18,13,allow,1,0,Potential Threat
64312,53,39914,53,209,110,99,2,30,1,1,allow,0,0,Normal
57591,443,27521,443,2614,1689,925,18,20,10,8,allow,1,0,Potential Threat
58305,443,38970,443,11659,1027,10632,25,29,11,14,allow,1,0,Potential Threat
45941,23386,0,0,60,60,0,1,0,1,0,deny,0,1,Known Attack
62892,993,17111,993,9588,4811,4777,85,193,49,36,allow,1,0,Potential Threat
17129,53,49932,53,225,78,147,2,31,1,1,allow,1,0,Potential Threat
3023,40108,0,0,148,148,0,1,0,1,0,deny,1,1,High Risk
57743,445,0,0,70,70,0,1,0,1,0,drop,0,1,Known Attack
46812,80,23325,80,1137,679,458,10,15,6,4,allow,0,0,Normal
56829,53,52849,53,185,102,83,2,30,1,1,allow,0,0,Normal
50292,22114,0,0,62,62,0,1,0,1,0,deny,0,1,Known Attack
13171,53,13171,53,404,259,145,3,32,2,1,allow,1,0,Potential Threat
52690,7302,0,0,66,66,0,1,0,1,0,deny,0,1,Known Attack
55936,53,60791,53,177,94,83,2,30,1,1,allow,0,0,Normal
49659,445,0,0,66,66,0,1,0,1,0,drop,0,1,Known Attack
52808,445,0,0,66,66,0,1,0,1,0,drop,0,1,Known Attack
58123,80,21790,80,3641,1784,1857,19,375,10,9,allow,1,0,Potential Threat
55225,11392,0,0,66,66,0,1,0,1,0,deny,0,1,Known Attack
55057,53,28590,53,188,80,108,2,31,1,1,allow,0,0,Normal
49380,53,64533,53,199,102,97,2,30,1,1,allow,1,0,Potential Threat
49418,27017,46358,27017,252,71,181,2,30,1,1,allow,1,0,Potential Threat
55271,53,61756,53,751,95,656,2,31,1,1,allow,1,0,Potential Threat
53157,445,0,0,70,70,0,1,0,1,0,drop,0,1,Known Attack
52989,51505,0,0,66,66,0,1,0,1,0,deny,0,1,Known Attack
57376,445,0,0,66,66,0,1,0,1,0,drop,0,1,Known Attack
9204,443,60040,443,5399,368,5031,18,31,5,13,allow,1,0,Potential Threat
57904,443,36166,443,4042,2515,1527,28,169,14,14,allow,1,0,Potential Threat
35052,80,38624,80,350,210,140,6,30,4,2,allow,0,0,Normal
52168,445,0,0,66,66,0,1,0,1,0,drop,0,1,Known Attack
64191,53,17402,53,264,110,154,2,30,1,1,allow,0,0,Normal
58127,445,0,0,66,66,0,1,0,1,0,drop,0,1,Known Attack
54996,445,0,0,70,70,0,1,0,1,0,drop,0,1,Known Attack
54025,53,41690,53,578,286,292,9,0,5,4,allow,0,0,Normal
53701,8999,10439,8999,1328,960,368,10,32,5,5,allow,1,0,Potential Threat
54118,6004,0,0,66,66,0,1,0,1,0,deny,0,1,Known Attack
59225,57587,0,0,66,66,0,1,0,1,0,deny,1,1,High Risk
6881,37232,47143,37232,502,150,352,2,1199,1,1,allow,1,0,Potential Threat
36567,443,58934,443,2341,1054,1287,20,299,7,13,allow,1,0,Potential Threat
57161,53,1657,53,711,87,624,2,30,1,1,allow,0,0,Normal
49157,53,4191,53,184,94,90,2,30,1,1,allow,0,0,Normal
61143,8080,0,0,60,60,0,1,0,1,0,deny,0,1,Known Attack
40959,61903,0,0,145,145,0,1,0,1,0,deny,1,1,High Risk
65357,53,31464,53,256,93,163,2,30,1,1,allow,0,0,Normal
56864,15646,51512,15646,70,70,0,2,8,2,0,allow,1,0,Potential Threat
50265,44822,26867,44822,149,149,0,1,1200,1,0,allow,1,0,Potential Threat
30084,21247,0,0,146,146,0,1,0,1,0,deny,1,1,High Risk
49842,7302,0,0,62,62,0,1,0,1,0,deny,0,1,Known Attack
50309,80,22924,80,2481,723,1758,12,57,6,6,allow,0,0,Normal
57525,445,0,0,66,66,0,1,0,1,0,drop,0,1,Known Attack
51506,443,39609,443,4869,699,4170,14,15,8,6,allow,1,0,Potential Threat
56505,443,54192,443,78426,3219,75207,98,96,37,61,allow,1,0,Potential Threat
53212,445,0,0,70,70,0,1,0,1,0,drop,0,1,Known Attack
15899,37807,0,0,146,146,0,1,0,1,0,deny,1,1,High Risk
53676,3678,50673,3678,70,70,0,1,4,1,0,allow,1,0,Potential Threat
56761,53,40671,53,788,108,680,2,30,1,1,allow,0,0,Normal
55666,53,45375,53,211,102,109,2,30,1,1,allow,0,0,Normal
51431,445,0,0,70,70,0,1,0,1,0,drop,0,1,Known Attack
38721,443,64394,443,10216,3380,6836,26,120,12,14,allow,1,0,Potential Threat
52537,37965,0,0,66,66,0,1,0,1,0,deny,0,1,Known Attack
17579,57470,0,0,62,62,0,1,0,1,0,deny,1,1,High Risk
51232,23,0,0,60,60,0,1,0,1,0,deny,0,1,Known Attack
62362,445,0,0,70,70,0,1,0,1,0,drop,0,1,Known Attack
59448,445,0,0,70,70,0,1,0,1,0,drop,0,1,Known Attack
46734,50265,0,0,74,74,0,1,0,1,0,deny,0,1,Known Attack
53843,17556,3555,17556,320,140,180,6,7,3,3,allow,1,0,Potential Threat
60422,443,51829,443,7274,1925,5349,24,138,12,12,allow,1,0,Potential Threat
51976,11816,61215,11816,70,70,0,2,8,2,0,allow,1,0,Potential Threat
4544,3478,63036,3478,338,110,228,2,299,1,1,allow,1,0,Potential Threat
53600,445,0,0,70,70,0,1,0,1,0,drop,0,1,Known Attack
55159,53,17196,53,168,86,82,2,30,1,1,allow,0,0,Normal
53163,32834,49682,32834,70,70,0,1,5,1,0,allow,1,0,Potential Threat
50136,445,0,0,70,70,0,1,0,1,0,drop,0,1,Known Attack
56602,53,21237,53,197,102,95,2,30,1,1,allow,0,0,Normal
51388,443,52372,443,20351,3359,16992,52,103,27,25,allow,1,0,Potential Threat
52431,64147,0,0,62,62,0,1,0,1,0,deny,1,1,High Risk
57084,443,60490,443,9905,4321,5584,27,315,13,14,allow,1,0,Potential Threat
43440,80,5073,80,2093,825,1268,12,45,7,5,allow,1,0,Potential Threat
64049,1029,15442,1029,70,70,0,1,5,1,0,allow,0,0,Normal
63135,443,47015,443,7127,1737,5390,18,16,10,8,allow,1,0,Potential Threat
22677,25174,0,0,66,66,0,1,0,1,0,deny,0,1,Known Attack
16387,22226,0,0,60,60,0,1,61,1,0,allow,1,0,Potential Threat
57226,443,27047,443,7924,2027,5897,23,22,14,9,allow,1,0,Potential Threat
52207,443,22846,443,74711,8646,66065,150,89,70,80,allow,1,0,Potential Threat
55578,45682,64868,45682,70,70,0,1,5,1,0,allow,1,0,Potential Threat
49418,27014,18652,27014,249,78,171,2,31,1,1,allow,1,0,Potential Threat
56357,53,47293,53,196,102,94,2,30,1,1,allow,0,0,Normal
5588,5588,0,0,3354,1792,1562,46,193,23,23,allow,1,0,Potential Threat
57987,56125,0,0,90,90,0,1,0,1,0,deny,1,1,High Risk
59908,445,0,0,70,70,0,1,0,1,0,drop,0,1,Known Attack
36158,443,62102,443,7848,2137,5711,23,25,13,10,allow,1,0,Potential Threat
56801,21916,14491,21916,316,136,180,6,7,3,3,allow,1,0,Potential Threat
41002,53,33121,53,164,78,86,2,30,1,1,allow,0,0,Normal
43900,443,13168,443,442,250,192,8,25,5,3,allow,0,0,Normal
58226,52848,0,0,145,145,0,1,0,1,0,deny,1,1,High Risk
52128,37807,0,0,62,62,0,1,0,1,0,deny,0,1,Known Attack
33898,80,33898,80,14448,2001,12447,26,16,14,12,allow,1,0,Potential Threat
49777,443,39129,443,8638,2215,6423,24,126,14,10,allow,1,0,Potential Threat
59630,445,0,0,66,66,0,1,0,1,0,drop,0,1,Known Attack
46155,443,27543,443,206090,6478,199612,211,170,69,142,allow,1,0,Potential Threat
51852,18636,28064,18636,136,136,0,3,13,3,0,allow,1,0,Potential Threat
64627,53,3343,53,199,102,97,2,31,1,1,allow,0,0,Normal
34158,53,34158,53,217,87,130,2,30,1,1,allow,0,0,Normal
58642,445,0,0,66,66,0,1,0,1,0,drop,0,1,Known Attack
51930,57470,0,0,62,62,0,1,0,1,0,deny,0,1,Known Attack
54486,443,15577,443,3170,1036,2134,13,135,6,7,allow,1,0,Potential Threat
3937,36829,0,0,62,62,0,1,0,1,0,deny,1,1,High Risk
64986,53,34295,53,183,94,89,2,30,1,1,allow,0,0,Normal
2697,28189,0,0,60,60,0,1,0,1,0,deny,1,1,High Risk
55877,53546,37144,53546,481,150,331,2,1200,1,1,allow,1,0,Potential Threat
59734,443,60915,443,512,166,346,2,29,1,1,allow,1,0,Potential Threat
56630,445,0,0,66,66,0,1,0,1,0,drop,0,1,Known Attack
65482,443,27020,443,6762,3351,3411,31,160,14,17,allow,1,0,Potential Threat
57196,53,50893,53,182,93,89,2,30,1,1,allow,0,0,Normal
52924,443,13021,443,5583,1390,4193,19,15,9,10,allow,1,0,Potential Threat
56265,445,0,0,66,66,0,1,0,1,0,drop,0,1,Known Attack
57470,38871,35688,38871,545,166,379,2,1199,1,1,allow,1,0,Potential Threat
50017,443,23366,443,56408,47400,9008,88,138,49,39,allow,1,0,Potential Threat
57308,443,32709,443,8837,3033,5804,44,16,24,20,allow,1,0,Potential Threat
58738,445,0,0,66,66,0,1,0,1,0,drop,0,1,Known Attack
61428,443,21919,443,7276,1763,5513,22,77,12,10,allow,1,0,Potential Threat
55340,53,32896,53,184,94,90,2,31,1,1,allow,0,0,Normal
12694,12446,0,0,145,145,0,1,0,1,0,deny,1,1,High Risk
40309,443,48693,443,51588,40242,11346,107,418,53,54,allow,1,0,Potential Threat
59732,27036,24754,27036,1218,924,294,6,30,3,3,allow,1,0,Potential Threat
57593,28678,11489,28678,1806,1806,0,22,225,22,0,allow,1,0,Potential Threat
50407,53,51161,53,749,89,660,2,31,1,1,allow,0,0,Normal
56138,53,30181,53,284,94,190,2,29,1,1,allow,0,0,Normal
52020,445,0,0,66,66,0,1,0,1,0,drop,0,1,Known Attack
63836,14791,37606,14791,70,70,0,1,4,1,0,allow,1,0,Potential Threat
56843,53,63293,53,177,94,83,2,30,1,1,allow,1,0,Potential Threat
26496,80,26496,80,160989,10162,150827,189,31,81,108,allow,1,0,Potential Threat
53886,443,40309,443,499,425,74,4,0,3,1,allow,0,0,Normal
44258,25,0,0,74,74,0,1,0,1,0,deny,0,1,Known Attack
64432,53,49029,53,168,86,82,2,30,1,1,allow,0,0,Normal
10248,21247,0,0,62,62,0,1,0,1,0,deny,0,1,Known Attack
51862,80,9823,80,6106,5420,686,13,30,7,6,allow,1,0,Potential Threat
60863,53,60863,53,298,114,184,2,30,1,1,allow,0,0,Normal
58483,445,0,0,70,70,0,1,0,1,0,drop,0,1,Known Attack
41050,443,28705,443,137809,4697,133112,153,170,55,98,allow,1,0,Potential Threat
48066,443,56844,443,62,62,0,1,4,1,0,allow,0,0,Normal
57972,445,0,0,66,66,0,1,0,1,0,drop,0,1,Known Attack
20508,57470,0,0,62,62,0,1,0,1,0,deny,1,1,High Risk
49724,53,13142,53,183,94,89,2,30,1,1,allow,0,0,Normal
443,64347,0,0,60,60,0,1,0,1,0,deny,1,1,High Risk
49597,80,42235,80,130,70,60,2,15,1,1,allow,0,0,Normal
57150,53,61382,53,166,86,80,2,31,1,1,allow,0,0,Normal
59944,80,51806,80,1186,390,796,9,16,5,4,allow,1,0,Potential Threat
53638,443,51723,443,24895,2856,22039,46,270,22,24,allow,1,0,Potential Threat
49537,53,25046,53,269,96,173,4,59,2,2,allow,0,0,Normal
56137,53,13627,53,198,101,97,2,30,1,1,allow,0,0,Normal
49671,53,37210,53,182,93,89,2,31,1,1,allow,0,0,Normal
58029,80,1723,80,374,192,182,7,21,4,3,allow,0,0,Normal
443,9986,0,0,669,669,0,1,0,1,0,deny,1,1,High Risk
53240,443,55808,443,14932,1671,13261,31,69,15,16,allow,1,0,Potential Threat
60983,443,50042,443,7458,2832,4626,26,16,15,11,allow,1,0,Potential Threat
64155,53,12235,53,183,94,89,2,30,1,1,allow,0,0,Normal
64060,53,33741,53,258,110,148,2,30,1,1,allow,0,0,Normal
59395,443,39581,443,5817,1995,3822,19,16,10,9,allow,1,0,Potential Threat
55260,445,0,0,70,70,0,1,0,1,0,drop,0,1,Known Attack
65064,30188,0,0,66,66,0,1,0,1,0,deny,0,1,Known Attack
50991,445,0,0,66,66,0,1,0,1,0,drop,0,1,Known Attack
56662,445,0,0,66,66,0,1,0,1,0,drop,0,1,Known Attack
49356,53,31614,53,209,102,107,2,30,1,1,allow,0,0,Normal
49257,445,0,0,70,70,0,1,0,1,0,drop,0,1,Known Attack
58638,5900,0,0,62,62,0,1,0,1,0,deny,0,1,Known Attack
52884,443,37471,443,4466,1914,2552,32,116,18,14,allow,1,0,Potential Threat
49197,30188,0,0,62,62,0,1,0,1,0,deny,0,1,Known Attack
56878,53,41614,53,168,86,82,2,30,1,1,allow,0,0,Normal
57322,53,63683,53,196,102,94,2,31,1,1,allow,1,0,Potential Threat
60761,51221,0,0,66,66,0,1,0,1,0,deny,0,1,Known Attack
58813,445,0,0,66,66,0,1,0,1,0,drop,0,1,Known Attack
58600,53,58600,53,217,82,135,2,32,1,1,allow,0,0,Normal
55009,53,51311,53,241,78,163,2,30,1,1,allow,0,0,Normal
35812,1,0,0,146,146,0,1,0,1,0,deny,0,1,Known Attack
57425,53,32563,53,168,86,82,2,30,1,1,allow,0,0,Normal
62732,443,28854,443,50000,36438,13562,98,336,61,37,allow,1,0,Potential Threat
62339,443,17791,443,9125,2616,6509,30,76,14,16,allow,1,0,Potential Threat
57340,53,41414,53,711,87,624,2,30,1,1,allow,0,0,Normal
55342,443,55342,443,5593,2346,3247,22,39,13,9,allow,1,0,Potential Threat
62020,445,0,0,70,70,0,1,0,1,0,drop,0,1,Known Attack
51961,445,0,0,70,70,0,1,0,1,0,drop,0,1,Known Attack
65401,445,0,0,66,66,0,1,0,1,0,drop,0,1,Known Attack
64117,53,35902,53,350,94,256,2,29,1,1,allow,0,0,Normal
56815,443,53722,443,7903,1914,5989,20,15,11,9,allow,1,0,Potential Threat
65073,80,65073,80,169702,10513,159189,187,23,72,115,allow,1,0,Potential Threat
50156,53,2104,53,777,87,690,2,0,1,1,allow,0,0,Normal
64862,445,0,0,70,70,0,1,0,1,0,drop,0,1,Known Attack
53138,443,15464,443,6760,1346,5414,18,325,9,9,allow,1,0,Potential Threat
64789,443,4787,443,1786,172,1614,7,121,3,4,allow,1,0,Potential Threat
61452,53,0,0,223,89,134,2,30,1,1,allow,0,0,Normal
44815,36829,0,0,62,62,0,1,0,1,0,deny,0,1,Known Attack
58921,443,47044,443,10782,7193,3589,30,16,17,13,allow,1,0,Potential Threat
58638,5900,0,0,62,62,0,1,0,1,0,deny,0,1,Known Attack
64668,53,32390,53,772,103,669,2,31,1,1,allow,0,0,Normal
36668,443,55888,443,142299,120615,21684,348,336,180,168,allow,1,0,Potential Threat
60508,445,0,0,66,66,0,1,0,1,0,drop,0,1,Known Attack
21133,11342,54289,11342,478,149,329,2,1200,1,1,allow,1,0,Potential Threat
37672,5223,8222,5223,110,110,0,1,5,1,0,allow,1,0,Potential Threat
43411,443,13391,443,2895,726,2169,10,121,5,5,allow,1,0,Potential Threat
56070,445,0,0,70,70,0,1,0,1,0,drop,0,1,Known Attack
47725,443,52489,443,502,250,252,9,32,5,4,allow,0,0,Normal
49724,53,34584,53,210,102,108,2,30,1,1,allow,0,0,Normal
35078,443,8054,443,234,234,0,4,12,4,0,allow,0,0,Normal
64034,17935,14010,17935,66,66,0,2,8,2,0,allow,1,0,Potential Threat
51939,34393,16792,34393,70,70,0,1,5,1,0,allow,1,0,Potential Threat
51187,445,0,0,66,66,0,1,0,1,0,drop,0,1,Known Attack
27651,53,46551,53,225,78,147,2,30,1,1,allow,0,0,Normal
58638,5900,0,0,62,62,0,1,0,1,0,deny,0,1,Known Attack
65115,50584,0,0,66,66,0,1,0,1,0,deny,1,1,High Risk
47089,22114,0,0,146,146,0,1,0,1,0,deny,1,1,High Risk
59886,445,0,0,70,70,0,1,0,1,0,drop,0,1,Known Attack
54955,445,0,0,66,66,0,1,0,1,0,drop,0,1,Known Attack
64964,53,28757,53,197,102,95,2,31,1,1,allow,0,0,Normal
63520,445,0,0,66,66,0,1,0,1,0,drop,0,1,Known Attack
34212,11392,0,0,66,66,0,1,0,1,0,deny,0,1,Known Attack
50005,53,45437,53,295,101,194,4,30,2,2,allow,0,0,Normal
59509,64147,0,0,145,145,0,1,0,1,0,deny,1,1,High Risk
55199,53,53506,53,214,110,104,2,31,1,1,allow,0,0,Normal
54892,445,0,0,70,70,0,1,0,1,0,drop,0,1,Known Attack
54121,445,0,0,66,66,0,1,0,1,0,drop,0,1,Known Attack
56115,445,0,0,66,66,0,1,0,1,0,drop,0,1,Known Attack
53370,445,0,0,66,66,0,1,0,1,0,drop,0,1,Known Attack
33886,65504,0,0,162,162,0,1,0,1,0,deny,1,1,High Risk
52248,443,56929,443,190,70,120,4,15,2,2,allow,0,0,Normal
46908,80,46908,80,5464,713,4751,15,16,8,7,allow,1,0,Potential Threat
55264,53,35896,53,170,87,83,2,30,1,1,allow,0,0,Normal
49198,53,16713,53,261,94,167,2,29,1,1,allow,0,0,Normal
56078,53,50373,53,178,94,84,2,29,1,1,allow,0,0,Normal
53829,443,25937,443,499,425,74,4,0,3,1,allow,0,0,Normal
51774,80,22011,80,240,120,120,5,27,3,2,allow,0,0,Normal
63467,37807,0,0,62,62,0,1,0,1,0,deny,0,1,Known Attack
50040,443,40234,443,1097,654,443,12,86,7,5,allow,1,0,Potential Threat
43571,26467,0,0,62,62,0,1,0,1,0,deny,0,1,Known Attack
50474,80,43879,80,19357,10244,9113,36,27,19,17,allow,1,0,Potential Threat
63868,60392,13062,60392,70,70,0,1,4,1,0,allow,1,0,Potential Threat
51943,80,43908,80,306,120,186,6,27,3,3,allow,0,0,Normal
58638,5900,0,0,62,62,0,1,0,1,0,deny,0,1,Known Attack
55851,53,30574,53,183,102,81,2,30,1,1,allow,0,0,Normal
54677,443,15752,443,3704,1428,2276,14,135,7,7,allow,1,0,Potential Threat
59925,443,55867,443,10302,3853,6449,27,61,16,11,allow,1,0,Potential Threat
58002,80,62017,80,2362,1608,754,22,80,12,10,allow,1,0,Potential Threat
65469,445,0,0,66,66,0,1,0,1,0,drop,0,1,Known Attack
58829,445,0,0,66,66,0,1,0,1,0,drop,0,1,Known Attack
1024,57470,0,0,62,62,0,1,0,1,0,deny,1,1,High Risk
47668,443,3195,443,69732,65832,3900,104,316,55,49,allow,1,0,Potential Threat
48817,58518,48817,58518,580,121,459,4,1199,2,2,allow,1,0,Potential Threat
1025,46232,0,0,145,145,0,1,0,1,0,deny,1,1,High Risk
62284,443,22217,443,3419,1275,2144,13,135,6,7,allow,1,0,Potential Threat
64385,53,34139,53,174,89,85,2,30,1,1,allow,0,0,Normal
56577,53,47746,53,198,110,88,2,30,1,1,allow,0,0,Normal
64586,50584,0,0,146,146,0,1,0,1,0,deny,1,1,High Risk
57290,53,13860,53,178,94,84,2,30,1,1,allow,0,0,Normal
61955,445,0,0,70,70,0,1,0,1,0,drop,0,1,Known Attack
51996,35440,0,0,66,66,0,1,0,1,0,deny,0,1,Known Attack
40923,53,40923,53,200,90,110,2,29,1,1,allow,0,0,Normal
19096,64147,0,0,62,62,0,1,0,1,0,deny,1,1,High Risk
11488,22114,0,0,66,66,0,1,0,1,0,deny,0,1,Known Attack
57304,443,45886,443,134,60,74,3,5,2,1,allow,0,0,Normal
56386,50584,0,0,66,66,0,1,0,1,0,deny,0,1,Known Attack
59218,53,41217,53,511,126,385,2,31,1,1,allow,0,0,Normal
19858,64147,0,0,62,62,0,1,0,1,0,deny,1,1,High Risk
64900,53,46043,53,197,102,95,2,30,1,1,allow,0,0,Normal
58975,80,4684,80,214,140,74,4,15,3,1,allow,0,0,Normal
12567,53,12567,53,231,90,141,2,30,1,1,allow,0,0,Normal
5462,21247,0,0,62,62,0,1,0,1,0,deny,1,1,High Risk
59646,5223,10066,5223,139,139,0,1,5,1,0,allow,1,0,Potential Threat
25234,1,0,0,62,62,0,1,0,1,0,reset-both,0,1,Known Attack
41890,443,5361,443,7014,1958,5056,31,18,19,12,allow,1,0,Potential Threat
50116,445,0,0,66,66,0,1,0,1,0,drop,0,1,Known Attack
65350,53,14923,53,212,102,110,2,31,1,1,allow,0,0,Normal
42203,443,25522,443,6345,1024,5321,21,361,11,10,allow,1,0,Potential Threat
58814,445,0,0,70,70,0,1,0,1,0,drop,0,1,Known Attack
49115,443,63602,443,361013,18864,342149,392,296,110,282,allow,1,0,Potential Threat
59786,443,7763,443,170002,17069,152933,229,48,118,111,allow,1,0,Potential Threat
58638,5900,0,0,62,62,0,1,0,1,0,deny,0,1,Known Attack
60911,53,60911,53,216,90,126,2,30,1,1,allow,0,0,Normal
39040,443,45031,443,25034,7042,17992,58,21,29,29,allow,1,0,Potential Threat
58230,64147,0,0,66,66,0,1,0,1,0,deny,1,1,High Risk
48756,443,37837,443,6353,1075,5278,18,33,10,8,allow,1,0,Potential Threat
53758,443,30147,443,499,425,74,4,0,3,1,allow,0,0,Normal
49355,53,60733,53,193,102,91,2,30,1,1,allow,0,0,Normal
56429,80,57755,80,17188,1559,15629,25,25,10,15,allow,1,0,Potential Threat
52458,443,42668,443,4550,1777,2773,17,135,8,9,allow,1,0,Potential Threat
53089,24211,0,0,66,66,0,1,0,1,0,deny,0,1,Known Attack
41916,53,0,0,60,60,0,1,0,1,0,deny,0,1,Known Attack
53901,443,43794,443,499,425,74,4,0,3,1,allow,0,0,Normal
51627,445,0,0,70,70,0,1,0,1,0,drop,0,1,Known Attack
59761,445,0,0,70,70,0,1,0,1,0,drop,0,1,Known Attack
50265,41071,33048,41071,1716,1716,0,27,2188,27,0,allow,1,0,Potential Threat
44354,80,44354,80,250076,10158,239918,315,24,146,169,allow,1,0,Potential Threat
55314,445,0,0,70,70,0,1,0,1,0,drop,0,1,Known Attack
53799,445,0,0,70,70,0,1,0,1,0,drop,0,1,Known Attack
56303,53,31666,53,177,94,83,2,30,1,1,allow,0,0,Normal
49181,2710,52440,2710,66,66,0,1,5,1,0,allow,1,0,Potential Threat
48188,443,44045,443,1263,536,727,13,82,6,7,allow,1,0,Potential Threat
61532,445,0,0,66,66,0,1,0,1,0,drop,0,1,Known Attack
35719,443,27839,443,9736,4347,5389,23,361,11,12,allow,1,0,Potential Threat
60225,443,43705,443,8989,3335,5654,65,152,31,34,allow,1,0,Potential Threat
26448,80,26448,80,642,338,304,10,32,6,4,allow,1,0,Potential Threat
27005,27222,26856,27222,890,126,764,2,30,1,1,allow,1,0,Potential Threat
52694,443,37161,443,10384,4563,5821,34,436,17,17,allow,1,0,Potential Threat
51362,445,0,0,66,66,0,1,0,1,0,drop,0,1,Known Attack
51181,445,0,0,66,66,0,1,0,1,0,drop,0,1,Known Attack
64915,443,15491,443,4659604,120303,4539301,4651,74,1586,3065,allow,1,0,Potential Threat
56181,53,2631,53,784,94,690,2,29,1,1,allow,0,0,Normal
30188,41184,4045,41184,509,150,359,2,1200,1,1,allow,1,0,Potential Threat
49869,80,37142,80,2125,1041,1084,11,87,6,5,allow,0,0,Normal
49947,80,44031,80,362232,10443,351789,387,15,147,240,allow,1,0,Potential Threat
50394,25174,0,0,62,62,0,1,0,1,0,deny,0,1,Known Attack
58302,443,57426,443,4568,2059,2509,17,33,9,8,allow,1,0,Potential Threat
52019,40689,48482,40689,70,70,0,2,8,2,0,allow,1,0,Potential Threat
35939,443,12067,443,9111,2919,6192,27,19,14,13,allow,1,0,Potential Threat
54134,64147,0,0,66,66,0,1,0,1,0,deny,1,1,High Risk
52373,445,0,0,70,70,0,1,0,1,0,drop,0,1,Known Attack
48013,53,0,0,82,82,0,1,30,1,0,allow,0,0,Normal
57638,80,57638,80,29263,2432,26831,36,31,13,23,allow,1,0,Potential Threat
65314,53,60905,53,402,118,284,2,30,1,1,allow,1,0,Potential Threat
51424,30188,0,0,62,62,0,1,0,1,0,deny,0,1,Known Attack
64639,53,46471,53,199,102,97,2,30,1,1,allow,0,0,Normal
55972,53,18787,53,193,102,91,2,31,1,1,allow,0,0,Normal
57691,445,0,0,70,70,0,1,0,1,0,drop,0,1,Known Attack
51693,22114,0,0,62,62,0,1,0,1,0,deny,0,1,Known Attack
53570,24874,57819,24874,70,70,0,1,4,1,0,allow,1,0,Potential Threat
54452,445,0,0,66,66,0,1,0,1,0,drop,0,1,Known Attack
52516,80,41641,80,3224,2776,448,11,15,7,4,allow,1,0,Potential Threat
51166,31573,0,0,66,66,0,1,0,1,0,deny,0,1,Known Attack
57656,445,0,0,66,66,0,1,0,1,0,drop,0,1,Known Attack
58615,443,30095,443,6796,1541,5255,23,121,11,12,allow,1,0,Potential Threat
58638,5900,0,0,62,62,0,1,0,1,0,deny,0,1,Known Attack
40763,443,27693,443,15679,4305,11374,32,43,17,15,allow,1,0,Potential Threat
56813,53,41752,53,753,96,657,2,31,1,1,allow,0,0,Normal
60714,445,0,0,66,66,0,1,0,1,0,drop,0,1,Known Attack
14693,64147,0,0,66,66,0,1,0,1,0,deny,1,1,High Risk
50933,443,10395,443,10546,2453,8093,28,15,16,12,allow,1,0,Potential Threat
53896,48027,30657,48027,70,70,0,1,5,1,0,allow,1,0,Potential Threat
6666,6001,0,0,60,60,0,1,0,1,0,deny,0,1,Known Attack
50170,53,38281,53,260,86,174,2,29,1,1,allow,0,0,Normal
64006,53,16897,53,394,96,298,4,47,2,2,allow,0,0,Normal
50394,25174,0,0,62,62,0,1,0,1,0,deny,0,1,Known Attack
56788,445,0,0,66,66,0,1,0,1,0,drop,0,1,Known Attack
64485,445,0,0,70,70,0,1,0,1,0,drop,0,1,Known Attack
48372,8100,19668,8100,234,234,0,4,11,4,0,allow,1,0,Potential Threat
60994,443,7195,443,13145,6129,7016,37,34,19,18,allow,1,0,Potential Threat
3978,35440,0,0,62,62,0,1,0,1,0,deny,1,1,High Risk
55618,56205,0,0,66,66,0,1,0,1,0,deny,0,1,Known Attack
52754,26467,0,0,62,62,0,1,0,1,0,deny,0,1,Known Attack
49849,53,33985,53,173,94,79,2,31,1,1,allow,0,0,Normal
16387,7205,0,0,60,60,0,1,0,1,0,deny,0,1,Known Attack
63345,53,0,0,75,75,0,1,0,1,0,deny,0,1,Known Attack
50403,445,0,0,66,66,0,1,0,1,0,drop,0,1,Known Attack
49664,37965,0,0,66,66,0,1,0,1,0,deny,0,1,Known Attack
50491,53,0,0,183,86,97,2,29,1,1,allow,0,0,Normal
443,62732,0,0,332,332,0,1,0,1,0,deny,1,1,High Risk
55835,62413,0,0,66,66,0,1,0,1,0,deny,1,1,High Risk
58638,5900,58638,5900,130,66,64,2,5,1,1,allow,1,0,Potential Threat
55621,28144,20259,28144,70,70,0,2,8,2,0,allow,1,0,Potential Threat
50562,443,27211,443,1313,876,437,11,27,6,5,allow,0,0,Normal
64677,53,58771,53,183,94,89,2,30,1,1,allow,0,0,Normal
49571,443,45165,443,3972,887,3085,13,31,6,7,allow,1,0,Potential Threat
5588,5588,0,0,3562,1936,1626,48,196,24,24,allow,1,0,Potential Threat
50676,445,0,0,66,66,0,1,0,1,0,drop,0,1,Known Attack
63593,22114,0,0,62,62,0,1,0,1,0,deny,0,1,Known Attack
49289,53,50733,53,322,118,204,2,30,1,1,allow,0,0,Normal
56770,52920,10024,52920,70,70,0,1,5,1,0,allow,1,0,Potential Threat
58248,445,0,0,70,70,0,1,0,1,0,drop,0,1,Known Attack
54088,445,0,0,70,70,0,1,0,1,0,drop,0,1,Known Attack
50265,45589,64355,45589,132,132,0,3,1200,3,0,allow,1,0,Potential Threat
13718,23,0,0,60,60,0,1,0,1,0,deny,0,1,Known Attack
51289,445,0,0,70,70,0,1,0,1,0,drop,0,1,Known Attack
51177,443,18641,443,154,94,60,2,4,1,1,allow,0,0,Normal
58867,443,37875,443,16230,11127,5103,69,330,34,35,allow,1,0,Potential Threat
56840,20413,2836,20413,66,66,0,1,5,1,0,allow,1,0,Potential Threat
55656,53,20503,53,760,96,664,2,30,1,1,allow,0,0,Normal
54048,25174,0,0,66,66,0,1,0,1,0,deny,0,1,Known Attack
16037,25174,0,0,146,146,0,1,0,1,0,deny,1,1,High Risk
63648,445,0,0,70,70,0,1,0,1,0,drop,0,1,Known Attack
27005,27015,45199,27015,892,126,766,2,30,1,1,allow,1,0,Potential Threat
49593,53,21447,53,762,98,664,2,31,1,1,allow,0,0,Normal
65297,53,52505,53,241,118,123,2,30,1,1,allow,0,0,Normal
443,46223,0,0,66,66,0,1,0,1,0,deny,1,1,High Risk
61426,64910,0,0,66,66,0,1,0,1,0,deny,1,1,High Risk
60579,25174,0,0,66,66,0,1,0,1,0,deny,0,1,Known Attack
64363,53,54171,53,212,102,110,2,30,1,1,allow,0,0,Normal
51429,22114,0,0,66,66,0,1,0,1,0,deny,0,1,Known Attack
50866,443,31244,443,9517,1897,7620,21,130,11,10,allow,1,0,Potential Threat
57470,40794,36042,40794,132,132,0,3,1199,3,0,allow,1,0,Potential Threat
51862,27758,53526,27758,70,70,0,1,5,1,0,allow,1,0,Potential Threat
32961,80,43846,80,480,258,222,8,12,5,3,allow,1,0,Potential Threat
39161,17,0,0,60,60,0,1,0,1,0,deny,0,1,Known Attack
34247,48817,0,0,145,145,0,1,0,1,0,deny,1,1,High Risk
60962,64147,0,0,66,66,0,1,0,1,0,deny,1,1,High Risk
61000,1,0,0,146,146,0,1,0,1,0,deny,0,1,Known Attack
51582,443,29660,443,9080,2186,6894,27,108,14,13,allow,1,0,Potential Threat
49975,445,0,0,70,70,0,1,0,1,0,drop,0,1,Known Attack
57063,445,0,0,70,70,0,1,0,1,0,drop,0,1,Known Attack
51726,18475,34444,18475,316,136,180,6,7,3,3,allow,1,0,Potential Threat
30960,45705,10345,45705,396,396,0,7,3617,7,0,allow,1,0,Potential Threat
64083,63666,39336,63666,70,70,0,1,4,1,0,allow,1,0,Potential Threat
37306,53,55019,53,168,78,90,2,30,1,1,allow,0,0,Normal
55608,53,12316,53,195,102,93,2,30,1,1,allow,0,0,Normal
49942,53,42485,53,177,94,83,2,31,1,1,allow,0,0,Normal
63775,445,0,0,66,66,0,1,0,1,0,drop,0,1,Known Attack
56374,53,9778,53,212,102,110,2,30,1,1,allow,0,0,Normal
46090,50584,0,0,66,66,0,1,0,1,0,deny,0,1,Known Attack
50966,443,44457,443,7975,3304,4671,19,86,11,8,allow,1,0,Potential Threat
57398,53,44535,53,202,86,116,2,30,1,1,allow,0,0,Normal
50512,445,0,0,70,70,0,1,0,1,0,drop,0,1,Known Attack
52401,623,0,0,60,60,0,1,0,1,0,deny,0,1,Known Attack
49359,53,18321,53,216,110,106,2,30,1,1,allow,0,0,Normal
57504,443,39017,443,5238,695,4543,14,25,8,6,allow,1,0,Potential Threat
54315,445,0,0,70,70,0,1,0,1,0,drop,0,1,Known Attack
60659,443,57729,443,8175,3047,5128,26,165,12,14,allow,1,0,Potential Threat
52221,33166,34754,33166,70,70,0,2,8,2,0,allow,1,0,Potential Threat
51769,80,52683,80,74039,4367,69672,91,19,40,51,allow,1,0,Potential Threat
53790,443,36167,443,499,425,74,4,0,3,1,allow,0,0,Normal
53892,445,0,0,70,70,0,1,0,1,0,drop,0,1,Known Attack
54063,443,37024,443,1313,652,661,13,185,7,6,allow,1,0,Potential Threat
62508,445,0,0,70,70,0,1,0,1,0,drop,0,1,Known Attack
64307,53,35303,53,241,94,147,2,30,1,1,allow,0,0,Normal
52887,445,0,0,70,70,0,1,0,1,0,drop,0,1,Known Attack
56668,443,3930,443,8005,1985,6020,20,15,11,9,allow,1,0,Potential Threat
16285,23,0,0,60,60,0,1,0,1,0,deny,0,1,Known Attack
57799,10387,0,0,145,145,0,1,0,1,0,deny,0,1,Known Attack
54366,445,0,0,70,70,0,1,0,1,0,drop,0,1,Known Attack
51523,443,27460,443,4045,765,3280,11,45,5,6,allow,1,0,Potential Threat
50165,53,36668,53,211,78,133,2,30,1,1,allow,0,0,Normal
38795,40042,2140,40042,142,80,62,2,31,1,1,allow,1,0,Potential Threat
38031,80,38031,80,37629,3025,34604,51,24,22,29,allow,1,0,Potential Threat
61002,37965,0,0,145,145,0,1,0,1,0,deny,1,1,High Risk
53861,443,51732,443,499,425,74,4,1,3,1,allow,0,0,Normal
58022,5601,0,0,60,60,0,1,0,1,0,deny,0,1,Known Attack
3074,64147,0,0,62,62,0,1,0,1,0,deny,1,1,High Risk
64781,53,27529,53,209,102,107,2,30,1,1,allow,0,0,Normal
50973,443,10208,443,9525,6135,3390,24,120,13,11,allow,1,0,Potential Threat
49820,53,12064,53,186,95,91,2,31,1,1,allow,0,0,Normal
50862,445,0,0,70,70,0,1,0,1,0,drop,0,1,Known Attack
57369,1433,0,0,60,60,0,1,0,1,0,deny,0,1,Known Attack
31017,50584,0,0,62,62,0,1,0,1,0,deny,1,1,High Risk
50011,53,36525,53,94,94,0,1,30,1,0,allow,0,0,Normal
55705,53,14171,53,209,110,99,2,30,1,1,allow,0,0,Normal
28064,36237,0,0,62,62,0,1,0,1,0,deny,0,1,Known Attack
52920,445,0,0,66,66,0,1,0,1,0,drop,0,1,Known Attack
49236,8080,49236,8080,4458,1336,3122,13,53,7,6,allow,1,0,Potential Threat
27005,30006,22484,30006,890,126,764,2,31,1,1,allow,1,0,Potential Threat
57056,445,0,0,70,70,0,1,0,1,0,drop,0,1,Known Attack
62009,445,0,0,70,70,0,1,0,1,0,drop,0,1,Known Attack
62996,445,0,0,70,70,0,1,0,1,0,drop,0,1,Known Attack
26900,27017,25827,27017,172,86,86,2,29,1,1,allow,1,0,Potential Threat
49825,53,18724,53,168,86,82,2,29,1,1,allow,0,0,Normal
65179,53,63378,53,184,94,90,2,31,1,1,allow,1,0,Potential Threat
42119,443,42119,443,9299,1697,7602,21,146,12,9,allow,1,0,Potential Threat
51784,8245,58196,8245,280,214,66,2,31,1,1,allow,1,0,Potential Threat
49377,443,17002,443,11627,4670,6957,37,155,16,21,allow,1,0,Potential Threat
58858,445,0,0,70,70,0,1,0,1,0,drop,0,1,Known Attack
54748,445,0,0,70,70,0,1,0,1,0,drop,0,1,Known Attack
59503,445,0,0,66,66,0,1,0,1,0,drop,0,1,Known Attack
57243,53,28936,53,168,78,90,2,30,1,1,allow,0,0,Normal
40086,22114,0,0,146,146,0,1,0,1,0,deny,1,1,High Risk
56505,445,0,0,70,70,0,1,0,1,0,drop,0,1,Known Attack
55312,64147,0,0,66,66,0,1,0,1,0,deny,1,1,High Risk
58638,5900,0,0,62,62,0,1,0,1,0,deny,0,1,Known Attack
9454,443,57468,443,5699,505,5194,14,15,7,7,allow,1,0,Potential Threat
49831,30188,0,0,66,66,0,1,0,1,0,deny,0,1,Known Attack
51293,445,0,0,66,66,0,1,0,1,0,drop,0,1,Known Attack
38993,443,34045,443,7089,1290,5799,24,16,12,12,allow,1,0,Potential Threat
56122,53,50294,53,731,91,640,2,30,1,1,allow,0,0,Normal
56152,53,61194,53,190,97,93,2,31,1,1,allow,0,0,Normal
56739,443,41966,443,7914,1925,5989,20,15,11,9,allow,1,0,Potential Threat
50498,53,36030,53,751,94,657,2,29,1,1,allow,0,0,Normal
59899,53,59899,53,194,87,107,2,31,1,1,allow,0,0,Normal
58817,443,7616,443,1413,876,537,12,25,6,6,allow,1,0,Potential Threat
61420,443,13668,443,6327,1143,5184,18,28,9,9,allow,1,0,Potential Threat
49402,53,34826,53,214,110,104,2,30,1,1,allow,0,0,Normal
59930,80,22245,80,1638,1324,314,10,15,5,5,allow,1,0,Potential Threat
49295,443,9529,443,4179,2599,1580,27,75,13,14,allow,1,0,Potential Threat
53781,445,0,0,70,70,0,1,0,1,0,drop,0,1,Known Attack
17643,50584,0,0,146,146,0,1,0,1,0,deny,1,1,High Risk
47134,37965,0,0,62,62,0,1,0,1,0,deny,0,1,Known Attack
58887,443,25823,443,5167,700,4467,16,15,7,9,allow,1,0,Potential Threat
50585,445,0,0,70,70,0,1,0,1,0,drop,0,1,Known Attack
51647,443,26913,443,6400,1830,4570,26,316,13,13,allow,1,0,Potential Threat
49341,53,41507,53,199,102,97,2,30,1,1,allow,0,0,Normal
62896,445,0,0,70,70,0,1,0,1,0,drop,0,1,Known Attack
49967,53,25418,53,193,102,91,2,31,1,1,allow,0,0,Normal
58638,5900,0,0,62,62,0,1,0,1,0,deny,0,1,Known Attack
56630,443,6016,443,7941,1952,5989,20,15,11,9,allow,1,0,Potential Threat
49398,445,0,0,70,70,0,1,0,1,0,drop,0,1,Known Attack
55594,53,15652,53,202,83,119,2,31,1,1,allow,0,0,Normal
65066,445,0,0,66,66,0,1,0,1,0,drop,0,1,Known Attack
57414,53,33094,53,214,102,112,2,29,1,1,allow,0,0,Normal
50622,80,45334,80,11907,10409,1498,28,52,16,12,allow,1,0,Potential Threat
64908,53,50064,53,812,110,702,2,30,1,1,allow,1,0,Potential Threat
57281,53,33051,53,178,94,84,2,30,1,1,allow,0,0,Normal
50515,445,0,0,70,70,0,1,0,1,0,drop,0,1,Known Attack
56070,53,35943,53,770,101,669,2,30,1,1,allow,0,0,Normal
60666,123,38509,123,184,94,90,2,30,1,1,allow,0,0,Normal
51705,22114,0,0,66,66,0,1,0,1,0,deny,0,1,Known Attack
53174,41442,6472,41442,70,70,0,2,8,2,0,allow,1,0,Potential Threat
59147,25174,0,0,62,62,0,1,0,1,0,deny,0,1,Known Attack
64180,53,16774,53,176,90,86,2,31,1,1,allow,0,0,Normal
60863,445,0,0,70,70,0,1,0,1,0,drop,0,1,Known Attack
65194,53,61837,53,402,142,260,2,31,1,1,allow,1,0,Potential Threat
49421,5228,11226,5228,8399,1901,6498,39,1562,16,23,allow,1,0,Potential Threat
55423,53,31871,53,177,94,83,2,31,1,1,allow,0,0,Normal
65095,53,43220,53,718,94,624,2,30,1,1,allow,0,0,Normal
51106,445,0,0,66,66,0,1,0,1,0,drop,0,1,Known Attack
35657,48637,0,0,62,62,0,1,0,1,0,deny,0,1,Known Attack
50674,35440,0,0,62,62,0,1,0,1,0,deny,0,1,Known Attack
56582,53,17999,53,196,102,94,2,32,1,1,allow,0,0,Normal
54300,22114,0,0,62,62,0,1,0,1,0,deny,0,1,Known Attack
57353,443,50919,443,70,70,0,1,5,1,0,allow,0,0,Normal
32679,37965,0,0,62,62,0,1,0,1,0,deny,0,1,Known Attack
51547,443,7780,443,202,70,132,3,11,1,2,allow,0,0,Normal
36368,80,58408,80,78,78,0,1,5,1,0,allow,1,0,Potential Threat
64790,53,41786,53,183,94,89,2,30,1,1,allow,0,0,Normal
27005,27017,40940,27017,600,126,474,2,31,1,1,allow,1,0,Potential Threat
34698,443,50104,443,16164,3053,13111,31,18,16,15,allow,1,0,Potential Threat
54973,53,49914,53,811,94,717,2,29,1,1,allow,0,0,Normal
35519,80,60080,80,841,715,126,5,15,3,2,allow,1,0,Potential Threat
55113,53,62881,53,198,102,96,2,33,1,1,allow,1,0,Potential Threat
55704,53,10411,53,177,94,83,2,31,1,1,allow,0,0,Normal
60191,80,55591,80,2589,1231,1358,9,28,5,4,allow,1,0,Potential Threat
65483,445,0,0,70,70,0,1,0,1,0,drop,0,1,Known Attack
65319,53,38266,53,285,103,182,4,43,2,2,allow,0,0,Normal
28124,37965,0,0,145,145,0,1,0,1,0,deny,1,1,High Risk
26528,51221,0,0,78,78,0,1,0,1,0,deny,1,1,High Risk
62934,445,0,0,70,70,0,1,0,1,0,drop,0,1,Known Attack
52649,443,45569,443,6292,1492,4800,22,17,11,11,allow,1,0,Potential Threat
34150,443,7922,443,12564,9272,3292,66,107,31,35,allow,1,0,Potential Threat
56910,53,3209,53,199,102,97,2,30,1,1,allow,0,0,Normal
48070,443,9695,443,10240,2295,7945,38,121,20,18,allow,1,0,Potential Threat
60504,443,51319,443,1875,1165,710,13,28,7,6,allow,1,0,Potential Threat
52249,443,52249,443,152755,7304,145451,171,21,65,106,allow,1,0,Potential Threat
28624,23,0,0,60,60,0,1,0,1,0,deny,0,1,Known Attack
58856,443,60071,443,2694,1614,1080,14,386,8,6,allow,1,0,Potential Threat
52572,80,52572,80,1680,696,984,11,142,6,5,allow,1,0,Potential Threat
63855,29799,24538,29799,66,66,0,2,8,2,0,allow,1,0,Potential Threat
55336,53,49932,53,199,102,97,2,30,1,1,allow,0,0,Normal
50010,53,28513,53,330,126,204,2,31,1,1,allow,0,0,Normal
52984,445,0,0,66,66,0,1,0,1,0,drop,0,1,Known Attack
50516,443,44017,443,1575,771,804,16,47,9,7,allow,1,0,Potential Threat
49859,443,23944,443,6065,1045,5020,20,60,11,9,allow,1,0,Potential Threat
51675,53,24941,53,168,78,90,2,29,1,1,allow,0,0,Normal
58638,5900,0,0,62,62,0,1,0,1,0,deny,0,1,Known Attack
60083,445,0,0,70,70,0,1,0,1,0,drop,0,1,Known Attack
35494,22114,0,0,66,66,0,1,0,1,0,deny,0,1,Known Attack
51109,11392,0,0,66,66,0,1,0,1,0,deny,0,1,Known Attack
58775,445,0,0,66,66,0,1,0,1,0,drop,0,1,Known Attack
61936,443,38328,443,4348,1643,2705,14,138,6,8,allow,1,0,Potential Threat
55376,53,48930,53,789,110,679,2,31,1,1,allow,0,0,Normal
37834,45129,0,0,145,145,0,1,0,1,0,deny,1,1,High Risk
55955,53,35067,53,184,94,90,2,31,1,1,allow,0,0,Normal
64543,50265,0,0,66,66,0,1,0,1,0,deny,1,1,High Risk
27005,27019,53599,27019,881,126,755,2,30,1,1,allow,1,0,Potential Threat
58638,5900,0,0,62,62,0,1,0,1,0,deny,0,1,Known Attack
40273,53,38821,53,164,78,86,2,30,1,1,allow,0,0,Normal
52913,443,33752,443,50739,5508,45231,100,116,36,64,allow,1,0,Potential Threat
51959,42269,61621,42269,70,70,0,1,4,1,0,allow,1,0,Potential Threat
44740,443,62303,443,5954,1454,4500,22,142,13,9,allow,1,0,Potential Threat
52335,445,0,0,70,70,0,1,0,1,0,drop,0,1,Known Attack
64840,53,3676,53,193,102,91,2,30,1,1,allow,0,0,Normal
60332,53,8836,53,419,111,308,2,31,1,1,allow,0,0,Normal
57587,443,15184,443,7150,1958,5192,28,144,14,14,allow,1,0,Potential Threat
13285,29892,0,0,145,145,0,1,0,1,0,deny,1,1,High Risk
6666,3389,0,0,60,60,0,1,0,1,0,deny,0,1,Known Attack
65506,53,20953,53,197,102,95,2,30,1,1,allow,0,0,Normal
50284,53,6888,53,168,78,90,2,30,1,1,allow,0,0,Normal
50021,53,58776,53,963,391,572,10,83,5,5,allow,1,0,Potential Threat
62488,445,0,0,70,70,0,1,0,1,0,drop,0,1,Known Attack
61766,44847,0,0,62,62,0,1,0,1,0,deny,1,1,High Risk
38334,22,38334,22,9022,3349,5673,57,43,26,31,allow,1,0,Potential Threat
62084,445,0,0,70,70,0,1,0,1,0,drop,0,1,Known Attack
27005,27111,57650,27111,893,126,767,2,30,1,1,allow,1,0,Potential Threat
60417,443,24567,443,8590,1987,6603,23,86,12,11,allow,1,0,Potential Threat
45020,443,48024,443,10427,2928,7499,34,106,16,18,allow,1,0,Potential Threat
63409,445,0,0,70,70,0,1,0,1,0,drop,0,1,Known Attack
51954,57470,0,0,66,66,0,1,0,1,0,deny,0,1,Known Attack
58740,445,0,0,70,70,0,1,0,1,0,drop,0,1,Known Attack
4772,37965,0,0,66,66,0,1,0,1,0,deny,1,1,High Risk
48024,443,44709,443,9194,1066,8128,21,27,12,9,allow,1,0,Potential Threat
41783,443,41782,443,23344,2097,21247,39,15,18,21,allow,1,0,Potential Threat
50426,445,0,0,66,66,0,1,0,1,0,drop,0,1,Known Attack
48079,43227,0,0,66,66,0,1,0,1,0,deny,0,1,Known Attack
50820,53,0,0,371,77,294,2,30,1,1,allow,0,0,Normal
54379,80,23086,80,1466,729,737,12,16,7,5,allow,0,0,Normal
64098,10096,39565,10096,66,66,0,2,8,2,0,allow,1,0,Potential Threat
62549,53733,0,0,66,66,0,1,0,1,0,deny,1,1,High Risk
61280,26467,0,0,66,66,0,1,0,1,0,deny,0,1,Known Attack
52228,49974,17167,49974,230,136,94,4,14,3,1,allow,1,0,Potential Threat
37965,22343,64266,22343,1307,594,713,17,1657,10,7,allow,1,0,Potential Threat
61459,445,0,0,70,70,0,1,0,1,0,drop,0,1,Known Attack
49838,53,8093,53,182,93,89,2,31,1,1,allow,0,0,Normal
58626,445,0,0,70,70,0,1,0,1,0,drop,0,1,Known Attack
27947,26467,0,0,66,66,0,1,0,1,0,deny,0,1,Known Attack
57281,53,14335,53,178,94,84,2,30,1,1,allow,0,0,Normal
62261,445,0,0,70,70,0,1,0,1,0,drop,0,1,Known Attack
55926,80,55926,80,450,246,204,8,29,5,3,allow,0,0,Normal
49878,53,34561,53,216,94,122,2,30,1,1,allow,0,0,Normal
37322,53,64245,53,168,78,90,2,31,1,1,allow,1,0,Potential Threat
57470,60080,37928,60080,12668,8506,4162,117,3745,74,43,allow,1,0,Potential Threat
47091,443,36299,443,6326,4367,1959,31,144,17,14,allow,1,0,Potential Threat
19004,51505,0,0,66,66,0,1,0,1,0,deny,1,1,High Risk
50986,445,0,0,70,70,0,1,0,1,0,drop,0,1,Known Attack
23197,44847,0,0,62,62,0,1,0,1,0,deny,1,1,High Risk
43162,443,31273,443,10096,3002,7094,25,16,13,12,allow,1,0,Potential Threat
51884,445,0,0,66,66,0,1,0,1,0,drop,0,1,Known Attack
34165,443,5648,443,8208,2080,6128,24,81,14,10,allow,1,0,Potential Threat
33641,443,2360,443,15017,6951,8066,49,20,25,24,allow,1,0,Potential Threat
60286,80,21753,80,5836,2829,3007,19,164,14,5,allow,1,0,Potential Threat
60430,445,0,0,70,70,0,1,0,1,0,drop,0,1,Known Attack
55773,53,34274,53,199,102,97,2,30,1,1,allow,0,0,Normal
61510,37965,0,0,66,66,0,1,0,1,0,deny,0,1,Known Attack
36628,80,36628,80,5529,713,4816,15,15,8,7,allow,1,0,Potential Threat
56858,32330,62382,32330,70,70,0,2,8,2,0,allow,1,0,Potential Threat
58362,443,29130,443,13272,2360,10912,37,208,19,18,allow,1,0,Potential Threat
2572,35440,0,0,66,66,0,1,0,1,0,deny,1,1,High Risk
55176,53,57165,53,195,102,93,2,30,1,1,allow,0,0,Normal
1027,9822,0,0,146,146,0,1,0,1,0,deny,1,1,High Risk
56344,53,55607,53,167,86,81,2,30,1,1,allow,0,0,Normal
50740,445,0,0,66,66,0,1,0,1,0,drop,0,1,Known Attack
56560,53,15895,53,164,86,78,2,29,1,1,allow,0,0,Normal
50765,22114,0,0,66,66,0,1,0,1,0,deny,0,1,Known Attack
62709,57470,0,0,62,62,0,1,0,1,0,deny,1,1,High Risk
3225,64147,0,0,62,62,0,1,0,1,0,deny,1,1,High Risk
50391,80,6997,80,300,180,120,6,26,4,2,allow,0,0,Normal
56426,53,37263,53,184,94,90,2,31,1,1,allow,0,0,Normal
46593,28678,34181,28678,1806,1806,0,22,224,22,0,allow,1,0,Potential Threat
57584,443,53316,443,915797,52405,863392,1231,269,604,627,allow,1,0,Potential Threat
39500,443,7473,443,6517,2048,4469,21,90,12,9,allow,1,0,Potential Threat
56613,443,29986,443,7981,1961,6020,20,16,11,9,allow,1,0,Potential Threat
50829,53,16960,53,168,78,90,2,30,1,1,allow,0,0,Normal
52828,51221,0,0,66,66,0,1,0,1,0,deny,0,1,Known Attack
41343,443,31271,443,7601,1595,6006,25,35,12,13,allow,1,0,Potential Threat
52509,445,0,0,70,70,0,1,0,1,0,drop,0,1,Known Attack
39703,443,48474,443,4719,2313,2406,15,132,7,8,allow,1,0,Potential Threat
51981,38274,61701,38274,206,136,70,4,13,3,1,allow,1,0,Potential Threat
60614,445,0,0,66,66,0,1,0,1,0,drop,0,1,Known Attack
55044,443,54771,443,5549,2777,2772,24,16,14,10,allow,1,0,Potential Threat
19885,64147,0,0,145,145,0,1,0,1,0,deny,1,1,High Risk
60675,445,0,0,66,66,0,1,0,1,0,drop,0,1,Known Attack
64900,445,0,0,70,70,0,1,0,1,0,drop,0,1,Known Attack
53793,53,24147,53,213,78,135,2,30,1,1,allow,0,0,Normal
43897,443,6897,443,6259,1816,4443,30,2615,16,14,allow,1,0,Potential Threat
62725,445,0,0,70,70,0,1,0,1,0,drop,0,1,Known Attack
49420,53,61159,53,183,94,89,2,30,1,1,allow,0,0,Normal
61526,443,1145,443,13977,5303,8674,48,152,20,28,allow,1,0,Potential Threat
65078,445,0,0,66,66,0,1,0,1,0,drop,0,1,Known Attack
63712,21917,18745,21917,504,382,122,8,15,6,2,allow,1,0,Potential Threat
55659,443,55659,443,25716,7632,18084,52,48,31,21,allow,1,0,Potential Threat
57181,53,16955,53,753,96,657,2,31,1,1,allow,0,0,Normal
63904,18268,47003,18268,66,66,0,2,7,2,0,allow,1,0,Potential Threat
65157,445,0,0,70,70,0,1,0,1,0,drop,0,1,Known Attack
54300,22114,0,0,66,66,0,1,0,1,0,deny,0,1,Known Attack
54703,53,49581,53,168,78,90,2,30,1,1,allow,0,0,Normal
51826,58925,47237,58925,70,70,0,1,4,1,0,allow,1,0,Potential Threat
63772,35440,0,0,66,66,0,1,0,1,0,deny,0,1,Known Attack
27988,40006,7041,40006,148,86,62,2,30,1,1,allow,1,0,Potential Threat
26435,39004,0,0,62,62,0,1,0,1,0,deny,1,1,High Risk
7285,51221,0,0,66,66,0,1,0,1,0,deny,1,1,High Risk
49568,53,32071,53,168,86,82,2,31,1,1,allow,0,0,Normal
63939,24867,28601,24867,312,132,180,6,6,3,3,allow,1,0,Potential Threat
50589,445,0,0,70,70,0,1,0,1,0,drop,0,1,Known Attack
20586,25174,0,0,62,62,0,1,0,1,0,deny,0,1,Known Attack
63288,52848,0,0,66,66,0,1,0,1,0,deny,1,1,High Risk
49476,443,31371,443,7254,1183,6071,19,152,9,10,allow,1,0,Potential Threat
61788,445,0,0,70,70,0,1,0,1,0,drop,0,1,Known Attack
53314,64097,0,0,62,62,0,1,0,1,0,deny,1,1,High Risk
56450,53,17647,53,177,94,83,2,29,1,1,allow,0,0,Normal
58486,57470,0,0,66,66,0,1,0,1,0,deny,1,1,High Risk
58824,53,47620,53,358,96,262,4,50,2,2,allow,0,0,Normal
54600,6881,0,0,66,66,0,1,0,1,0,deny,0,1,Known Attack
52921,443,13055,443,5581,1388,4193,19,15,9,10,allow,1,0,Potential Threat
17232,22114,0,0,62,62,0,1,0,1,0,deny,0,1,Known Attack
37579,443,43995,443,499,425,74,4,0,3,1,allow,1,0,Potential Threat
35526,443,57074,443,4566,3317,1249,21,23,12,9,allow,1,0,Potential Threat
55679,445,0,0,70,70,0,1,0,1,0,drop,0,1,Known Attack
47677,80,49789,80,1304,850,454,11,31,6,5,allow,0,0,Normal
56884,53,35715,53,199,102,97,2,30,1,1,allow,0,0,Normal
49222,443,64126,443,476852,12774,464078,491,17,177,314,allow,1,0,Potential Threat
52120,42751,65345,42751,70,70,0,2,8,2,0,allow,1,0,Potential Threat
51535,443,24359,443,322,262,60,2,4,1,1,allow,0,0,Normal
6881,9074,0,0,143,143,0,1,0,1,0,deny,1,1,High Risk
62424,443,60409,443,4650,3116,1534,19,44,10,9,allow,1,0,Potential Threat
55087,53,26632,53,183,94,89,2,30,1,1,allow,0,0,Normal
55267,53,18171,53,168,86,82,2,31,1,1,allow,0,0,Normal
52745,57866,0,0,62,62,0,1,0,1,0,deny,1,1,High Risk
51206,443,30642,443,12274,2677,9597,51,17,29,22,allow,1,0,Potential Threat
26792,37965,0,0,62,62,0,1,0,1,0,deny,0,1,Known Attack
55330,53,61986,53,194,102,92,2,31,1,1,allow,0,0,Normal
49356,445,0,0,66,66,0,1,0,1,0,drop,0,1,Known Attack
27005,27015,11588,27015,1019,252,767,4,32,3,1,allow,1,0,Potential Threat
53100,443,19603,443,472,406,66,4,0,3,1,allow,0,0,Normal
55069,44847,0,0,62,62,0,1,0,1,0,deny,0,1,Known Attack
49378,445,0,0,66,66,0,1,0,1,0,drop,0,1,Known Attack
49707,445,0,0,70,70,0,1,0,1,0,drop,0,1,Known Attack
53692,44512,0,0,66,66,0,1,0,1,0,deny,0,1,Known Attack
63838,445,0,0,66,66,0,1,0,1,0,drop,0,1,Known Attack
49346,53,28098,53,212,102,110,2,30,1,1,allow,0,0,Normal
53738,443,58635,443,499,425,74,4,0,3,1,allow,0,0,Normal
42094,35440,0,0,62,62,0,1,0,1,0,deny,0,1,Known Attack
52453,443,8871,443,6650,950,5700,18,75,9,9,allow,1,0,Potential Threat
30654,51221,0,0,72,72,0,1,0,1,0,deny,1,1,High Risk
50534,53,27625,53,168,86,82,2,30,1,1,allow,0,0,Normal
56986,53,7478,53,259,87,172,4,37,2,2,allow,0,0,Normal
50544,443,24381,443,8592,1152,7440,25,150,13,12,allow,1,0,Potential Threat
59604,445,0,0,70,70,0,1,0,1,0,drop,0,1,Known Attack
60523,443,60523,443,1088,641,447,10,25,6,4,allow,1,0,Potential Threat
9523,443,27776,443,7199,1410,5789,22,33,11,11,allow,1,0,Potential Threat
46275,64147,0,0,62,62,0,1,0,1,0,deny,1,1,High Risk
52103,53733,0,0,66,66,0,1,0,1,0,deny,0,1,Known Attack
56629,53,45116,53,183,94,89,2,29,1,1,allow,0,0,Normal
33259,443,58382,443,4193,2689,1504,23,23,14,9,allow,1,0,Potential Threat
61265,445,0,0,70,70,0,1,0,1,0,drop,0,1,Known Attack
49263,445,0,0,66,66,0,1,0,1,0,drop,0,1,Known Attack
55563,53,57917,53,763,101,662,2,30,1,1,allow,0,0,Normal
53995,25174,0,0,66,66,0,1,0,1,0,deny,0,1,Known Attack
55037,443,21745,443,2639,258,2381,9,120,4,5,allow,1,0,Potential Threat
51838,29448,59159,29448,70,70,0,1,5,1,0,allow,1,0,Potential Threat
58366,445,0,0,70,70,0,1,0,1,0,drop,0,1,Known Attack
55453,443,3812,443,3015948,160028,2855920,3852,218,1499,2353,allow,1,0,Potential Threat
56638,445,0,0,66,66,0,1,0,1,0,drop,0,1,Known Attack
52658,445,0,0,66,66,0,1,0,1,0,drop,0,1,Known Attack
53736,37168,47120,37168,70,70,0,2,7,2,0,allow,1,0,Potential Threat
59404,443,10904,443,2962,1844,1118,16,15,8,8,allow,1,0,Potential Threat
2919,57866,0,0,66,66,0,1,0,1,0,deny,1,1,High Risk
37568,443,13649,443,1702,861,841,19,110,10,9,allow,1,0,Potential Threat
20724,19750,0,0,78,78,0,1,0,1,0,deny,0,1,Known Attack
64091,53,52948,53,172,88,84,2,30,1,1,allow,0,0,Normal
49418,27016,50703,27016,258,78,180,2,31,1,1,allow,1,0,Potential Threat
36256,443,38729,443,3936219,107920,3828299,3880,132,1208,2672,allow,1,0,Potential Threat
51946,445,0,0,70,70,0,1,0,1,0,drop,0,1,Known Attack
33825,443,41237,443,9407,2233,7174,38,96,16,22,allow,1,0,Potential Threat
57397,53,60967,53,177,94,83,2,30,1,1,allow,0,0,Normal
1100,27540,17868,27540,132,70,62,2,30,1,1,allow,1,0,Potential Threat
1092,57470,0,0,145,145,0,1,0,1,0,deny,1,1,High Risk
65112,53,30397,53,202,103,99,2,31,1,1,allow,0,0,Normal
49869,443,47117,443,7910,1967,5943,30,55,15,15,allow,1,0,Potential Threat
54991,36829,0,0,62,62,0,1,0,1,0,deny,0,1,Known Attack
49713,53,44635,53,177,94,83,2,30,1,1,allow,0,0,Normal
51955,80,57774,80,366,240,126,7,27,5,2,allow,0,0,Normal
64053,47783,54848,47783,66,66,0,2,7,2,0,allow,1,0,Potential Threat
56853,53,30375,53,167,86,81,2,29,1,1,allow,0,0,Normal
64739,53,44159,53,172,88,84,2,30,1,1,allow,0,0,Normal
57900,443,44556,443,1798,1159,639,17,170,10,7,allow,1,0,Potential Threat
50297,445,0,0,66,66,0,1,0,1,0,drop,0,1,Known Attack
57366,53,36112,53,711,87,624,2,31,1,1,allow,0,0,Normal
50696,445,0,0,66,66,0,1,0,1,0,drop,0,1,Known Attack
63214,445,0,0,70,70,0,1,0,1,0,drop,0,1,Known Attack
52956,445,0,0,70,70,0,1,0,1,0,drop,0,1,Known Attack
50566,443,28525,443,7367,1149,6218,18,27,9,9,allow,1,0,Potential Threat
57226,53,4215,53,88,88,0,1,30,1,0,allow,0,0,Normal
65112,53,6227,53,209,110,99,2,31,1,1,allow,0,0,Normal
56182,80,62619,80,2085,797,1288,10,15,6,4,allow,1,0,Potential Threat
38694,443,56498,443,90289,3481,86808,96,16,31,65,allow,1,0,Potential Threat
48710,22,48710,22,11002,3445,7557,60,42,26,34,allow,1,0,Potential Threat
53883,443,37691,443,495,421,74,4,0,3,1,allow,0,0,Normal
62765,16933,0,0,66,66,0,1,0,1,0,deny,0,1,Known Attack
56606,3389,56606,3389,4130,2105,2025,18,16,9,9,allow,1,0,Potential Threat
52479,443,31867,443,9326,1833,7493,24,131,12,12,allow,1,0,Potential Threat
58638,5900,0,0,62,62,0,1,0,1,0,deny,0,1,Known Attack
443,59493,0,0,60,60,0,1,0,1,0,deny,1,1,High Risk
57497,445,0,0,66,66,0,1,0,1,0,drop,0,1,Known Attack
44881,53,62824,53,212,78,134,2,30,1,1,allow,1,0,Potential Threat
53070,53,0,0,168,74,94,2,29,1,1,allow,0,0,Normal
36067,443,36067,443,228681,29484,199197,303,110,149,154,allow,1,0,Potential Threat
54808,445,0,0,70,70,0,1,0,1,0,drop,0,1,Known Attack
49394,443,62275,443,1392,731,661,14,80,8,6,allow,1,0,Potential Threat
2932,44847,0,0,66,66,0,1,0,1,0,deny,1,1,High Risk
56896,53,19605,53,256,87,169,2,30,1,1,allow,0,0,Normal
64685,53,31549,53,199,102,97,2,30,1,1,allow,0,0,Normal
54633,36237,0,0,66,66,0,1,0,1,0,deny,0,1,Known Attack
60711,443,10147,443,10569,3485,7084,27,515,15,12,allow,1,0,Potential Threat
50878,80,60118,80,325925,18062,307863,377,146,161,216,allow,1,0,Potential Threat
51446,53,21490,53,168,78,90,2,30,1,1,allow,0,0,Normal
54571,445,0,0,70,70,0,1,0,1,0,drop,0,1,Known Attack
51434,445,0,0,70,70,0,1,0,1,0,drop,0,1,Known Attack
64820,53,13245,53,190,97,93,2,31,1,1,allow,0,0,Normal
61369,64147,0,0,66,66,0,1,0,1,0,deny,1,1,High Risk
443,31353,0,0,97,97,0,1,0,1,0,deny,1,1,High Risk
52699,25174,0,0,66,66,0,1,0,1,0,deny,0,1,Known Attack
49418,27055,11921,27055,269,78,191,2,30,1,1,allow,1,0,Potential Threat
44884,443,1595,443,309,309,0,1,5,1,0,allow,0,0,Normal
57834,80,57834,80,2106,1657,449,10,20,6,4,allow,1,0,Potential Threat
55902,53,58638,53,181,94,87,2,30,1,1,allow,0,0,Normal
54410,443,16745,443,7256,1669,5587,27,318,15,12,allow,1,0,Potential Threat
56236,80,56236,80,44755,823,43932,45,15,12,33,allow,1,0,Potential Threat
10128,23718,0,0,146,146,0,1,0,1,0,deny,1,1,High Risk
60934,80,21512,80,1212,774,438,11,81,7,4,allow,1,0,Potential Threat
56912,53,8353,53,199,102,97,2,30,1,1,allow,0,0,Normal
35357,53,47462,53,291,86,205,2,29,1,1,allow,0,0,Normal
50118,445,0,0,70,70,0,1,0,1,0,drop,0,1,Known Attack
55002,53,11641,53,196,102,94,2,31,1,1,allow,0,0,Normal
53923,445,0,0,70,70,0,1,0,1,0,drop,0,1,Known Attack
53550,445,0,0,66,66,0,1,0,1,0,drop,0,1,Known Attack
59592,37965,0,0,62,62,0,1,0,1,0,deny,0,1,Known Attack
23406,443,23406,443,5368,1609,3759,21,75,12,9,allow,1,0,Potential Threat
64032,12343,46737,12343,630,508,122,9,15,7,2,allow,1,0,Potential Threat
58445,17500,0,0,66,66,0,1,0,1,0,deny,0,1,Known Attack
50938,80,32549,80,10272889,104948,10167941,8416,121,1525,6891,allow,1,0,Potential Threat
14263,22114,0,0,62,62,0,1,0,1,0,deny,0,1,Known Attack
35702,443,51381,443,13428,5815,7613,42,995,22,20,allow,1,0,Potential Threat
17262,25174,0,0,62,62,0,1,0,1,0,deny,0,1,Known Attack
50391,445,0,0,66,66,0,1,0,1,0,drop,0,1,Known Attack
60048,445,0,0,66,66,0,1,0,1,0,drop,0,1,Known Attack
62566,35993,0,0,62,62,0,1,0,1,0,deny,0,1,Known Attack
49378,53,56071,53,268,94,174,2,30,1,1,allow,0,0,Normal
12060,37965,0,0,66,66,0,1,0,1,0,deny,1,1,High Risk
53756,61137,24650,61137,672,306,366,11,16,5,6,allow,1,0,Potential Threat
55535,53,57254,53,199,102,97,2,30,1,1,allow,0,0,Normal
54528,443,20055,443,6256,1871,4385,20,45,12,8,allow,1,0,Potential Threat
55868,53,18445,53,177,94,83,2,30,1,1,allow,0,0,Normal
64912,53,63953,53,356,118,238,2,30,1,1,allow,1,0,Potential Threat
9445,56205,0,0,66,66,0,1,0,1,0,deny,1,1,High Risk
58597,35440,0,0,66,66,0,1,0,1,0,deny,0,1,Known Attack
60727,445,0,0,70,70,0,1,0,1,0,drop,0,1,Known Attack
55570,53,55501,53,341,134,207,2,30,1,1,allow,0,0,Normal
63937,53,33435,53,183,94,89,2,30,1,1,allow,0,0,Normal
55046,53,20538,53,300,102,198,4,40,2,2,allow,0,0,Normal
55634,53,8065,53,210,110,100,2,30,1,1,allow,0,0,Normal
49461,53,38932,53,198,102,96,2,29,1,1,allow,0,0,Normal
49745,53,63902,53,1472,98,1374,4,54,2,2,allow,1,0,Potential Threat
50792,443,51398,443,144115,19017,125098,229,400,112,117,allow,1,0,Potential Threat
62692,445,0,0,70,70,0,1,0,1,0,drop,0,1,Known Attack
50078,443,13152,443,12035,9784,2251,41,92,22,19,allow,1,0,Potential Threat
53972,59089,65256,59089,70,70,0,2,7,2,0,allow,1,0,Potential Threat
55264,53,25192,53,177,94,83,2,30,1,1,allow,0,0,Normal
50328,22114,0,0,66,66,0,1,0,1,0,deny,0,1,Known Attack
59530,445,0,0,66,66,0,1,0,1,0,drop,0,1,Known Attack
57115,53,1229,53,178,94,84,2,30,1,1,allow,0,0,Normal
64546,57470,0,0,66,66,0,1,0,1,0,deny,1,1,High Risk
60117,50934,0,0,66,66,0,1,0,1,0,deny,0,1,Known Attack
56618,443,57435,443,8034,2014,6020,20,15,11,9,allow,1,0,Potential Threat
64242,53,3579,53,180,94,86,2,30,1,1,allow,0,0,Normal
55312,443,20877,443,7952,3638,4314,36,149,17,19,allow,1,0,Potential Threat
53136,41442,29017,41442,70,70,0,2,8,2,0,allow,1,0,Potential Threat
52495,443,36037,443,32875,8836,24039,37,16,15,22,allow,1,0,Potential Threat
62152,56205,0,0,66,66,0,1,0,1,0,deny,1,1,High Risk
63050,53,33894,53,384,166,218,2,30,1,1,allow,0,0,Normal
55640,445,0,0,70,70,0,1,0,1,0,drop,0,1,Known Attack
57504,44847,0,0,66,66,0,1,0,1,0,deny,0,1,Known Attack
52793,443,27629,443,1942,1281,661,22,228,16,6,allow,1,0,Potential Threat
50376,53,42212,53,819,102,717,2,30,1,1,allow,0,0,Normal
60078,80,2527,80,1114,534,580,12,15,7,5,allow,1,0,Potential Threat
55679,1024,59914,1024,70,70,0,2,8,2,0,allow,1,0,Potential Threat
27084,50584,0,0,66,66,0,1,0,1,0,deny,1,1,High Risk
63951,53,13752,53,186,95,91,2,31,1,1,allow,0,0,Normal
63819,18445,34551,18445,70,70,0,1,4,1,0,allow,1,0,Potential Threat
53183,445,0,0,66,66,0,1,0,1,0,drop,0,1,Known Attack
53239,443,57625,443,84664,6099,78565,140,70,56,84,allow,1,0,Potential Threat
63190,445,0,0,70,70,0,1,0,1,0,drop,0,1,Known Attack
60608,53,20949,53,199,94,105,2,30,1,1,allow,0,0,Normal
50986,80,14169,80,8074,2261,5813,22,19,13,9,allow,1,0,Potential Threat
62489,23117,0,0,66,66,0,1,0,1,0,deny,0,1,Known Attack
50511,445,0,0,70,70,0,1,0,1,0,drop,0,1,Known Attack
61145,445,0,0,70,70,0,1,0,1,0,drop,0,1,Known Attack
63938,3389,63938,3389,3364,1714,1650,15,32,8,7,allow,1,0,Potential Threat
49787,445,0,0,70,70,0,1,0,1,0,drop,0,1,Known Attack
26879,37965,0,0,62,62,0,1,0,1,0,deny,0,1,Known Attack
63001,445,0,0,70,70,0,1,0,1,0,drop,0,1,Known Attack
4110,35440,0,0,66,66,0,1,0,1,0,deny,1,1,High Risk
64312,53,41455,53,225,110,115,2,30,1,1,allow,0,0,Normal
57179,445,0,0,70,70,0,1,0,1,0,drop,0,1,Known Attack
50946,44847,0,0,66,66,0,1,0,1,0,deny,0,1,Known Attack
55877,22374,2922,22374,150,150,0,1,1200,1,0,allow,1,0,Potential Threat
42889,443,3091,443,3961,1595,2366,21,15,12,9,allow,1,0,Potential Threat
65139,53,19988,53,216,110,106,2,31,1,1,allow,0,0,Normal
53938,445,0,0,70,70,0,1,0,1,0,drop,0,1,Known Attack
6889,8970,0,0,143,143,0,1,0,1,0,reset-both,1,1,High Risk
50584,11830,62858,11830,2118,900,1218,14,4232,7,7,allow,1,0,Potential Threat
50255,445,0,0,70,70,0,1,0,1,0,drop,0,1,Known Attack
60533,445,0,0,70,70,0,1,0,1,0,drop,0,1,Known Attack
49573,443,10413,443,1326,876,450,11,55,6,5,allow,1,0,Potential Threat
36903,56205,0,0,62,62,0,1,0,1,0,deny,1,1,High Risk
55199,53,62068,53,152,78,74,2,30,1,1,allow,0,0,Normal
59455,53,0,0,221,81,140,2,31,1,1,allow,0,0,Normal
64277,53,1694,53,337,110,227,2,30,1,1,allow,0,0,Normal
1182,23,0,0,60,60,0,1,0,1,0,deny,1,1,High Risk
39053,443,36119,443,6699,4494,2205,27,29,14,13,allow,1,0,Potential Threat
51614,15000,49065,15000,130,70,60,2,5,1,1,allow,1,0,Potential Threat
56830,53,55667,53,195,102,93,2,30,1,1,allow,0,0,Normal
50653,80,33144,80,124643,7017,117626,163,21,75,88,allow,1,0,Potential Threat
60368,443,34243,443,6041,1830,4211,21,82,10,11,allow,1,0,Potential Threat
58909,445,0,0,70,70,0,1,0,1,0,drop,0,1,Known Attack
51518,443,51518,443,15967,3046,12921,39,173,15,24,allow,1,0,Potential Threat
61989,445,0,0,70,70,0,1,0,1,0,drop,0,1,Known Attack
54553,443,44028,443,68345,58488,9857,122,329,62,60,allow,1,0,Potential Threat
61456,443,24877,443,9577,1475,8102,30,124,14,16,allow,1,0,Potential Threat
49233,53,56407,53,196,102,94,2,29,1,1,allow,0,0,Normal
49317,53,48476,53,166,86,80,2,30,1,1,allow,0,0,Normal
55024,53,61199,53,174,89,85,2,30,1,1,allow,0,0,Normal
35053,80,19912,80,71843,2833,69010,83,15,36,47,allow,1,0,Potential Threat
50973,445,0,0,70,70,0,1,0,1,0,drop,0,1,Known Attack
11716,37965,0,0,62,62,0,1,0,1,0,deny,1,1,High Risk
59043,35440,0,0,66,66,0,1,0,1,0,deny,0,1,Known Attack
54329,443,7872,443,7827,2416,5411,18,136,8,10,allow,1,0,Potential Threat
31404,52955,0,0,100,100,0,1,0,1,0,deny,1,1,High Risk
16092,50265,0,0,62,62,0,1,0,1,0,deny,1,1,High Risk
59194,445,0,0,66,66,0,1,0,1,0,drop,0,1,Known Attack
20520,53,20520,53,215,80,135,2,32,1,1,allow,0,0,Normal
65009,53,56985,53,737,94,643,2,30,1,1,allow,1,0,Potential Threat
35287,443,46797,443,47587,20536,27051,345,581,173,172,allow,1,0,Potential Threat
55336,443,52055,443,209596,37190,172406,378,79,184,194,allow,1,0,Potential Threat
64110,51617,13818,51617,66,66,0,2,7,2,0,allow,1,0,Potential Threat
22724,9822,0,0,62,62,0,1,0,1,0,deny,0,1,Known Attack
65382,53,24981,53,301,108,193,4,54,2,2,allow,0,0,Normal
49209,53,10202,53,198,101,97,2,31,1,1,allow,0,0,Normal
49998,53,44432,53,94,94,0,1,30,1,0,allow,0,0,Normal
59752,443,56734,443,2233,1237,996,18,75,9,9,allow,1,0,Potential Threat
62813,25174,0,0,62,62,0,1,0,1,0,deny,0,1,Known Attack
44847,37005,6154,37005,150,150,0,1,1200,1,0,allow,1,0,Potential Threat
7423,22114,0,0,62,62,0,1,0,1,0,deny,1,1,High Risk
33045,443,23219,443,4446,1298,3148,15,34,8,7,allow,1,0,Potential Threat
56249,55442,0,0,66,66,0,1,0,1,0,deny,0,1,Known Attack
51157,445,0,0,70,70,0,1,0,1,0,drop,0,1,Known Attack
68,67,0,0,346,346,0,1,0,1,0,deny,1,1,High Risk
63838,445,0,0,70,70,0,1,0,1,0,drop,0,1,Known Attack
58638,5900,0,0,62,62,0,1,0,1,0,deny,0,1,Known Attack
49670,53,59914,53,168,86,82,2,31,1,1,allow,0,0,Normal
50024,445,0,0,70,70,0,1,0,1,0,drop,0,1,Known Attack
56337,53,46173,53,268,89,179,4,45,2,2,allow,0,0,Normal
54206,25174,0,0,62,62,0,1,0,1,0,deny,0,1,Known Attack
38871,80,51643,80,2057,1263,794,10,15,6,4,allow,1,0,Potential Threat
51808,443,51808,443,1466,856,610,13,27,6,7,allow,1,0,Potential Threat
53621,443,63130,443,2005,1100,905,16,17,9,7,allow,1,0,Potential Threat
52173,44632,6542,44632,156,66,90,2,5,1,1,allow,1,0,Potential Threat
64963,27037,16564,27037,741,462,279,2,31,1,1,allow,1,0,Potential Threat
53388,445,0,0,66,66,0,1,0,1,0,drop,0,1,Known Attack
54476,443,29193,443,48303,3997,44306,69,271,30,39,allow,1,0,Potential Threat
55421,53,47278,53,200,102,98,2,30,1,1,allow,0,0,Normal
65239,443,50519,443,5780,2572,3208,23,120,11,12,allow,1,0,Potential Threat
51174,443,12417,443,786014,23908,762106,803,47,276,527,allow,1,0,Potential Threat
56553,445,0,0,70,70,0,1,0,1,0,drop,0,1,Known Attack
47637,443,16997,443,280,140,140,5,151,3,2,allow,0,0,Normal
59057,445,0,0,70,70,0,1,0,1,0,drop,0,1,Known Attack
54132,445,0,0,70,70,0,1,0,1,0,drop,0,1,Known Attack
50248,443,36330,443,8882,3013,5869,29,137,14,15,allow,1,0,Potential Threat
15018,37965,0,0,62,62,0,1,0,1,0,deny,1,1,High Risk
55693,45341,14771,45341,70,70,0,2,8,2,0,allow,1,0,Potential Threat
49229,6921,0,0,145,145,0,1,0,1,0,deny,0,1,Known Attack
62597,53,18771,53,102,102,0,1,30,1,0,allow,0,0,Normal
23277,53733,0,0,66,66,0,1,0,1,0,deny,1,1,High Risk
37965,50321,10306,50321,158,158,0,1,1199,1,0,allow,1,0,Potential Threat
53475,3389,0,0,66,66,0,1,0,1,0,deny,0,1,Known Attack
55512,53,3521,53,458,188,270,6,30,3,3,allow,0,0,Normal
50649,443,16928,443,15295,1755,13540,31,77,15,16,allow,1,0,Potential Threat
61213,445,0,0,66,66,0,1,0,1,0,drop,0,1,Known Attack
49741,443,56871,443,6060,1553,4507,18,129,10,8,allow,1,0,Potential Threat
60423,52001,49584,52001,260,140,120,5,9,3,2,allow,1,0,Potential Threat
42117,443,44867,443,9999,4008,5991,33,345,18,15,allow,1,0,Potential Threat
65226,53,19267,53,79,79,0,2,34,2,0,allow,0,0,Normal
65324,445,0,0,70,70,0,1,0,1,0,drop,0,1,Known Attack
60302,445,0,0,70,70,0,1,0,1,0,drop,0,1,Known Attack
64116,443,49764,443,7439,1156,6283,19,75,11,8,allow,1,0,Potential Threat
50564,443,57456,443,1313,876,437,11,26,6,5,allow,1,0,Potential Threat
49622,445,0,0,66,66,0,1,0,1,0,drop,0,1,Known Attack
55170,53,27773,53,250,94,156,2,30,1,1,allow,0,0,Normal
54489,445,0,0,70,70,0,1,0,1,0,drop,0,1,Known Attack
51972,5222,10197,5222,5410,2343,3067,42,53,24,18,allow,1,0,Potential Threat
56685,443,20018,443,7855,1866,5989,20,15,11,9,allow,1,0,Potential Threat
15403,51505,0,0,66,66,0,1,0,1,0,deny,1,1,High Risk
57202,53,54278,53,293,94,199,4,43,2,2,allow,0,0,Normal
49566,443,36540,443,10225,5069,5156,30,106,17,13,allow,1,0,Potential Threat
65185,445,0,0,70,70,0,1,0,1,0,drop,0,1,Known Attack
56835,53,43767,53,213,102,111,2,30,1,1,allow,0,0,Normal
34341,28678,47024,28678,1806,1806,0,22,224,22,0,allow,1,0,Potential Threat
49514,52255,0,0,162,162,0,1,0,1,0,deny,1,1,High Risk
25565,30367,0,0,60,60,0,1,0,1,0,deny,0,1,Known Attack
64614,53,5990,53,517,179,338,6,62,3,3,allow,1,0,Potential Threat
65280,53,4153,53,164,84,80,2,31,1,1,allow,0,0,Normal
34517,443,44047,443,5996,1967,4029,17,99,10,7,allow,1,0,Potential Threat
56668,53,30534,53,199,102,97,2,30,1,1,allow,0,0,Normal
58638,5900,0,0,62,62,0,1,0,1,0,deny,0,1,Known Attack
57817,445,0,0,70,70,0,1,0,1,0,drop,0,1,Known Attack
57238,443,50721,443,7549,2807,4742,42,78,22,20,allow,1,0,Potential Threat
123,123,8140,123,184,94,90,2,30,1,1,allow,1,0,Potential Threat
61478,445,0,0,70,70,0,1,0,1,0,drop,0,1,Known Attack
21492,51505,0,0,146,146,0,1,0,1,0,deny,1,1,High Risk
49428,53,34747,53,267,94,173,2,31,1,1,allow,0,0,Normal
60073,80,45095,80,10676,6719,3957,23,141,12,11,allow,1,0,Potential Threat
1026,30188,0,0,146,146,0,1,0,1,0,deny,1,1,High Risk
52096,443,13873,443,4747,3601,1146,18,15,10,8,allow,1,0,Potential Threat
49940,445,0,0,66,66,0,1,0,1,0,drop,0,1,Known Attack
5208,63836,0,0,145,145,0,1,0,1,0,deny,1,1,High Risk
39064,443,7055,443,11356,4341,7015,33,128,16,17,allow,1,0,Potential Threat
37603,443,12094,443,8493,2314,6179,33,15,18,15,allow,1,0,Potential Threat
50689,445,0,0,70,70,0,1,0,1,0,drop,0,1,Known Attack
10669,49756,0,0,60,60,0,1,0,1,0,deny,1,1,High Risk
54014,445,0,0,70,70,0,1,0,1,0,drop,0,1,Known Attack
55205,53,50575,53,167,86,81,2,30,1,1,allow,0,0,Normal
50341,37965,0,0,66,66,0,1,0,1,0,deny,0,1,Known Attack
57307,53,14179,53,177,94,83,2,30,1,1,allow,0,0,Normal
50379,443,5364,443,6748,1843,4905,21,29,11,10,allow,1,0,Potential Threat
50544,445,0,0,70,70,0,1,0,1,0,drop,0,1,Known Attack
13871,53,13871,53,240,98,142,2,30,1,1,allow,0,0,Normal
44710,25174,0,0,62,62,0,1,0,1,0,deny,0,1,Known Attack
50502,123,48233,123,184,94,90,2,30,1,1,allow,0,0,Normal
8999,1,0,0,62,62,0,1,0,1,0,deny,0,1,Known Attack
50584,18066,56366,18066,1705,536,1169,5,1200,4,1,allow,1,0,Potential Threat
55018,53,31411,53,174,89,85,2,30,1,1,allow,0,0,Normal
58251,36237,0,0,62,62,0,1,0,1,0,deny,0,1,Known Attack
61524,23,0,0,60,60,0,1,0,1,0,deny,0,1,Known Attack
46902,123,43333,123,184,94,90,2,30,1,1,allow,0,0,Normal
62600,445,0,0,66,66,0,1,0,1,0,drop,0,1,Known Attack
53807,445,0,0,70,70,0,1,0,1,0,drop,0,1,Known Attack
49627,445,0,0,70,70,0,1,0,1,0,drop,0,1,Known Attack
43937,123,21193,123,184,94,90,2,30,1,1,allow,0,0,Normal
55101,53,27553,53,194,99,95,2,30,1,1,allow,0,0,Normal
56752,80,35742,80,1462,703,759,8,16,5,3,allow,0,0,Normal
61461,443,31107,443,9073,2899,6174,36,94,19,17,allow,1,0,Potential Threat
40500,5618,0,0,146,146,0,1,0,1,0,reset-both,0,1,Known Attack
1024,64147,0,0,62,62,0,1,0,1,0,deny,1,1,High Risk
64048,53,38443,53,209,110,99,2,30,1,1,allow,0,0,Normal
50602,26467,0,0,66,66,0,1,0,1,0,deny,0,1,Known Attack
64385,53,43683,53,179,94,85,2,30,1,1,allow,0,0,Normal
59136,50584,0,0,66,66,0,1,0,1,0,deny,0,1,Known Attack
53012,51050,0,0,66,66,0,1,0,1,0,deny,0,1,Known Attack
48737,443,47925,443,5220,2290,2930,15,121,7,8,allow,1,0,Potential Threat
64192,53,23253,53,308,110,198,2,29,1,1,allow,0,0,Normal
55161,53,36813,53,197,94,103,2,30,1,1,allow,0,0,Normal
63755,445,0,0,66,66,0,1,0,1,0,drop,0,1,Known Attack
58497,39004,0,0,66,66,0,1,0,1,0,deny,0,1,Known Attack
57321,53,34343,53,762,98,664,2,30,1,1,allow,0,0,Normal
52038,80,51825,80,70,70,0,1,5,1,0,allow,0,0,Normal
53960,61038,13704,61038,552,306,246,9,14,5,4,allow,1,0,Potential Threat
51458,445,0,0,70,70,0,1,0,1,0,drop,0,1,Known Attack
20108,64147,0,0,66,66,0,1,0,1,0,deny,1,1,High Risk
57339,53,43284,53,184,80,104,2,30,1,1,allow,0,0,Normal
60772,36829,0,0,62,62,0,1,0,1,0,deny,0,1,Known Attack
59937,37965,0,0,66,66,0,1,0,1,0,deny,0,1,Known Attack
64776,50584,0,0,66,66,0,1,0,1,0,deny,1,1,High Risk
51754,1182,24029,1182,70,70,0,1,5,1,0,allow,0,0,Normal
54797,80,8308,80,8957,4075,4882,32,416,17,15,allow,1,0,Potential Threat
54970,443,62898,443,251620,16028,235592,353,371,159,194,allow,1,0,Potential Threat
59505,53733,0,0,66,66,0,1,0,1,0,deny,0,1,Known Attack
63161,445,0,0,70,70,0,1,0,1,0,drop,0,1,Known Attack
46002,53,40286,53,168,78,90,2,30,1,1,allow,0,0,Normal
16230,53,64249,53,223,78,145,2,30,1,1,allow,1,0,Potential Threat
44933,26467,0,0,62,62,0,1,0,1,0,deny,0,1,Known Attack
17230,25174,0,0,146,146,0,1,0,1,0,deny,1,1,High Risk
60561,445,0,0,66,66,0,1,0,1,0,drop,0,1,Known Attack
49339,80,8376,80,1467,361,1106,10,15,5,5,allow,1,0,Potential Threat
55487,53,11679,53,195,102,93,2,30,1,1,allow,0,0,Normal
49972,53,10685,53,216,110,106,2,31,1,1,allow,0,0,Normal
49952,53,43225,53,196,94,102,2,30,1,1,allow,0,0,Normal
63943,53,44134,53,196,94,102,2,30,1,1,allow,0,0,Normal
60701,445,0,0,70,70,0,1,0,1,0,drop,0,1,Known Attack
57220,53,51033,53,701,88,613,2,30,1,1,allow,0,0,Normal
56838,445,0,0,66,66,0,1,0,1,0,drop,0,1,Known Attack
60976,22114,0,0,62,62,0,1,0,1,0,deny,0,1,Known Attack
61077,445,0,0,66,66,0,1,0,1,0,drop,0,1,Known Attack
49332,53,39051,53,740,93,647,2,31,1,1,allow,0,0,Normal
37632,443,56701,443,11338,2980,8358,31,46,18,13,allow,1,0,Potential Threat
59083,445,0,0,66,66,0,1,0,1,0,drop,0,1,Known Attack
42951,22114,0,0,66,66,0,1,0,1,0,deny,0,1,Known Attack
59845,44847,0,0,66,66,0,1,0,1,0,deny,0,1,Known Attack
53992,445,0,0,66,66,0,1,0,1,0,drop,0,1,Known Attack
63886,445,0,0,66,66,0,1,0,1,0,drop,0,1,Known Attack
64772,445,0,0,70,70,0,1,0,1,0,drop,0,1,Known Attack
58932,53,21682,53,168,78,90,2,31,1,1,allow,0,0,Normal
64094,1024,11634,1024,66,66,0,2,8,2,0,allow,0,0,Normal
57413,445,0,0,66,66,0,1,0,1,0,drop,0,1,Known Attack
57731,445,0,0,70,70,0,1,0,1,0,drop,0,1,Known Attack
27005,27017,4799,27017,883,126,757,2,30,1,1,allow,1,0,Potential Threat
65036,53,31003,53,209,94,115,2,30,1,1,allow,0,0,Normal
53104,445,0,0,70,70,0,1,0,1,0,drop,0,1,Known Attack
47969,53,59484,53,199,94,105,2,30,1,1,allow,0,0,Normal
49410,53,65177,53,172,88,84,2,31,1,1,allow,1,0,Potential Threat
61385,445,0,0,70,70,0,1,0,1,0,drop,0,1,Known Attack
50055,445,0,0,70,70,0,1,0,1,0,drop,0,1,Known Attack
61369,64147,0,0,62,62,0,1,0,1,0,deny,1,1,High Risk
60239,445,0,0,66,66,0,1,0,1,0,drop,0,1,Known Attack
48817,23944,48817,23944,513,152,361,2,1201,1,1,allow,1,0,Potential Threat
52427,445,0,0,66,66,0,1,0,1,0,drop,0,1,Known Attack
56991,443,28802,443,20986,10828,10158,35,95,20,15,allow,1,0,Potential Threat
55165,53,30043,53,199,102,97,2,30,1,1,allow,0,0,Normal
37455,50584,0,0,66,66,0,1,0,1,0,deny,0,1,Known Attack
65491,53,6276,53,889,404,485,10,30,5,5,allow,1,0,Potential Threat
52003,44512,0,0,66,66,0,1,0,1,0,deny,0,1,Known Attack
51496,443,41580,443,1177,624,553,12,16,7,5,allow,1,0,Potential Threat
61413,80,4426,80,283970,23419,260551,574,158,255,319,allow,1,0,Potential Threat
62877,53,36980,53,248,78,170,2,30,1,1,allow,0,0,Normal
65087,53,63765,53,230,110,120,2,30,1,1,allow,1,0,Potential Threat
51825,25501,11280,25501,70,70,0,2,9,2,0,allow,1,0,Potential Threat
34775,5900,0,0,60,60,0,1,0,1,0,deny,0,1,Known Attack
60287,80,59923,80,10135,7433,2702,28,164,19,9,allow,1,0,Potential Threat
64385,53,21883,53,307,105,202,4,47,2,2,allow,0,0,Normal
50564,445,0,0,66,66,0,1,0,1,0,drop,0,1,Known Attack
39311,443,39728,443,12825,8114,4711,63,269,25,38,allow,1,0,Potential Threat
60337,443,11026,443,1862,1223,639,18,89,11,7,allow,1,0,Potential Threat
34297,443,14287,443,65853,31390,34463,203,694,105,98,allow,1,0,Potential Threat
26884,37965,0,0,66,66,0,1,0,1,0,deny,1,1,High Risk
62556,445,0,0,66,66,0,1,0,1,0,drop,0,1,Known Attack
57797,445,0,0,70,70,0,1,0,1,0,drop,0,1,Known Attack
49772,80,38136,80,70,70,0,2,8,2,0,allow,0,0,Normal
50584,55727,63781,55727,2268,1050,1218,15,5442,8,7,allow,1,0,Potential Threat
64332,53,6045,53,167,86,81,2,30,1,1,allow,0,0,Normal
56638,80,7412,80,234,234,0,4,11,4,0,allow,0,0,Normal
56884,53,31028,53,177,94,83,2,30,1,1,allow,0,0,Normal
49488,53,28678,53,194,102,92,2,31,1,1,allow,0,0,Normal
58253,445,0,0,70,70,0,1,0,1,0,drop,0,1,Known Attack
49920,443,59929,443,6489,2137,4352,28,143,14,14,allow,1,0,Potential Threat
61430,37965,0,0,66,66,0,1,0,1,0,deny,0,1,Known Attack
53574,23650,56670,23650,320,140,180,6,5,3,3,allow,1,0,Potential Threat
64670,53,9827,53,183,86,97,2,30,1,1,allow,0,0,Normal
31675,19473,0,0,62,62,0,1,0,1,0,deny,0,1,Known Attack
60033,443,16938,443,2845,1765,1080,15,142,8,7,allow,1,0,Potential Threat
56422,80,3635,80,35833,938,34895,37,104,11,26,allow,1,0,Potential Threat
6929,35440,0,0,62,62,0,1,0,1,0,deny,1,1,High Risk
62160,53,62160,53,205,81,124,2,30,1,1,allow,1,0,Potential Threat
57377,443,4552,443,5553,927,4626,16,15,10,6,allow,1,0,Potential Threat
64528,53,42814,53,353,118,235,2,30,1,1,allow,0,0,Normal
56927,53,57010,53,749,94,655,2,31,1,1,allow,0,0,Normal
49974,445,0,0,66,66,0,1,0,1,0,drop,0,1,Known Attack
62549,64147,0,0,62,62,0,1,0,1,0,deny,1,1,High Risk
64079,53,36707,53,232,94,138,2,30,1,1,allow,0,0,Normal
50478,80,50478,80,28032,3868,24164,47,24,23,24,allow,1,0,Potential Threat
55562,50584,0,0,66,66,0,1,0,1,0,deny,0,1,Known Attack
55349,53,28852,53,744,89,655,2,30,1,1,allow,0,0,Normal
49342,443,27856,443,6944,2404,4540,21,15,10,11,allow,1,0,Potential Threat
60415,53,60415,53,257,101,156,2,33,1,1,allow,0,0,Normal
52204,445,0,0,70,70,0,1,0,1,0,drop,0,1,Known Attack
44947,443,36944,443,6359,4441,1918,33,80,17,16,allow,1,0,Potential Threat
57998,80,49916,80,318,192,126,6,21,4,2,allow,0,0,Normal
61408,30188,0,0,66,66,0,1,0,1,0,deny,0,1,Known Attack
11076,53,11076,53,832,106,726,2,30,1,1,allow,1,0,Potential Threat
55032,443,19722,443,8965,3021,5944,39,360,22,17,allow,1,0,Potential Threat
64657,53,42843,53,816,102,714,2,30,1,1,allow,0,0,Normal
50963,445,0,0,66,66,0,1,0,1,0,drop,0,1,Known Attack
55436,445,0,0,70,70,0,1,0,1,0,drop,0,1,Known Attack
64985,53,37843,53,194,102,92,2,30,1,1,allow,0,0,Normal
49328,443,21805,443,74569,3173,71396,97,80,36,61,allow,1,0,Potential Threat
49700,80,44971,80,71320,1026,70294,64,52,12,52,allow,1,0,Potential Threat
50608,443,5976,443,5039,2265,2774,21,30,11,10,allow,1,0,Potential Threat
55378,445,0,0,66,66,0,1,0,1,0,drop,0,1,Known Attack
48452,443,56539,443,9553,2175,7378,33,27,17,16,allow,1,0,Potential Threat
4138,55777,0,0,66,66,0,1,0,1,0,deny,1,1,High Risk
50325,80,28914,80,19438,12019,7419,53,312,30,23,allow,1,0,Potential Threat
49501,443,35522,443,13077,4380,8697,34,1881,17,17,allow,1,0,Potential Threat
49212,53,34127,53,1188,94,1094,2,29,1,1,allow,0,0,Normal
50179,445,0,0,70,70,0,1,0,1,0,drop,0,1,Known Attack
56931,443,32343,443,34750,2997,31753,61,95,29,32,allow,1,0,Potential Threat
43227,443,48195,443,460628,23936,436692,580,124,264,316,allow,1,0,Potential Threat
55014,443,4277,443,4962,1352,3610,19,135,9,10,allow,1,0,Potential Threat
50810,443,16412,443,10682,4653,6029,28,33,15,13,allow,1,0,Potential Threat
16477,37807,0,0,66,66,0,1,0,1,0,deny,1,1,High Risk
50294,80,24616,80,1515,481,1034,11,15,6,5,allow,0,0,Normal
52860,9694,0,0,62,62,0,1,0,1,0,deny,0,1,Known Attack
52001,80,20376,80,8117874,148550,7969324,7318,25,2033,5285,allow,1,0,Potential Threat
52169,59681,50827,59681,70,70,0,2,8,2,0,allow,1,0,Potential Threat
65100,53,63534,53,199,102,97,2,30,1,1,allow,1,0,Potential Threat
65019,53,29209,53,195,102,93,2,31,1,1,allow,0,0,Normal
50077,443,40548,443,7976,3333,4643,23,25,12,11,allow,1,0,Potential Threat
57903,443,52416,443,5465,2653,2812,28,169,14,14,allow,1,0,Potential Threat
65123,53,24943,53,307,110,197,2,29,1,1,allow,0,0,Normal
26573,44847,0,0,66,66,0,1,0,1,0,deny,1,1,High Risk
64540,53,29410,53,94,94,0,1,30,1,0,allow,0,0,Normal
58638,5900,0,0,62,62,0,1,0,1,0,deny,0,1,Known Attack
64505,445,0,0,66,66,0,1,0,1,0,drop,0,1,Known Attack
57013,80,43644,80,5696,703,4993,14,75,8,6,allow,1,0,Potential Threat
52012,443,5821,443,126,60,66,3,10,2,1,allow,0,0,Normal
58638,5900,0,0,62,62,0,1,0,1,0,deny,0,1,Known Attack
36438,5223,19564,5223,5243,1898,3345,34,3005,18,16,allow,1,0,Potential Threat
64631,53,8154,53,193,102,91,2,30,1,1,allow,0,0,Normal
48818,443,11974,443,4167,1669,2498,23,15,12,11,allow,1,0,Potential Threat
44389,443,27883,443,3067,1817,1250,18,16,8,10,allow,1,0,Potential Threat
64785,53,44600,53,281,94,187,2,29,1,1,allow,0,0,Normal
52054,443,46268,443,9339,4411,4928,20,135,10,10,allow,1,0,Potential Threat
63583,37965,0,0,66,66,0,1,0,1,0,deny,0,1,Known Attack
56372,53,63368,53,172,94,78,2,29,1,1,allow,1,0,Potential Threat
57945,443,56695,443,3522,1763,1759,31,32,16,15,allow,1,0,Potential Threat
60796,443,14652,443,69973,4662,65311,108,135,43,65,allow,1,0,Potential Threat
58638,5900,0,0,62,62,0,1,0,1,0,deny,0,1,Known Attack
46982,443,35062,443,3847,2650,1197,22,35,13,9,allow,1,0,Potential Threat
57816,445,0,0,66,66,0,1,0,1,0,drop,0,1,Known Attack
49826,53,43562,53,466,192,274,6,83,3,3,allow,0,0,Normal
53112,29258,11040,29258,70,70,0,2,8,2,0,allow,1,0,Potential Threat
56970,443,7987,443,6815,3817,2998,23,143,11,12,allow,1,0,Potential Threat
49465,443,57765,443,11184,6821,4363,27,53,14,13,allow,1,0,Potential Threat
49526,443,23120,443,6032,1049,4983,18,26,9,9,allow,1,0,Potential Threat
55258,443,6481,443,1786,172,1614,7,120,3,4,allow,1,0,Potential Threat
10949,22114,0,0,146,146,0,1,0,1,0,deny,1,1,High Risk
53818,445,0,0,66,66,0,1,0,1,0,drop,0,1,Known Attack
58282,445,0,0,66,66,0,1,0,1,0,drop,0,1,Known Attack
52557,44847,0,0,66,66,0,1,0,1,0,deny,0,1,Known Attack
57334,53,29836,53,204,104,100,2,31,1,1,allow,0,0,Normal
50187,445,0,0,70,70,0,1,0,1,0,drop,0,1,Known Attack
12348,50265,0,0,62,62,0,1,0,1,0,deny,1,1,High Risk
62849,62413,0,0,62,62,0,1,0,1,0,deny,1,1,High Risk
57239,123,0,0,90,90,0,1,0,1,0,deny,0,1,Known Attack
53381,25174,0,0,66,66,0,1,0,1,0,deny,0,1,Known Attack
60795,443,29587,443,3282,1018,2264,10,121,5,5,allow,1,0,Potential Threat
53752,35446,60472,35446,492,306,186,8,15,5,3,allow,1,0,Potential Threat
56112,53,18781,53,199,102,97,2,30,1,1,allow,0,0,Normal
53654,445,0,0,66,66,0,1,0,1,0,drop,0,1,Known Attack
39915,443,44120,443,6922156,117604,6804552,6122,50,1519,4603,allow,1,0,Potential Threat
35036,26296,0,0,159,159,0,1,0,1,0,deny,1,1,High Risk
55727,53,2459,53,195,102,93,2,29,1,1,allow,0,0,Normal
60260,445,0,0,66,66,0,1,0,1,0,drop,0,1,Known Attack
55313,443,62411,443,4005,1162,2843,17,142,8,9,allow,1,0,Potential Threat
61590,445,0,0,70,70,0,1,0,1,0,drop,0,1,Known Attack
0,0,0,0,156,156,0,2,0,2,0,deny,1,1,High Risk
60294,30188,0,0,66,66,0,1,0,1,0,deny,0,1,Known Attack
54019,445,0,0,70,70,0,1,0,1,0,drop,0,1,Known Attack
55743,53,47802,53,165,86,79,2,30,1,1,allow,0,0,Normal
64763,445,0,0,66,66,0,1,0,1,0,drop,0,1,Known Attack
50147,443,13714,443,9915,1833,8082,22,46,13,9,allow,1,0,Potential Threat
51655,80,54219,80,318,192,126,6,37,4,2,allow,0,0,Normal
60410,443,3323,443,3683,1899,1784,20,20,10,10,allow,1,0,Potential Threat
51667,21391,14607,21391,1345,679,666,9,30,5,4,allow,1,0,Potential Threat
53640,28937,28393,28937,70,70,0,1,5,1,0,allow,1,0,Potential Threat
0,0,0,0,600,306,294,6,0,3,3,allow,1,0,Potential Threat
59165,53,3283,53,186,78,108,2,30,1,1,allow,0,0,Normal
56186,53,13478,53,198,102,96,2,31,1,1,allow,0,0,Normal
59377,9319,0,0,62,62,0,1,0,1,0,deny,0,1,Known Attack
51096,63710,0,0,66,66,0,1,0,1,0,deny,1,1,High Risk
63466,443,61707,443,5828,1439,4389,16,75,9,7,allow,1,0,Potential Threat
57723,445,0,0,70,70,0,1,0,1,0,drop,0,1,Known Attack
63999,10552,13138,10552,66,66,0,2,8,2,0,allow,1,0,Potential Threat
53796,53,64571,53,213,78,135,2,30,1,1,allow,1,0,Potential Threat
65514,53,50854,53,170,87,83,2,30,1,1,allow,0,0,Normal
35570,22114,0,0,62,62,0,1,0,1,0,deny,0,1,Known Attack
55890,53,46214,53,711,87,624,2,30,1,1,allow,0,0,Normal
27005,27021,28946,27021,879,126,753,2,31,1,1,allow,1,0,Potential Threat
55262,445,0,0,70,70,0,1,0,1,0,drop,0,1,Known Attack
6927,4660,0,0,100,100,0,1,0,1,0,deny,1,1,High Risk
50518,443,9409,443,7117,1288,5829,22,84,12,10,allow,1,0,Potential Threat
65453,53,50552,53,242,94,148,2,30,1,1,allow,0,0,Normal
10003,64147,0,0,62,62,0,1,0,1,0,deny,1,1,High Risk
53097,25174,0,0,62,62,0,1,0,1,0,deny,0,1,Known Attack
32071,51221,0,0,66,66,0,1,0,1,0,deny,1,1,High Risk
51891,23238,33315,23238,70,70,0,2,8,2,0,allow,1,0,Potential Threat
38799,53,0,0,86,86,0,1,30,1,0,allow,0,0,Normal
5938,19141,0,0,60,60,0,1,91,1,0,allow,1,0,Potential Threat
60406,64337,21894,64337,70,70,0,1,5,1,0,allow,1,0,Potential Threat
55080,53,13972,53,165,86,79,2,29,1,1,allow,0,0,Normal
55280,53,18692,53,258,110,148,2,30,1,1,allow,0,0,Normal
35957,51185,0,0,60,60,0,1,0,1,0,deny,0,1,Known Attack
58151,445,0,0,70,70,0,1,0,1,0,drop,0,1,Known Attack
65066,53,65066,53,240,98,142,2,30,1,1,allow,1,0,Potential Threat
64233,53,2922,53,257,126,131,2,29,1,1,allow,0,0,Normal
11677,44847,0,0,146,146,0,1,0,1,0,deny,1,1,High Risk
65478,443,30120,443,92279,4799,87480,107,16,43,64,allow,1,0,Potential Threat
65514,53,51532,53,177,94,83,2,30,1,1,allow,0,0,Normal
64245,445,0,0,70,70,0,1,0,1,0,drop,0,1,Known Attack
49969,53,27742,53,199,102,97,2,30,1,1,allow,0,0,Normal
54819,443,17467,443,70,70,0,1,4,1,0,allow,0,0,Normal
44503,1433,44503,1433,150,60,90,2,9,1,1,allow,0,0,Normal
28391,80,28391,80,12237,2818,9419,27,26,14,13,allow,1,0,Potential Threat
54231,445,0,0,70,70,0,1,0,1,0,drop,0,1,Known Attack
55043,53,37629,53,167,86,81,2,30,1,1,allow,0,0,Normal
58550,21247,0,0,62,62,0,1,0,1,0,deny,0,1,Known Attack
3541,22114,0,0,62,62,0,1,0,1,0,deny,1,1,High Risk
59838,443,12869,443,5520,3416,2104,27,22,13,14,allow,1,0,Potential Threat
64922,53,2264,53,209,102,107,2,30,1,1,allow,0,0,Normal
10736,35440,0,0,66,66,0,1,0,1,0,deny,1,1,High Risk
51903,26467,0,0,62,62,0,1,0,1,0,deny,0,1,Known Attack
58486,57470,0,0,66,66,0,1,0,1,0,deny,1,1,High Risk
22904,56205,0,0,62,62,0,1,0,1,0,deny,1,1,High Risk
56336,53,34970,53,178,94,84,2,29,1,1,allow,0,0,Normal
53517,445,0,0,66,66,0,1,0,1,0,drop,0,1,Known Attack
56544,445,0,0,70,70,0,1,0,1,0,drop,0,1,Known Attack
55565,443,12183,443,21087,4784,16303,25,146,7,18,allow,1,0,Potential Threat
17750,60780,57502,60780,481,150,331,2,1200,1,1,allow,1,0,Potential Threat
10036,44847,0,0,66,66,0,1,0,1,0,deny,1,1,High Risk
64954,53,8799,53,94,94,0,1,30,1,0,allow,0,0,Normal
55732,53,41995,53,177,94,83,2,29,1,1,allow,0,0,Normal
56356,53,24415,53,184,102,82,2,30,1,1,allow,0,0,Normal
52128,37807,0,0,66,66,0,1,0,1,0,deny,0,1,Known Attack
53342,445,0,0,70,70,0,1,0,1,0,drop,0,1,Known Attack
65390,53,64921,53,387,134,253,2,30,1,1,allow,1,0,Potential Threat
5938,47968,0,0,60,60,0,1,91,1,0,allow,1,0,Potential Threat
48298,2043,0,0,60,60,0,1,0,1,0,deny,0,1,Known Attack
50579,80,47300,80,1827,989,838,13,78,7,6,allow,0,0,Normal
27005,27022,35280,27022,1654,126,1528,4,31,2,2,allow,1,0,Potential Threat
55050,443,45507,443,1480,1029,451,11,151,6,5,allow,1,0,Potential Threat
50783,445,0,0,70,70,0,1,0,1,0,drop,0,1,Known Attack
33289,50584,0,0,62,62,0,1,0,1,0,deny,1,1,High Risk
59756,53,64652,53,571,166,405,2,29,1,1,allow,1,0,Potential Threat
56803,53,10846,53,195,102,93,2,30,1,1,allow,0,0,Normal
61523,37807,0,0,66,66,0,1,0,1,0,deny,0,1,Known Attack
12830,25174,0,0,62,62,0,1,0,1,0,deny,0,1,Known Attack
32381,50584,0,0,66,66,0,1,0,1,0,deny,1,1,High Risk
52992,443,3497,443,97763,8230,89533,131,150,49,82,allow,1,0,Potential Threat
47311,443,49307,443,3398,2096,1302,19,16,10,9,allow,1,0,Potential Threat
51878,443,1905,443,7241,1972,5269,28,68,16,12,allow,1,0,Potential Threat
63467,37807,0,0,62,62,0,1,0,1,0,deny,0,1,Known Attack
56587,53,8172,53,184,94,90,2,31,1,1,allow,0,0,Normal
56800,445,0,0,70,70,0,1,0,1,0,drop,0,1,Known Attack
55131,53,55323,53,244,94,150,2,30,1,1,allow,0,0,Normal
60732,445,0,0,70,70,0,1,0,1,0,drop,0,1,Known Attack
22975,23,0,0,60,60,0,1,0,1,0,deny,0,1,Known Attack
64965,53,42321,53,200,94,106,2,31,1,1,allow,0,0,Normal
57604,53,48752,53,290,86,204,2,29,1,1,allow,0,0,Normal
59732,53,64408,53,384,166,218,2,30,1,1,allow,1,0,Potential Threat
49312,53,27461,53,772,102,670,2,30,1,1,allow,0,0,Normal
55615,13826,16063,13826,70,70,0,2,8,2,0,allow,1,0,Potential Threat
52231,1026,54310,1026,136,136,0,3,14,3,0,allow,0,0,Normal
57669,443,51063,443,12569,8228,4341,28,256,16,12,allow,1,0,Potential Threat
64483,53,39103,53,168,86,82,2,29,1,1,allow,0,0,Normal
37307,443,33957,443,9563,2336,7227,25,15,14,11,allow,1,0,Potential Threat
49343,53,1518,53,209,110,99,2,30,1,1,allow,0,0,Normal
37965,33149,27231,33149,3957,2324,1633,51,1732,29,22,allow,1,0,Potential Threat
45632,443,51632,443,55844,3452,52392,85,255,38,47,allow,1,0,Potential Threat
60398,46776,0,0,74,74,0,1,0,1,0,deny,1,1,High Risk
51365,445,0,0,66,66,0,1,0,1,0,drop,0,1,Known Attack
59969,445,0,0,66,66,0,1,0,1,0,drop,0,1,Known Attack
64051,53,14293,53,430,172,258,6,60,3,3,allow,0,0,Normal
53742,63344,47218,63344,1294,797,497,13,15,7,6,allow,1,0,Potential Threat
45964,2228,0,0,60,60,0,1,0,1,0,deny,0,1,Known Attack
443,10120,443,10120,64,64,0,1,5,1,0,allow,1,0,Potential Threat
58018,443,65091,443,8828,2193,6635,38,99,17,21,allow,1,0,Potential Threat
49487,53,10311,53,183,94,89,2,31,1,1,allow,0,0,Normal
58381,57470,0,0,66,66,0,1,0,1,0,deny,1,1,High Risk
49328,445,0,0,66,66,0,1,0,1,0,drop,0,1,Known Attack
60308,37965,0,0,66,66,0,1,0,1,0,deny,0,1,Known Attack
23900,64147,0,0,62,62,0,1,0,1,0,deny,1,1,High Risk
44822,11848,0,0,148,148,0,1,0,1,0,reset-both,0,1,Known Attack
10380,5223,0,0,148,148,0,1,0,1,0,deny,1,1,High Risk
50709,80,40115,80,1658,1247,411,8,15,5,3,allow,1,0,Potential Threat
62425,445,0,0,66,66,0,1,0,1,0,drop,0,1,Known Attack
51902,55933,35723,55933,316,136,180,6,5,3,3,allow,1,0,Potential Threat
62333,443,8530,443,4019,2219,1800,33,186,17,16,allow,1,0,Potential Threat
55307,53,50101,53,1415,101,1314,4,51,2,2,allow,0,0,Normal
55893,45711,0,0,78,78,0,1,0,1,0,deny,0,1,Known Attack
49619,53,50189,53,789,110,679,2,30,1,1,allow,0,0,Normal
53654,445,0,0,70,70,0,1,0,1,0,drop,0,1,Known Attack
61241,22114,0,0,66,66,0,1,0,1,0,deny,0,1,Known Attack
56144,53,15210,53,177,94,83,2,30,1,1,allow,0,0,Normal
9103,443,27886,443,7876,1511,6365,29,42,14,15,allow,1,0,Potential Threat
50367,443,43632,443,1630,916,714,12,25,7,5,allow,1,0,Potential Threat
50852,80,1179,80,1118864,18787,1100077,1036,132,280,756,allow,1,0,Potential Threat
29080,50265,0,0,62,62,0,1,0,1,0,deny,1,1,High Risk
27785,37965,0,0,66,66,0,1,0,1,0,deny,0,1,Known Attack
0,0,0,0,320,320,0,5,0,5,0,allow,1,0,Potential Threat
58940,443,24448,443,5108,700,4408,15,15,7,8,allow,1,0,Potential Threat
64125,53,18557,53,199,102,97,2,30,1,1,allow,0,0,Normal
52787,443,54390,443,1550,834,716,19,141,10,9,allow,1,0,Potential Threat
62360,445,0,0,66,66,0,1,0,1,0,drop,0,1,Known Attack
7447,53,7447,53,244,98,146,2,32,1,1,allow,1,0,Potential Threat
63469,64147,0,0,62,62,0,1,0,1,0,deny,1,1,High Risk
16358,50584,0,0,146,146,0,1,0,1,0,deny,1,1,High Risk
49298,445,0,0,70,70,0,1,0,1,0,drop,0,1,Known Attack
57314,445,0,0,70,70,0,1,0,1,0,drop,0,1,Known Attack
56707,443,1984,443,5928,1558,4370,22,20,13,9,allow,1,0,Potential Threat
64878,26467,0,0,62,62,0,1,0,1,0,deny,0,1,Known Attack
61738,2767,0,0,62,62,0,1,0,1,0,deny,0,1,Known Attack
35292,8100,23509,8100,78,78,0,1,5,1,0,allow,1,0,Potential Threat
64907,53,16767,53,211,102,109,2,30,1,1,allow,0,0,Normal
58955,80,51848,80,3037,2276,761,12,28,7,5,allow,1,0,Potential Threat
49248,445,0,0,70,70,0,1,0,1,0,drop,0,1,Known Attack
50575,443,8721,443,149414,8612,140802,208,25,107,101,allow,1,0,Potential Threat
49889,53,4477,53,338,110,228,2,30,1,1,allow,0,0,Normal
58638,5900,0,0,62,62,0,1,0,1,0,deny,0,1,Known Attack
59747,445,0,0,70,70,0,1,0,1,0,drop,0,1,Known Attack
63977,54486,15705,54486,66,66,0,1,5,1,0,allow,1,0,Potential Threat
27005,27015,38552,27015,876,126,750,2,31,1,1,allow,1,0,Potential Threat
3478,61463,0,0,822,822,0,1,0,1,0,deny,1,1,High Risk
58402,445,0,0,70,70,0,1,0,1,0,drop,0,1,Known Attack
35408,56205,0,0,66,66,0,1,0,1,0,deny,1,1,High Risk
45725,443,40804,443,8600,4882,3718,44,225,23,21,allow,1,0,Potential Threat
56377,80,8742,80,1633,943,690,15,72,8,7,allow,1,0,Potential Threat
56052,53,22562,53,177,94,83,2,30,1,1,allow,0,0,Normal
53305,50584,0,0,62,62,0,1,0,1,0,deny,0,1,Known Attack
49774,80,42910,80,254,128,126,5,15,3,2,allow,0,0,Normal
60273,445,0,0,70,70,0,1,0,1,0,drop,0,1,Known Attack
27005,27017,10381,27017,600,126,474,2,30,1,1,allow,1,0,Potential Threat
50607,443,33073,443,3947,2271,1676,22,140,13,9,allow,1,0,Potential Threat
9231,3389,0,0,66,66,0,1,0,1,0,deny,0,1,Known Attack
53863,443,62778,443,499,425,74,4,1,3,1,allow,1,0,Potential Threat
50727,27029,42555,27029,269,78,191,2,30,1,1,allow,1,0,Potential Threat
51470,445,0,0,70,70,0,1,0,1,0,drop,0,1,Known Attack
56119,37965,0,0,62,62,0,1,0,1,0,deny,0,1,Known Attack
55387,53,15050,53,195,94,101,2,29,1,1,allow,0,0,Normal
50624,80,47844,80,12701,9788,2913,29,52,16,13,allow,1,0,Potential Threat
57339,50584,0,0,66,66,0,1,0,1,0,deny,0,1,Known Attack
60369,445,0,0,66,66,0,1,0,1,0,drop,0,1,Known Attack
56361,445,0,0,70,70,0,1,0,1,0,drop,0,1,Known Attack
52066,60118,24886,60118,70,70,0,2,8,2,0,allow,1,0,Potential Threat
57640,80,57640,80,64437,2630,61807,64,31,18,46,allow,1,0,Potential Threat
50917,445,0,0,70,70,0,1,0,1,0,drop,0,1,Known Attack
36823,80,35585,80,3335,2735,600,12,30,7,5,allow,1,0,Potential Threat
64756,53,60471,53,195,102,93,2,30,1,1,allow,0,0,Normal
19204,41864,0,0,159,159,0,1,0,1,0,deny,1,1,High Risk
33013,443,50966,443,88895,4807,84088,104,136,37,67,allow,1,0,Potential Threat
59436,22114,0,0,62,62,0,1,0,1,0,deny,0,1,Known Attack
54022,443,20800,443,121935,7839,114096,175,255,82,93,allow,1,0,Potential Threat
52860,9694,0,0,146,146,0,1,0,1,0,deny,0,1,Known Attack
65491,53,33767,53,193,102,91,2,31,1,1,allow,0,0,Normal
60213,80,45825,80,70,70,0,1,4,1,0,allow,0,0,Normal
56367,44847,0,0,66,66,0,1,0,1,0,deny,0,1,Known Attack
2267,53,35610,53,204,118,86,2,30,1,1,allow,1,0,Potential Threat
50621,80,31852,80,11975,10368,1607,27,52,16,11,allow,1,0,Potential Threat
56727,53,4531,53,250,86,164,4,46,2,2,allow,0,0,Normal
56998,80,16426,80,214,140,74,4,35,3,1,allow,0,0,Normal
65292,53,3636,53,195,102,93,2,30,1,1,allow,0,0,Normal
51388,443,47694,443,4209,1570,2639,14,136,7,7,allow,1,0,Potential Threat
27005,28002,21197,28002,918,126,792,2,30,1,1,allow,1,0,Potential Threat
50495,53,56662,53,195,102,93,2,30,1,1,allow,0,0,Normal
41234,443,28858,443,1741,1048,693,15,25,8,7,allow,1,0,Potential Threat
65250,445,0,0,66,66,0,1,0,1,0,drop,0,1,Known Attack
49396,445,0,0,70,70,0,1,0,1,0,drop,0,1,Known Attack
56691,443,48234,443,3986,2645,1341,18,18,10,8,allow,1,0,Potential Threat
59718,445,0,0,70,70,0,1,0,1,0,drop,0,1,Known Attack
60581,53,60581,53,197,76,121,2,30,1,1,allow,0,0,Normal
53923,443,32187,443,499,425,74,4,0,3,1,allow,0,0,Normal
58638,5900,0,0,62,62,0,1,0,1,0,deny,0,1,Known Attack
49211,15576,51582,15576,70,70,0,2,8,2,0,allow,1,0,Potential Threat
2707,37,0,0,60,60,0,1,0,1,0,deny,1,1,High Risk
56740,80,35362,80,1462,703,759,8,17,5,3,allow,0,0,Normal
62663,35253,0,0,66,66,0,1,0,1,0,deny,0,1,Known Attack
63791,445,0,0,70,70,0,1,0,1,0,drop,0,1,Known Attack
54505,445,0,0,66,66,0,1,0,1,0,drop,0,1,Known Attack
50698,443,13372,443,24575,6565,18010,86,275,32,54,allow,1,0,Potential Threat
63065,53,14429,53,448,166,282,2,30,1,1,allow,0,0,Normal
52119,49239,52121,49239,160,70,90,2,5,1,1,allow,1,0,Potential Threat
57578,443,34885,443,13999,3478,10521,33,134,15,18,allow,1,0,Potential Threat
57351,53,35105,53,184,94,90,2,30,1,1,allow,0,0,Normal
52726,445,0,0,66,66,0,1,0,1,0,drop,0,1,Known Attack
64048,53,15990,53,209,110,99,2,30,1,1,allow,0,0,Normal
6881,1707,0,0,146,146,0,1,0,1,0,deny,1,1,High Risk
50116,22,0,0,60,60,0,1,0,1,0,deny,0,1,Known Attack
55382,53,48828,53,199,102,97,2,30,1,1,allow,0,0,Normal
59918,44847,0,0,66,66,0,1,0,1,0,deny,0,1,Known Attack
45144,25174,0,0,62,62,0,1,0,1,0,deny,0,1,Known Attack
49938,445,0,0,70,70,0,1,0,1,0,drop,0,1,Known Attack
57069,443,33403,443,15125,2482,12643,53,38,27,26,allow,1,0,Potential Threat
51455,53733,0,0,66,66,0,1,0,1,0,deny,0,1,Known Attack
9479,443,13111,443,6100,777,5323,17,25,9,8,allow,1,0,Potential Threat
65145,445,0,0,70,70,0,1,0,1,0,drop,0,1,Known Attack
64873,445,0,0,66,66,0,1,0,1,0,drop,0,1,Known Attack
38406,80,52487,80,52105,1615,50490,61,18,24,37,allow,1,0,Potential Threat
56521,443,48766,443,8760,3693,5067,20,90,12,8,allow,1,0,Potential Threat
56500,53,38812,53,164,86,78,2,30,1,1,allow,0,0,Normal
62019,445,0,0,70,70,0,1,0,1,0,drop,0,1,Known Attack
52232,35126,13178,35126,70,70,0,1,5,1,0,allow,1,0,Potential Threat
58811,443,3266,443,10704,7055,3649,29,17,15,14,allow,1,0,Potential Threat
1067,51221,0,0,62,62,0,1,0,1,0,deny,1,1,High Risk
56092,445,0,0,70,70,0,1,0,1,0,drop,0,1,Known Attack
49696,443,49696,443,4871,1623,3248,18,137,8,10,allow,1,0,Potential Threat
56693,1900,0,0,139,139,0,1,0,1,0,deny,0,1,Known Attack
20508,57470,0,0,62,62,0,1,0,1,0,deny,1,1,High Risk
55459,50584,0,0,66,66,0,1,0,1,0,deny,0,1,Known Attack
50479,443,28335,443,1654,1011,643,16,82,9,7,allow,1,0,Potential Threat
40394,67,0,0,60,60,0,1,0,1,0,deny,0,1,Known Attack
29177,44847,0,0,66,66,0,1,0,1,0,deny,1,1,High Risk
49838,445,0,0,70,70,0,1,0,1,0,drop,0,1,Known Attack
52830,22114,0,0,62,62,0,1,0,1,0,deny,0,1,Known Attack
65403,445,0,0,66,66,0,1,0,1,0,drop,0,1,Known Attack
65470,443,40363,443,372361,11310,361051,385,16,136,249,allow,1,0,Potential Threat
48706,23393,0,0,60,60,0,1,0,1,0,deny,0,1,Known Attack
49949,53,12218,53,193,102,91,2,29,1,1,allow,0,0,Normal
50063,35776,0,0,148,148,0,1,0,1,0,deny,1,1,High Risk
51822,12637,54729,12637,136,136,0,3,14,3,0,allow,1,0,Potential Threat
49217,53,50933,53,282,93,189,4,45,2,2,allow,0,0,Normal
63675,445,0,0,66,66,0,1,0,1,0,drop,0,1,Known Attack
56462,37965,0,0,66,66,0,1,0,1,0,deny,0,1,Known Attack
49482,22,0,0,60,60,0,1,0,1,0,deny,0,1,Known Attack
61804,51505,0,0,66,66,0,1,0,1,0,deny,1,1,High Risk
65333,445,0,0,70,70,0,1,0,1,0,drop,0,1,Known Attack
8889,26330,0,0,60,60,0,1,0,1,0,deny,1,1,High Risk
9132,80,49560,80,318,192,126,6,30,4,2,allow,1,0,Potential Threat
50036,445,0,0,70,70,0,1,0,1,0,drop,0,1,Known Attack
60050,445,0,0,66,66,0,1,0,1,0,drop,0,1,Known Attack
57734,445,0,0,66,66,0,1,0,1,0,drop,0,1,Known Attack
59486,80,17490,80,882,527,355,10,255,6,4,allow,1,0,Potential Threat
64914,53,32177,53,168,86,82,2,31,1,1,allow,0,0,Normal
50116,22,0,0,60,60,0,1,0,1,0,deny,0,1,Known Attack
56186,53,3994,53,198,102,96,2,29,1,1,allow,0,0,Normal
56490,445,0,0,70,70,0,1,0,1,0,drop,0,1,Known Attack
30559,64147,0,0,62,62,0,1,0,1,0,deny,1,1,High Risk
64493,53,17644,53,280,97,183,4,60,2,2,allow,0,0,Normal
58638,5900,0,0,62,62,0,1,0,1,0,deny,0,1,Known Attack
12909,47807,0,0,148,148,0,1,0,1,0,deny,1,1,High Risk
55975,53,28209,53,195,102,93,2,30,1,1,allow,0,0,Normal
50007,80,25590,80,2089,1161,928,10,86,6,4,allow,0,0,Normal
55335,445,0,0,70,70,0,1,0,1,0,drop,0,1,Known Attack
41764,53,7946,53,168,78,90,2,29,1,1,allow,0,0,Normal
55035,445,0,0,66,66,0,1,0,1,0,drop,0,1,Known Attack
36765,443,20693,443,27557,20627,6930,89,5581,44,45,allow,1,0,Potential Threat
55912,53,46949,53,184,94,90,2,30,1,1,allow,0,0,Normal
49236,53,40534,53,723,102,621,2,30,1,1,allow,0,0,Normal
56794,46824,0,0,66,66,0,1,0,1,0,deny,0,1,Known Attack
50853,50584,0,0,66,66,0,1,0,1,0,deny,0,1,Known Attack
63091,443,18908,443,382,164,218,2,30,1,1,allow,0,0,Normal
57202,53,47171,53,184,94,90,2,30,1,1,allow,0,0,Normal
55916,445,0,0,70,70,0,1,0,1,0,drop,0,1,Known Attack
49477,53,44035,53,168,78,90,2,30,1,1,allow,0,0,Normal
50174,445,0,0,66,66,0,1,0,1,0,drop,0,1,Known Attack
58812,443,22392,443,5167,700,4467,16,15,7,9,allow,1,0,Potential Threat
59223,17500,0,0,66,66,0,1,0,1,0,deny,0,1,Known Attack
56228,53,46587,53,711,87,624,2,30,1,1,allow,0,0,Normal
50516,53,48548,53,772,100,672,2,31,1,1,allow,0,0,Normal
58344,445,0,0,66,66,0,1,0,1,0,drop,0,1,Known Attack
63050,445,0,0,66,66,0,1,0,1,0,drop,0,1,Known Attack
42430,443,21880,443,3927,1425,2502,18,121,8,10,allow,1,0,Potential Threat
43600,443,57317,443,172272,14401,157871,254,418,100,154,allow,1,0,Potential Threat
58099,445,0,0,66,66,0,1,0,1,0,drop,0,1,Known Attack
56231,53,14277,53,268,94,174,2,30,1,1,allow,0,0,Normal
55872,123,4281,123,184,94,90,2,30,1,1,allow,0,0,Normal
64303,443,22839,443,3205,781,2424,17,135,8,9,allow,1,0,Potential Threat
59840,445,0,0,66,66,0,1,0,1,0,drop,0,1,Known Attack
40603,443,49368,443,9462,6402,3060,32,394,11,21,allow,1,0,Potential Threat
59657,445,0,0,70,70,0,1,0,1,0,drop,0,1,Known Attack
64009,80,25096,80,314,192,122,6,15,4,2,allow,0,0,Normal
51882,15733,38796,15733,70,70,0,2,8,2,0,allow,1,0,Potential Threat
59276,443,40586,443,16232,3319,12913,23,125,9,14,allow,1,0,Potential Threat
61530,445,0,0,70,70,0,1,0,1,0,drop,0,1,Known Attack
12011,443,12011,443,6981,948,6033,17,27,10,7,allow,1,0,Potential Threat
48012,443,51500,443,1429,1295,134,10,29,8,2,allow,1,0,Potential Threat
57566,445,0,0,70,70,0,1,0,1,0,drop,0,1,Known Attack
49498,443,36900,443,267319,11446,255873,336,192,117,219,allow,1,0,Potential Threat
56709,443,54114,443,8007,1987,6020,20,15,11,9,allow,1,0,Potential Threat
54183,445,0,0,70,70,0,1,0,1,0,drop,0,1,Known Attack
62806,445,0,0,70,70,0,1,0,1,0,drop,0,1,Known Attack
51117,445,0,0,66,66,0,1,0,1,0,drop,0,1,Known Attack
52375,80,50220,80,234,234,0,4,12,4,0,allow,0,0,Normal
53999,445,0,0,70,70,0,1,0,1,0,drop,0,1,Known Attack
52013,35185,29346,35185,66,66,0,1,5,1,0,allow,1,0,Potential Threat
49686,443,60868,443,8475,1661,6814,32,76,14,18,allow,1,0,Potential Threat
62115,445,0,0,70,70,0,1,0,1,0,drop,0,1,Known Attack
53239,445,0,0,66,66,0,1,0,1,0,drop,0,1,Known Attack
57123,445,0,0,70,70,0,1,0,1,0,drop,0,1,Known Attack
45964,3111,0,0,60,60,0,1,0,1,0,deny,0,1,Known Attack
49418,57470,0,0,62,62,0,1,0,1,0,deny,0,1,Known Attack
993,49276,0,0,129,129,0,1,0,1,0,deny,1,1,High Risk
59791,443,43640,443,6603,1085,5518,23,28,11,12,allow,1,0,Potential Threat
46750,80,46750,80,27124,1455,25669,41,15,20,21,allow,1,0,Potential Threat
38100,53,30457,53,168,78,90,2,30,1,1,allow,0,0,Normal
52092,443,18467,443,13078,7055,6023,114,162,59,55,allow,1,0,Potential Threat
53450,445,0,0,70,70,0,1,0,1,0,drop,0,1,Known Attack
61273,25174,0,0,146,146,0,1,0,1,0,deny,1,1,High Risk
56949,443,2703,443,5601,1203,4398,14,59,9,5,allow,1,0,Potential Threat
61515,445,0,0,70,70,0,1,0,1,0,drop,0,1,Known Attack
60646,445,0,0,70,70,0,1,0,1,0,drop,0,1,Known Attack
6881,6889,64062,6889,228,118,110,2,1199,1,1,allow,1,0,Potential Threat
59454,445,0,0,70,70,0,1,0,1,0,drop,0,1,Known Attack
58366,53,25101,53,167,78,89,2,30,1,1,allow,0,0,Normal
49415,443,33045,443,29561,4857,24704,44,44,15,29,allow,1,0,Potential Threat
8283,45858,63554,45858,130,70,60,2,30,1,1,allow,1,0,Potential Threat
45461,25174,0,0,62,62,0,1,0,1,0,deny,0,1,Known Attack
16387,35308,0,0,60,60,0,1,0,1,0,deny,1,1,High Risk
60038,445,0,0,70,70,0,1,0,1,0,drop,0,1,Known Attack
55276,53,62860,53,177,94,83,2,30,1,1,allow,1,0,Potential Threat
58771,53,46484,53,168,78,90,2,30,1,1,allow,0,0,Normal
58998,445,0,0,66,66,0,1,0,1,0,drop,0,1,Known Attack
54538,445,0,0,70,70,0,1,0,1,0,drop,0,1,Known Attack
55997,53,30863,53,716,95,621,2,30,1,1,allow,0,0,Normal
20650,26467,0,0,62,62,0,1,0,1,0,deny,0,1,Known Attack
49568,445,0,0,66,66,0,1,0,1,0,drop,0,1,Known Attack
51867,48059,47188,48059,160,70,90,2,5,1,1,allow,1,0,Potential Threat
5774,37965,0,0,66,66,0,1,0,1,0,deny,1,1,High Risk
3478,61463,0,0,1053,1053,0,1,0,1,0,deny,1,1,High Risk
49361,53,49782,53,166,86,80,2,30,1,1,allow,0,0,Normal
49355,53,16925,53,186,95,91,2,0,1,1,allow,0,0,Normal
55132,445,0,0,70,70,0,1,0,1,0,drop,0,1,Known Attack
64324,53,5232,53,344,105,239,4,33,2,2,allow,0,0,Normal
56825,445,0,0,70,70,0,1,0,1,0,drop,0,1,Known Attack
51675,8245,24099,8245,346,214,132,3,29,1,2,allow,1,0,Potential Threat
49411,445,0,0,66,66,0,1,0,1,0,drop,0,1,Known Attack
49418,27015,7927,27015,295,78,217,2,31,1,1,allow,1,0,Potential Threat
5588,5588,0,0,3562,1936,1626,48,195,24,24,allow,1,0,Potential Threat
52994,443,57845,443,10694,4129,6565,41,111,20,21,allow,1,0,Potential Threat
59153,35440,0,0,66,66,0,1,0,1,0,deny,0,1,Known Attack
39446,443,32219,443,1647482,62713,1584769,1898,219,744,1154,allow,1,0,Potential Threat
59037,28370,0,0,62,62,0,1,0,1,0,deny,0,1,Known Attack
57689,443,27070,443,10855,1786,9069,32,180,15,17,allow,1,0,Potential Threat
58869,445,0,0,66,66,0,1,0,1,0,drop,0,1,Known Attack
49850,443,7132,443,7371,1564,5807,18,89,9,9,allow,1,0,Potential Threat
62194,50584,0,0,62,62,0,1,0,1,0,deny,1,1,High Risk
39818,443,44736,443,2211,1181,1030,23,40,11,12,allow,1,0,Potential Threat
64225,445,0,0,70,70,0,1,0,1,0,drop,0,1,Known Attack
65245,53,10432,53,479,98,381,4,57,2,2,allow,0,0,Normal
52021,445,0,0,66,66,0,1,0,1,0,drop,0,1,Known Attack
58028,445,0,0,70,70,0,1,0,1,0,drop,0,1,Known Attack
50993,445,0,0,66,66,0,1,0,1,0,drop,0,1,Known Attack
41786,443,30860,443,174542,9281,165261,227,78,104,123,allow,1,0,Potential Threat
51764,445,0,0,66,66,0,1,0,1,0,drop,0,1,Known Attack
52780,53,38802,53,338,94,244,2,30,1,1,allow,0,0,Normal
59664,445,0,0,66,66,0,1,0,1,0,drop,0,1,Known Attack
55219,443,55870,443,6528,1918,4610,23,45,13,10,allow,1,0,Potential Threat
50990,445,0,0,66,66,0,1,0,1,0,drop,0,1,Known Attack
56119,37965,0,0,62,62,0,1,0,1,0,deny,0,1,Known Attack
56624,53,36589,53,177,94,83,2,31,1,1,allow,0,0,Normal
51608,445,0,0,66,66,0,1,0,1,0,drop,0,1,Known Attack
51502,443,63032,443,6559,2158,4401,30,17,16,14,allow,1,0,Potential Threat
38914,443,38914,443,4644,1737,2907,19,28,11,8,allow,1,0,Potential Threat
49718,53,50641,53,184,94,90,2,30,1,1,allow,0,0,Normal
57590,53,59223,53,260,86,174,2,30,1,1,allow,0,0,Normal
54913,445,0,0,70,70,0,1,0,1,0,drop,0,1,Known Attack
54742,50584,0,0,66,66,0,1,0,1,0,deny,0,1,Known Attack
62099,445,0,0,70,70,0,1,0,1,0,drop,0,1,Known Attack
55527,80,13344,80,20513,1960,18553,39,21,18,21,allow,1,0,Potential Threat
51674,51505,0,0,66,66,0,1,0,1,0,deny,0,1,Known Attack
57397,53,42252,53,735,88,647,2,31,1,1,allow,0,0,Normal
23415,11392,0,0,62,62,0,1,0,1,0,deny,0,1,Known Attack
61740,445,0,0,70,70,0,1,0,1,0,drop,0,1,Known Attack
45554,443,45554,443,4617,1710,2907,19,26,11,8,allow,1,0,Potential Threat
45964,2225,0,0,60,60,0,1,0,1,0,deny,0,1,Known Attack
50377,53,24974,53,753,94,659,2,30,1,1,allow,0,0,Normal
58131,15503,0,0,146,146,0,1,0,1,0,deny,0,1,Known Attack
59763,443,40613,443,304,86,218,2,30,1,1,allow,0,0,Normal
9687,57470,0,0,78,78,0,1,0,1,0,deny,1,1,High Risk
40216,50265,0,0,62,62,0,1,0,1,0,deny,0,1,Known Attack
65343,53,9995,53,197,102,95,2,30,1,1,allow,0,0,Normal
49848,443,28970,443,33314,1722,31592,40,88,14,26,allow,1,0,Potential Threat
49175,53,45258,53,193,102,91,2,31,1,1,allow,0,0,Normal
56580,443,55118,443,2343,1296,1047,17,196,10,7,allow,1,0,Potential Threat
27005,32038,39933,32038,868,126,742,2,30,1,1,allow,1,0,Potential Threat
52790,445,0,0,70,70,0,1,0,1,0,drop,0,1,Known Attack
57280,445,0,0,66,66,0,1,0,1,0,drop,0,1,Known Attack
59257,445,0,0,66,66,0,1,0,1,0,drop,0,1,Known Attack
56956,443,35896,443,4359,924,3435,15,59,9,6,allow,0,0,Normal
59732,443,44274,443,34866,3347,31519,55,54,22,33,allow,1,0,Potential Threat
49201,53,51989,53,200,102,98,2,30,1,1,allow,0,0,Normal
57470,1500,26703,1500,528,528,0,9,1200,9,0,allow,1,0,Potential Threat
49423,445,0,0,70,70,0,1,0,1,0,drop,0,1,Known Attack
58835,443,42835,443,5166,700,4466,16,15,7,9,allow,1,0,Potential Threat
62424,445,0,0,66,66,0,1,0,1,0,drop,0,1,Known Attack
53905,50130,9021,50130,552,306,246,9,16,5,4,allow,1,0,Potential Threat
9283,57470,0,0,66,66,0,1,0,1,0,deny,1,1,High Risk
56390,445,0,0,70,70,0,1,0,1,0,drop,0,1,Known Attack
64358,445,0,0,70,70,0,1,0,1,0,drop,0,1,Known Attack
51782,445,0,0,70,70,0,1,0,1,0,drop,0,1,Known Attack
49341,443,40823,443,484,210,274,8,135,4,4,allow,1,0,Potential Threat
53719,49306,15851,49306,70,70,0,1,5,1,0,allow,1,0,Potential Threat
58961,80,48953,80,5412,4758,654,14,14,8,6,allow,1,0,Potential Threat
65340,53,24167,53,313,110,203,4,34,2,2,allow,0,0,Normal
18754,30188,0,0,66,66,0,1,0,1,0,deny,1,1,High Risk
64797,53,45567,53,216,102,114,2,30,1,1,allow,0,0,Normal
54530,46776,0,0,66,66,0,1,0,1,0,deny,0,1,Known Attack
50669,80,58976,80,1485,806,679,13,15,7,6,allow,1,0,Potential Threat
55213,445,0,0,66,66,0,1,0,1,0,drop,0,1,Known Attack
56026,53,28063,53,183,94,89,2,30,1,1,allow,0,0,Normal
49748,445,0,0,70,70,0,1,0,1,0,drop,0,1,Known Attack
54174,445,0,0,70,70,0,1,0,1,0,drop,0,1,Known Attack
22587,30188,0,0,66,66,0,1,0,1,0,deny,0,1,Known Attack
54553,53,37407,53,102,102,0,1,30,1,0,allow,0,0,Normal
49558,53,30601,53,184,94,90,2,30,1,1,allow,0,0,Normal
54924,443,20791,443,53816,22991,30825,139,306,71,68,allow,1,0,Potential Threat
52291,445,0,0,70,70,0,1,0,1,0,drop,0,1,Known Attack
38149,53,54452,53,199,94,105,2,31,1,1,allow,0,0,Normal
64576,53,33878,53,188,96,92,2,31,1,1,allow,0,0,Normal
56826,31310,8679,31310,70,70,0,1,5,1,0,allow,1,0,Potential Threat
27005,27015,3826,27015,876,126,750,2,31,1,1,allow,1,0,Potential Threat
2267,53,56692,53,204,118,86,2,30,1,1,allow,1,0,Potential Threat
27005,32063,51455,32063,889,126,763,3,31,2,1,allow,1,0,Potential Threat
57991,53,26816,53,220,78,142,2,30,1,1,allow,0,0,Normal
52153,80,26645,80,366,240,126,7,32,5,2,allow,0,0,Normal
55259,445,0,0,70,70,0,1,0,1,0,drop,0,1,Known Attack
52519,44847,0,0,66,66,0,1,0,1,0,deny,0,1,Known Attack
55655,53,10525,53,304,110,194,4,34,2,2,allow,0,0,Normal
64631,53,29007,53,193,102,91,2,29,1,1,allow,0,0,Normal
50438,53,44786,53,296,101,195,4,31,2,2,allow,0,0,Normal
55923,53,7980,53,177,94,83,2,30,1,1,allow,0,0,Normal
56760,48386,9485,48386,268,70,198,4,19,1,3,allow,1,0,Potential Threat
49369,53,3787,53,182,93,89,2,31,1,1,allow,0,0,Normal
57140,445,0,0,70,70,0,1,0,1,0,drop,0,1,Known Attack
63536,445,0,0,66,66,0,1,0,1,0,drop,0,1,Known Attack
58638,5900,0,0,62,62,0,1,0,1,0,deny,0,1,Known Attack
60381,443,9520,443,24271,17315,6956,53,107,34,19,allow,1,0,Potential Threat
52973,443,33521,443,9294,2728,6566,43,113,22,21,allow,1,0,Potential Threat
56500,53,54568,53,164,86,78,2,30,1,1,allow,0,0,Normal
60788,40010,33720,40010,316,136,180,6,5,3,3,allow,1,0,Potential Threat
65507,53,7082,53,229,102,127,2,30,1,1,allow,0,0,Normal
43104,26467,0,0,62,62,0,1,0,1,0,deny,0,1,Known Attack
65510,443,47071,443,92101,4799,87302,107,16,43,64,allow,1,0,Potential Threat
49917,443,38114,443,7645,2967,4678,23,15,13,10,allow,1,0,Potential Threat
63027,445,0,0,66,66,0,1,0,1,0,drop,0,1,Known Attack
53928,445,0,0,70,70,0,1,0,1,0,drop,0,1,Known Attack
56406,53,47759,53,749,89,660,2,30,1,1,allow,0,0,Normal
59021,445,0,0,70,70,0,1,0,1,0,drop,0,1,Known Attack
32071,51221,0,0,62,62,0,1,0,1,0,deny,1,1,High Risk
0,0,0,0,102,102,0,1,0,1,0,deny,1,1,High Risk
56275,445,0,0,66,66,0,1,0,1,0,drop,0,1,Known Attack
60097,22114,0,0,62,62,0,1,0,1,0,deny,0,1,Known Attack
49383,53,44225,53,94,94,0,1,30,1,0,allow,0,0,Normal
65111,53,60409,53,198,94,104,2,29,1,1,allow,0,0,Normal
1620,53567,0,0,62,62,0,1,0,1,0,deny,1,1,High Risk
65513,53,57723,53,195,102,93,2,29,1,1,allow,0,0,Normal
49160,16919,59131,16919,868,150,718,4,1200,2,2,allow,1,0,Potential Threat
51222,35440,0,0,62,62,0,1,0,1,0,deny,0,1,Known Attack
60742,20010,30698,20010,70,70,0,1,5,1,0,allow,1,0,Potential Threat
39537,8245,49028,8245,280,214,66,2,30,1,1,allow,1,0,Potential Threat
49325,41615,0,0,157,157,0,1,0,1,0,deny,1,1,High Risk
49808,445,0,0,70,70,0,1,0,1,0,drop,0,1,Known Attack
53079,443,11081,443,8233,5537,2696,40,84,21,19,allow,1,0,Potential Threat
64460,53,62568,53,192,98,94,2,31,1,1,allow,1,0,Potential Threat
45538,5228,21561,5228,2372,1452,920,16,3600,8,8,allow,1,0,Potential Threat
59140,445,0,0,66,66,0,1,0,1,0,drop,0,1,Known Attack
62766,443,11804,443,3370,1226,2144,13,135,6,7,allow,1,0,Potential Threat
5223,13602,0,0,66,66,0,1,0,1,0,deny,1,1,High Risk
56438,53,21882,53,312,94,218,2,30,1,1,allow,0,0,Normal
57115,53,57910,53,788,108,680,2,30,1,1,allow,0,0,Normal
59459,37807,0,0,66,66,0,1,0,1,0,deny,0,1,Known Attack
39540,37965,0,0,66,66,0,1,0,1,0,deny,0,1,Known Attack
18086,25174,0,0,62,62,0,1,0,1,0,deny,0,1,Known Attack
18653,42707,0,0,66,66,0,1,0,1,0,deny,1,1,High Risk
63763,17368,8449,17368,66,66,0,1,5,1,0,allow,1,0,Potential Threat
9334,443,58101,443,674,128,546,12,46,3,9,allow,1,0,Potential Threat
58995,443,49054,443,8826,2860,5966,21,9,10,11,allow,1,0,Potential Threat
63808,40608,41042,40608,504,382,122,8,15,6,2,allow,1,0,Potential Threat
58755,445,0,0,66,66,0,1,0,1,0,drop,0,1,Known Attack
49160,51413,10192,51413,800,150,650,4,1200,2,2,allow,1,0,Potential Threat
63598,445,0,0,66,66,0,1,0,1,0,drop,0,1,Known Attack
40799,443,51690,443,21024,14637,6387,46,271,26,20,allow,1,0,Potential Threat
49866,445,0,0,70,70,0,1,0,1,0,drop,0,1,Known Attack
63669,445,0,0,70,70,0,1,0,1,0,drop,0,1,Known Attack
55027,53,18379,53,168,86,82,2,31,1,1,allow,0,0,Normal
57470,1,59410,1,132,132,0,3,1199,3,0,allow,1,0,Potential Threat
56380,445,0,0,70,70,0,1,0,1,0,drop,0,1,Known Attack
49699,53,49094,53,209,110,99,2,30,1,1,allow,0,0,Normal
52295,53,54282,53,322,102,220,2,30,1,1,allow,0,0,Normal
54613,53,0,0,86,86,0,1,30,1,0,allow,0,0,Normal
49418,27444,10177,27444,258,78,180,2,30,1,1,allow,1,0,Potential Threat
50338,443,61638,443,6441,1651,4790,22,53,12,10,allow,1,0,Potential Threat
49359,53,8497,53,216,110,106,2,30,1,1,allow,0,0,Normal
49418,27026,25116,27026,71,71,0,1,30,1,0,allow,1,0,Potential Threat
5881,53,5881,53,231,90,141,2,31,1,1,allow,1,0,Potential Threat
58215,443,23391,443,7337,1630,5707,23,256,12,11,allow,1,0,Potential Threat
44879,443,44879,443,7123,1020,6103,19,151,11,8,allow,1,0,Potential Threat
57979,443,3610,443,7970957,82522,7888435,6370,179,1027,5343,allow,1,0,Potential Threat
0,0,0,0,156,156,0,2,0,2,0,deny,1,1,High Risk
53319,443,19200,443,2246,1396,850,15,117,9,6,allow,1,0,Potential Threat
61830,445,0,0,70,70,0,1,0,1,0,drop,0,1,Known Attack
57555,35440,0,0,62,62,0,1,0,1,0,deny,0,1,Known Attack
55216,443,23383,443,8058,5498,2560,20,120,11,9,allow,1,0,Potential Threat
33806,443,17179,443,37541,4945,32596,69,127,31,38,allow,1,0,Potential Threat
63848,443,19599,443,3182,1568,1614,8,120,4,4,allow,1,0,Potential Threat
52217,80,27362,80,1074,565,509,11,16,6,5,allow,0,0,Normal
34331,443,8773,443,1717,1153,564,13,26,7,6,allow,1,0,Potential Threat
42298,40040,5414,40040,140,78,62,2,30,1,1,allow,1,0,Potential Threat
55363,445,0,0,70,70,0,1,0,1,0,drop,0,1,Known Attack
57470,64738,24802,64738,1577,594,983,20,1582,10,10,allow,1,0,Potential Threat
57470,53377,9260,53377,594,594,0,10,1199,10,0,allow,1,0,Potential Threat
64200,53,27722,53,193,102,91,2,30,1,1,allow,0,0,Normal
56854,445,0,0,70,70,0,1,0,1,0,drop,0,1,Known Attack
42587,53,63043,53,199,94,105,2,30,1,1,allow,1,0,Potential Threat
49914,443,44270,443,5895,728,5167,16,27,8,8,allow,1,0,Potential Threat
45019,53,52189,53,168,78,90,2,30,1,1,allow,0,0,Normal
5859,11392,0,0,62,62,0,1,0,1,0,deny,1,1,High Risk
39820,443,46872,443,2190,1249,941,23,26,12,11,allow,1,0,Potential Threat
64472,53,42723,53,183,94,89,2,30,1,1,allow,0,0,Normal
50222,445,0,0,66,66,0,1,0,1,0,drop,0,1,Known Attack
56694,443,1542,443,8058,2038,6020,20,15,11,9,allow,1,0,Potential Threat
57275,53,56267,53,177,94,83,2,30,1,1,allow,0,0,Normal
51514,443,43958,443,2188,1329,859,23,19,13,10,allow,1,0,Potential Threat
49322,445,0,0,70,70,0,1,0,1,0,drop,0,1,Known Attack
54373,26467,0,0,62,62,0,1,0,1,0,deny,0,1,Known Attack
53625,39198,33493,39198,552,306,246,9,16,5,4,allow,1,0,Potential Threat
54631,443,8589,443,130,70,60,3,5,2,1,allow,0,0,Normal
64583,443,48873,443,9150,2109,7041,27,32,15,12,allow,1,0,Potential Threat
56262,53,24636,53,177,94,83,2,30,1,1,allow,0,0,Normal
58944,443,12374,443,5166,700,4466,16,15,7,9,allow,1,0,Potential Threat
55675,53,34777,53,287,91,196,4,60,2,2,allow,0,0,Normal
54436,445,0,0,70,70,0,1,0,1,0,drop,0,1,Known Attack
37965,15509,12475,15509,481,150,331,2,1199,1,1,allow,1,0,Potential Threat
63037,445,0,0,66,66,0,1,0,1,0,drop,0,1,Known Attack
58558,445,0,0,70,70,0,1,0,1,0,drop,0,1,Known Attack
63686,445,0,0,70,70,0,1,0,1,0,drop,0,1,Known Attack
49760,53,59419,53,183,94,89,2,30,1,1,allow,0,0,Normal
19983,18242,0,0,146,146,0,1,0,1,0,reset-both,1,1,High Risk
60141,30188,0,0,66,66,0,1,0,1,0,deny,0,1,Known Attack
53602,445,0,0,70,70,0,1,0,1,0,drop,0,1,Known Attack
58664,53,14984,53,192,90,102,2,30,1,1,allow,0,0,Normal
65443,53,19494,53,215,102,113,2,30,1,1,allow,0,0,Normal
60861,445,0,0,66,66,0,1,0,1,0,drop,0,1,Known Attack
55450,53,40761,53,193,102,91,2,29,1,1,allow,0,0,Normal
24040,22114,0,0,62,62,0,1,0,1,0,deny,0,1,Known Attack
52828,51221,0,0,66,66,0,1,0,1,0,deny,0,1,Known Attack
52136,42939,1692,42939,70,70,0,1,5,1,0,allow,1,0,Potential Threat
64546,57470,0,0,66,66,0,1,0,1,0,deny,1,1,High Risk
43346,443,33396,443,3691281,56325,3634956,3201,138,570,2631,allow,1,0,Potential Threat
46176,53,12412,53,168,78,90,2,30,1,1,allow,0,0,Normal
51221,15886,64989,15886,481,150,331,2,1200,1,1,allow,1,0,Potential Threat
51076,25174,0,0,146,146,0,1,0,1,0,deny,1,1,High Risk
25436,53,25436,53,235,90,145,2,32,1,1,allow,0,0,Normal
51500,443,60787,443,451,259,192,5,23,2,3,allow,0,0,Normal
14903,10387,0,0,159,159,0,1,0,1,0,deny,1,1,High Risk
55907,53,49379,53,184,94,90,2,30,1,1,allow,0,0,Normal
49759,53,16085,53,216,110,106,2,29,1,1,allow,0,0,Normal
26900,27017,1315,27017,422,164,258,6,30,3,3,allow,1,0,Potential Threat
60334,443,17024,443,7506,4789,2717,28,130,16,12,allow,1,0,Potential Threat
50720,445,0,0,66,66,0,1,0,1,0,drop,0,1,Known Attack
27005,27015,61856,27015,888,126,762,2,30,1,1,allow,1,0,Potential Threat
55300,53,49492,53,308,94,214,2,30,1,1,allow,0,0,Normal
53527,45626,48951,45626,70,70,0,2,7,2,0,allow,1,0,Potential Threat
40033,80,40033,80,424,198,226,7,142,4,3,allow,1,0,Potential Threat
53539,44847,0,0,66,66,0,1,0,1,0,deny,0,1,Known Attack
51866,22114,0,0,66,66,0,1,0,1,0,deny,0,1,Known Attack
63979,49547,9568,49547,312,132,180,6,6,3,3,allow,1,0,Potential Threat
50100,445,0,0,70,70,0,1,0,1,0,drop,0,1,Known Attack
27621,50584,0,0,62,62,0,1,0,1,0,deny,1,1,High Risk
56447,53,59083,53,758,96,662,2,31,1,1,allow,0,0,Normal
61671,445,0,0,70,70,0,1,0,1,0,drop,0,1,Known Attack
54995,445,0,0,70,70,0,1,0,1,0,drop,0,1,Known Attack
58368,53,61007,53,167,78,89,2,30,1,1,allow,0,0,Normal
60854,42873,0,0,66,66,0,1,0,1,0,deny,0,1,Known Attack
58957,80,23483,80,13330975,109486,13221489,10177,23,1394,8783,allow,1,0,Potential Threat
54352,443,38196,443,12594,5098,7496,32,34,17,15,allow,1,0,Potential Threat
53717,443,51020,443,499,425,74,4,0,3,1,allow,0,0,Normal
43129,15503,0,0,62,62,0,1,0,1,0,deny,0,1,Known Attack
58528,443,58528,443,4672,1765,2907,19,29,11,8,allow,1,0,Potential Threat
49826,445,0,0,66,66,0,1,0,1,0,drop,0,1,Known Attack
57470,46772,63151,46772,528,528,0,9,1201,9,0,allow,1,0,Potential Threat
64870,65473,0,0,148,148,0,1,0,1,0,deny,1,1,High Risk
59829,445,0,0,70,70,0,1,0,1,0,drop,0,1,Known Attack
57917,6789,34924,6789,8164,1336,6828,34,18,18,16,allow,1,0,Potential Threat
57023,53,46258,53,179,94,85,2,29,1,1,allow,0,0,Normal
38095,443,38095,443,247172,58810,188362,325,90,174,151,allow,1,0,Potential Threat
56142,53,42662,53,194,102,92,2,31,1,1,allow,0,0,Normal
55045,53,38947,53,747,92,655,2,30,1,1,allow,0,0,Normal
58687,11392,0,0,66,66,0,1,0,1,0,deny,0,1,Known Attack
55879,53,9895,53,184,94,90,2,29,1,1,allow,0,0,Normal
50388,8080,50388,8080,4417,2499,1918,18,56,10,8,allow,1,0,Potential Threat
57275,53,57643,53,199,102,97,2,30,1,1,allow,0,0,Normal
52164,42271,32377,42271,70,70,0,1,5,1,0,allow,1,0,Potential Threat
55539,57470,0,0,66,66,0,1,0,1,0,deny,0,1,Known Attack
49743,53,1715,53,210,94,116,2,30,1,1,allow,0,0,Normal
54336,443,1774,443,172701,6397,166304,202,246,72,130,allow,1,0,Potential Threat
59068,49813,0,0,74,74,0,1,0,1,0,deny,1,1,High Risk
49232,53,52451,53,242,78,164,2,29,1,1,allow,0,0,Normal
50951,53,0,0,82,82,0,1,30,1,0,allow,0,0,Normal
56834,53,25406,53,178,94,84,2,30,1,1,allow,0,0,Normal
50,64147,0,0,66,66,0,1,0,1,0,deny,1,1,High Risk
53831,443,39132,443,499,425,74,4,0,3,1,allow,0,0,Normal
65247,445,0,0,70,70,0,1,0,1,0,drop,0,1,Known Attack
64520,445,0,0,70,70,0,1,0,1,0,drop,0,1,Known Attack
12677,53,12677,53,234,93,141,2,30,1,1,allow,0,0,Normal
50135,53,57045,53,774,101,673,2,30,1,1,allow,0,0,Normal
34658,80,20483,80,6094,954,5140,15,3601,8,7,allow,1,0,Potential Threat
56226,53,49033,53,200,102,98,2,30,1,1,allow,0,0,Normal
65344,46824,0,0,66,66,0,1,0,1,0,deny,1,1,High Risk
61887,443,28383,443,81136,7785,73351,109,131,40,69,allow,1,0,Potential Threat
34720,443,52073,443,6453,2318,4135,32,84,16,16,allow,1,0,Potential Threat
56984,53,53152,53,199,102,97,2,29,1,1,allow,0,0,Normal
51489,445,0,0,70,70,0,1,0,1,0,drop,0,1,Known Attack
38663,15000,54810,15000,138,78,60,2,5,1,1,allow,1,0,Potential Threat
52852,53,0,0,82,82,0,1,30,1,0,allow,0,0,Normal
55473,53,63957,53,186,102,84,2,30,1,1,allow,1,0,Potential Threat
49168,57470,0,0,66,66,0,1,0,1,0,deny,0,1,Known Attack
993,3979,0,0,129,129,0,1,0,1,0,deny,1,1,High Risk
50303,443,45984,443,3051,1801,1250,18,15,8,10,allow,1,0,Potential Threat
55771,53,45760,53,283,98,185,4,51,2,2,allow,0,0,Normal
64094,445,0,0,70,70,0,1,0,1,0,drop,0,1,Known Attack
51130,61689,0,0,66,66,0,1,0,1,0,deny,1,1,High Risk
53298,26467,0,0,66,66,0,1,0,1,0,deny,0,1,Known Attack
54968,53,59501,53,199,102,97,2,30,1,1,allow,0,0,Normal
36325,443,45107,443,2930,1614,1316,16,249,9,7,allow,1,0,Potential Threat
6881,6882,61481,6882,238,118,120,2,1199,1,1,allow,1,0,Potential Threat
51118,80,26346,80,1952,1118,834,21,365,11,10,allow,1,0,Potential Threat
52240,445,0,0,70,70,0,1,0,1,0,drop,0,1,Known Attack
58638,5900,0,0,62,62,0,1,0,1,0,deny,0,1,Known Attack
44034,80,44034,80,18510,706,17804,22,16,6,16,allow,1,0,Potential Threat
11136,19910,0,0,62,62,0,1,0,1,0,deny,0,1,Known Attack
57447,445,0,0,70,70,0,1,0,1,0,drop,0,1,Known Attack
59489,445,0,0,70,70,0,1,0,1,0,drop,0,1,Known Attack
64240,445,0,0,70,70,0,1,0,1,0,drop,0,1,Known Attack
2394,43890,0,0,62,62,0,1,0,1,0,deny,1,1,High Risk
56625,53,59531,53,186,95,91,2,31,1,1,allow,0,0,Normal
57527,445,0,0,70,70,0,1,0,1,0,drop,0,1,Known Attack
23776,57354,0,0,145,145,0,1,0,1,0,deny,1,1,High Risk
51613,443,47721,443,5052,2873,2179,26,15,14,12,allow,1,0,Potential Threat
55592,53,16143,53,817,98,719,2,30,1,1,allow,0,0,Normal
52711,443,64979,443,107997,3957,104040,135,80,51,84,allow,1,0,Potential Threat
45694,80,47472,80,154671,9533,145138,227,38,121,106,allow,1,0,Potential Threat
57959,21247,0,0,66,66,0,1,0,1,0,deny,0,1,Known Attack
55136,445,0,0,70,70,0,1,0,1,0,drop,0,1,Known Attack
57385,445,0,0,70,70,0,1,0,1,0,drop,0,1,Known Attack
49609,53,45961,53,177,94,83,2,31,1,1,allow,0,0,Normal
51728,44847,0,0,66,66,0,1,0,1,0,deny,0,1,Known Attack
57005,445,0,0,70,70,0,1,0,1,0,drop,0,1,Known Attack
53251,443,19794,443,5025,973,4052,19,66,10,9,allow,1,0,Potential Threat
38260,443,50232,443,7173,1419,5754,32,383,11,21,allow,1,0,Potential Threat
57020,36237,0,0,66,66,0,1,0,1,0,deny,0,1,Known Attack
49354,443,56660,443,4379,2565,1814,24,81,11,13,allow,1,0,Potential Threat
23383,64147,0,0,62,62,0,1,0,1,0,deny,1,1,High Risk
62982,445,0,0,66,66,0,1,0,1,0,drop,0,1,Known Attack
51753,445,0,0,70,70,0,1,0,1,0,drop,0,1,Known Attack
13027,64147,0,0,62,62,0,1,0,1,0,deny,1,1,High Risk
47879,443,13971,443,37598,2397,35201,53,239,22,31,allow,1,0,Potential Threat
42385,443,44650,443,26481,1832,24649,40,330,18,22,allow,1,0,Potential Threat
50939,443,38504,443,8058,1136,6922,19,126,9,10,allow,1,0,Potential Threat
57318,53,50520,53,418,88,330,4,41,2,2,allow,0,0,Normal
57901,443,18752,443,3924,1906,2018,26,170,14,12,allow,1,0,Potential Threat
28470,80,28470,80,355544,12402,343142,378,26,134,244,allow,1,0,Potential Threat
49784,443,6049,443,7805,1949,5856,22,126,12,10,allow,1,0,Potential Threat
56770,52920,52041,52920,70,70,0,2,8,2,0,allow,1,0,Potential Threat
50170,445,0,0,70,70,0,1,0,1,0,drop,0,1,Known Attack
0,0,0,0,600,306,294,6,0,3,3,allow,1,0,Potential Threat
54711,443,40588,443,3663,1136,2527,13,136,6,7,allow,1,0,Potential Threat
57763,52752,0,0,66,66,0,1,0,1,0,deny,0,1,Known Attack
62630,445,0,0,66,66,0,1,0,1,0,drop,0,1,Known Attack
51465,80,10875,80,913,410,503,10,15,5,5,allow,0,0,Normal
54280,3359,0,0,60,60,0,1,0,1,0,deny,0,1,Known Attack
63020,443,53282,443,512,166,346,2,30,1,1,allow,0,0,Normal
55897,445,0,0,70,70,0,1,0,1,0,drop,0,1,Known Attack
55635,38649,60618,38649,70,70,0,2,8,2,0,allow,1,0,Potential Threat
57470,64430,53438,64430,1386,1386,0,22,1526,22,0,allow,1,0,Potential Threat
50453,445,0,0,66,66,0,1,0,1,0,drop,0,1,Known Attack
59979,443,21635,443,30171,25514,4657,77,37,42,35,allow,1,0,Potential Threat
12550,37807,0,0,62,62,0,1,0,1,0,deny,1,1,High Risk
51159,445,0,0,70,70,0,1,0,1,0,drop,0,1,Known Attack
50219,445,0,0,70,70,0,1,0,1,0,drop,0,1,Known Attack
1024,64147,0,0,62,62,0,1,0,1,0,deny,1,1,High Risk
14614,25174,0,0,66,66,0,1,0,1,0,deny,0,1,Known Attack
64146,53,41885,53,194,99,95,2,31,1,1,allow,0,0,Normal
65319,53,54613,53,200,94,106,2,30,1,1,allow,0,0,Normal
58638,5900,0,0,62,62,0,1,0,1,0,deny,0,1,Known Attack
58638,5900,0,0,62,62,0,1,0,1,0,deny,0,1,Known Attack
49418,27015,10254,27015,78,78,0,1,30,1,0,allow,1,0,Potential Threat
55231,445,0,0,70,70,0,1,0,1,0,drop,0,1,Known Attack
49507,53,33142,53,177,94,83,2,30,1,1,allow,0,0,Normal
57240,53,32655,53,180,94,86,2,29,1,1,allow,0,0,Normal
29080,50265,0,0,62,62,0,1,0,1,0,deny,1,1,High Risk
54578,26467,0,0,66,66,0,1,0,1,0,deny,0,1,Known Attack
49712,53,30095,53,178,94,84,2,29,1,1,allow,0,0,Normal
52744,443,47091,443,14838,2048,12790,32,25,18,14,allow,1,0,Potential Threat
59669,445,0,0,70,70,0,1,0,1,0,drop,0,1,Known Attack
26330,26348,0,0,62,62,0,1,0,1,0,deny,0,1,Known Attack
59214,445,0,0,70,70,0,1,0,1,0,drop,0,1,Known Attack
55645,443,7018,443,9213,3751,5462,17,121,8,9,allow,1,0,Potential Threat
58975,445,0,0,70,70,0,1,0,1,0,drop,0,1,Known Attack
49454,53,56383,53,762,97,665,2,31,1,1,allow,0,0,Normal
56413,53,29873,53,233,94,139,2,30,1,1,allow,0,0,Normal
57884,445,0,0,70,70,0,1,0,1,0,drop,0,1,Known Attack
37433,443,8364,443,8641,955,7686,19,259,8,11,allow,1,0,Potential Threat
1024,41055,0,0,157,157,0,1,0,1,0,deny,1,1,High Risk
55001,445,0,0,70,70,0,1,0,1,0,drop,0,1,Known Attack
55015,53,27863,53,733,94,639,2,30,1,1,allow,0,0,Normal
53801,53,14956,53,167,78,89,2,30,1,1,allow,0,0,Normal
11897,443,11897,443,1452,817,635,16,29,9,7,allow,1,0,Potential Threat
13159,37965,0,0,66,66,0,1,0,1,0,deny,1,1,High Risk
49001,40108,0,0,161,161,0,1,0,1,0,deny,1,1,High Risk
50466,53,25118,53,295,101,194,4,30,2,2,allow,0,0,Normal
64460,53,1617,53,196,102,94,2,30,1,1,allow,0,0,Normal
62919,445,0,0,70,70,0,1,0,1,0,drop,0,1,Known Attack
64088,39650,57206,39650,66,66,0,2,7,2,0,allow,1,0,Potential Threat
29805,53,29805,53,226,89,137,2,30,1,1,allow,0,0,Normal
27988,40011,54890,40011,253,190,63,2,30,1,1,allow,1,0,Potential Threat
44293,23,0,0,60,60,0,1,0,1,0,deny,0,1,Known Attack
47762,36180,0,0,146,146,0,1,0,1,0,deny,1,1,High Risk
65287,3389,65287,3389,3409,1454,1955,16,16,8,8,allow,1,0,Potential Threat
49195,445,0,0,70,70,0,1,0,1,0,drop,0,1,Known Attack
49893,80,42792,80,1376,946,430,8,86,5,3,allow,0,0,Normal
57286,445,0,0,70,70,0,1,0,1,0,drop,0,1,Known Attack
0,0,0,0,82,82,0,1,0,1,0,deny,1,1,High Risk
59796,23,0,0,60,60,0,1,0,1,0,deny,0,1,Known Attack
61673,445,0,0,70,70,0,1,0,1,0,drop,0,1,Known Attack
52050,445,0,0,70,70,0,1,0,1,0,drop,0,1,Known Attack
64376,443,64376,443,4592,1685,2907,19,29,11,8,allow,1,0,Potential Threat
49882,80,49056,80,2560,599,1961,13,75,7,6,allow,0,0,Normal
31609,25174,0,0,62,62,0,1,0,1,0,deny,0,1,Known Attack
57132,53,52410,53,216,110,106,2,31,1,1,allow,0,0,Normal
35925,443,8324,443,1092248,9101,1083147,860,195,111,749,allow,1,0,Potential Threat
64047,16221,14226,16221,70,70,0,1,4,1,0,allow,1,0,Potential Threat
51963,443,38927,443,14602,6734,7868,46,56,26,20,allow,1,0,Potential Threat
33876,53,33876,53,404,259,145,3,32,2,1,allow,0,0,Normal
64748,53,3750,53,168,94,74,2,29,1,1,allow,0,0,Normal
26900,27017,43852,27017,422,164,258,6,29,3,3,allow,1,0,Potential Threat
39303,80,19010,80,3198,1493,1705,18,80,11,7,allow,1,0,Potential Threat
57788,443,31761,443,6400,1327,5073,21,21,13,8,allow,1,0,Potential Threat
55706,22,55706,22,252,60,192,5,14,2,3,allow,0,0,Normal
48831,443,51436,443,10129,5016,5113,18,120,9,9,allow,1,0,Potential Threat
62913,445,0,0,70,70,0,1,0,1,0,drop,0,1,Known Attack
1821,64147,0,0,66,66,0,1,0,1,0,deny,1,1,High Risk
45067,443,54041,443,7794,2844,4950,26,29,16,10,allow,1,0,Potential Threat
65092,53,28213,53,197,102,95,2,29,1,1,allow,0,0,Normal
36357,25174,0,0,62,62,0,1,0,1,0,deny,0,1,Known Attack
51784,34568,29870,34568,70,70,0,2,8,2,0,allow,1,0,Potential Threat
0,0,0,0,156,156,0,2,0,2,0,allow,1,1,High Risk
9144,80,51086,80,378,192,186,7,30,4,3,allow,1,0,Potential Threat
46190,80,10092,80,5443,2529,2914,14,515,8,6,allow,1,0,Potential Threat
6881,41872,4010,41872,509,150,359,2,1200,1,1,allow,1,0,Potential Threat
19838,23,0,0,60,60,0,1,0,1,0,deny,0,1,Known Attack
48323,35253,0,0,146,146,0,1,0,1,0,deny,1,1,High Risk
50031,44847,0,0,74,74,0,1,0,1,0,deny,0,1,Known Attack
59486,53,24146,53,316,86,230,2,29,1,1,allow,0,0,Normal
45862,443,6882,443,234,234,0,4,11,4,0,allow,0,0,Normal
2886,35440,0,0,66,66,0,1,0,1,0,deny,1,1,High Risk
62999,445,0,0,66,66,0,1,0,1,0,drop,0,1,Known Attack
1024,25174,0,0,62,62,0,1,0,1,0,deny,1,1,High Risk
62237,445,0,0,66,66,0,1,0,1,0,drop,0,1,Known Attack
64602,53,49677,53,184,94,90,2,30,1,1,allow,0,0,Normal
57337,64147,0,0,66,66,0,1,0,1,0,deny,1,1,High Risk
50280,57470,0,0,78,78,0,1,0,1,0,deny,1,1,High Risk
64525,53,5631,53,199,102,97,2,29,1,1,allow,0,0,Normal
57219,5223,28908,5223,9687,5105,4582,30,298,16,14,allow,1,0,Potential Threat
60853,443,17952,443,126,60,66,3,4,2,1,allow,0,0,Normal
49889,53,48150,53,197,102,95,2,31,1,1,allow,0,0,Normal
52531,445,0,0,66,66,0,1,0,1,0,drop,0,1,Known Attack
54636,443,3394,443,311000,8576,302424,319,175,103,216,allow,1,0,Potential Threat
13567,23684,0,0,168,168,0,1,0,1,0,deny,1,1,High Risk
49878,443,52783,443,5997,978,5019,19,53,10,9,allow,1,0,Potential Threat
54624,445,0,0,70,70,0,1,0,1,0,drop,0,1,Known Attack
54902,80,36045,80,1107,630,477,10,16,6,4,allow,0,0,Normal
56919,53,19863,53,186,95,91,2,31,1,1,allow,0,0,Normal
49763,53,30741,53,258,110,148,2,30,1,1,allow,0,0,Normal
57189,53,13765,53,78,78,0,1,30,1,0,allow,0,0,Normal
64818,445,0,0,70,70,0,1,0,1,0,drop,0,1,Known Attack
56640,80,54626,80,234,234,0,4,11,4,0,allow,0,0,Normal
50466,445,0,0,70,70,0,1,0,1,0,drop,0,1,Known Attack
56431,53,39797,53,177,94,83,2,30,1,1,allow,0,0,Normal
18577,25174,0,0,62,62,0,1,0,1,0,deny,0,1,Known Attack
57470,3800,54639,3800,150,150,0,1,1199,1,0,allow,1,0,Potential Threat
56176,53,4646,53,188,96,92,2,30,1,1,allow,0,0,Normal
41247,80,40368,80,78,78,0,1,5,1,0,allow,0,0,Normal
54815,3389,54815,3389,3424,1710,1714,16,31,8,8,allow,1,0,Potential Threat
63025,443,40805,443,304,86,218,2,30,1,1,allow,0,0,Normal
57176,53,50437,53,178,94,84,2,29,1,1,allow,0,0,Normal
52319,445,0,0,70,70,0,1,0,1,0,drop,0,1,Known Attack
25031,25174,0,0,146,146,0,1,0,1,0,deny,1,1,High Risk
45405,161,0,0,5858,2302,3556,22,30,11,11,allow,1,0,Potential Threat
60832,5222,60932,5222,3848,1039,2809,37,662,11,26,allow,1,0,Potential Threat
38536,443,1919,443,33980,7386,26594,51,121,22,29,allow,1,0,Potential Threat
62857,445,0,0,70,70,0,1,0,1,0,drop,0,1,Known Attack
52764,443,33185,443,14001,2908,11093,35,150,18,17,allow,1,0,Potential Threat
56664,443,31995,443,7561,2483,5078,26,20,13,13,allow,1,0,Potential Threat
50366,443,19959,443,1755,986,769,13,25,8,5,allow,0,0,Normal
52113,19619,23788,19619,70,70,0,2,8,2,0,allow,1,0,Potential Threat
62237,443,62237,443,169315,5255,164060,190,77,66,124,allow,1,0,Potential Threat
59839,443,29303,443,93467,4007,89460,107,22,33,74,allow,1,0,Potential Threat
38568,443,10055,443,11418,1999,9419,28,22,13,15,allow,1,0,Potential Threat
44704,443,31142,443,7228,3478,3750,37,164,17,20,allow,1,0,Potential Threat
51877,13472,10032,13472,70,70,0,2,8,2,0,allow,1,0,Potential Threat
5661,37965,0,0,62,62,0,1,0,1,0,deny,1,1,High Risk
27005,27015,55058,27015,1666,126,1540,4,31,2,2,allow,1,0,Potential Threat
57470,37395,27238,37395,1566,332,1234,11,1199,5,6,allow,1,0,Potential Threat
57385,445,0,0,66,66,0,1,0,1,0,drop,0,1,Known Attack
55776,53,11863,53,216,110,106,2,29,1,1,allow,0,0,Normal
55487,53,60324,53,199,102,97,2,31,1,1,allow,0,0,Normal
58859,443,48012,443,39518,2389,37129,54,179,21,33,allow,1,0,Potential Threat
60781,40010,23139,40010,316,136,180,6,5,3,3,allow,1,0,Potential Threat
62651,445,0,0,70,70,0,1,0,1,0,drop,0,1,Known Attack
49349,53,14349,53,183,94,89,2,30,1,1,allow,0,0,Normal
36138,443,58693,443,50384,5218,45166,76,99,26,50,allow,1,0,Potential Threat
48448,48817,0,0,66,66,0,1,0,1,0,deny,0,1,Known Attack
14032,53,14032,53,235,90,145,2,32,1,1,allow,0,0,Normal
50673,80,12286,80,20265,5748,14517,34,23,16,18,allow,1,0,Potential Threat
62339,25174,0,0,66,66,0,1,0,1,0,deny,0,1,Known Attack
51185,37965,0,0,66,66,0,1,0,1,0,deny,0,1,Known Attack
52518,35440,0,0,66,66,0,1,0,1,0,deny,0,1,Known Attack
30960,45759,38428,45759,330,330,0,6,3609,6,0,allow,1,0,Potential Threat
49682,53,35686,53,341,110,231,2,29,1,1,allow,0,0,Normal
16944,50584,0,0,146,146,0,1,0,1,0,deny,1,1,High Risk
59947,445,0,0,70,70,0,1,0,1,0,drop,0,1,Known Attack
29424,37807,0,0,66,66,0,1,0,1,0,deny,0,1,Known Attack
56152,53,29649,53,195,102,93,2,30,1,1,allow,0,0,Normal
64816,53,1997,53,164,84,80,2,31,1,1,allow,0,0,Normal
56963,80,25455,80,6974,3906,3068,19,30,11,8,allow,1,0,Potential Threat
55829,53,51099,53,177,94,83,2,30,1,1,allow,0,0,Normal
65026,53,34108,53,193,102,91,2,29,1,1,allow,0,0,Normal
53802,59932,27956,59932,320,140,180,6,6,3,3,allow,1,0,Potential Threat
65346,53,19469,53,183,94,89,2,30,1,1,allow,0,0,Normal
58395,53,61283,53,307,86,221,2,30,1,1,allow,0,0,Normal
49282,6881,35216,6881,709,523,186,6,16,3,3,allow,1,0,Potential Threat
49243,53,10757,53,452,118,334,2,30,1,1,allow,0,0,Normal
48882,443,39008,443,8105,1902,6203,24,26,14,10,allow,1,0,Potential Threat
37665,443,54006,443,8134,2717,5417,24,16,15,9,allow,1,0,Potential Threat
63732,40642,2876,40642,70,70,0,1,5,1,0,allow,1,0,Potential Threat
51661,443,59276,443,11558,3964,7594,37,17,15,22,allow,1,0,Potential Threat
22350,25174,0,0,66,66,0,1,0,1,0,deny,0,1,Known Attack
53034,445,0,0,70,70,0,1,0,1,0,drop,0,1,Known Attack
51754,18375,0,0,62,62,0,1,0,1,0,deny,0,1,Known Attack
50038,443,53552,443,2652,1566,1086,15,86,9,6,allow,1,0,Potential Threat
28830,37965,0,0,62,62,0,1,0,1,0,deny,0,1,Known Attack
65433,445,0,0,66,66,0,1,0,1,0,drop,0,1,Known Attack
8168,80,8168,80,282487,10736,271751,315,52,124,191,allow,1,0,Potential Threat
58638,5900,0,0,62,62,0,1,0,1,0,deny,0,1,Known Attack
49561,445,0,0,70,70,0,1,0,1,0,drop,0,1,Known Attack
49371,445,0,0,70,70,0,1,0,1,0,drop,0,1,Known Attack
54051,445,0,0,70,70,0,1,0,1,0,drop,0,1,Known Attack
63005,445,0,0,66,66,0,1,0,1,0,drop,0,1,Known Attack
3478,61463,0,0,437,437,0,1,0,1,0,deny,1,1,High Risk
61508,445,0,0,70,70,0,1,0,1,0,drop,0,1,Known Attack
55808,53,32888,53,183,94,89,2,30,1,1,allow,0,0,Normal
64650,53,46185,53,257,126,131,2,30,1,1,allow,0,0,Normal
58638,5900,0,0,62,62,0,1,0,1,0,deny,0,1,Known Attack
64958,53,60361,53,197,102,95,2,30,1,1,allow,0,0,Normal
49616,30188,0,0,66,66,0,1,0,1,0,deny,0,1,Known Attack
27005,27268,57130,27268,884,126,758,2,30,1,1,allow,1,0,Potential Threat
51690,993,38356,993,15022,5202,9820,113,36,53,60,allow,1,0,Potential Threat
54957,53,36470,53,99,99,0,1,30,1,0,allow,0,0,Normal
56662,443,10328,443,318,192,126,6,15,4,2,allow,0,0,Normal
21759,51505,0,0,66,66,0,1,0,1,0,deny,1,1,High Risk
49621,53,59180,53,287,93,194,4,56,2,2,allow,0,0,Normal
62187,445,0,0,70,70,0,1,0,1,0,drop,0,1,Known Attack
56612,53,30112,53,274,87,187,4,31,2,2,allow,0,0,Normal
56942,53,38411,53,177,94,83,2,30,1,1,allow,0,0,Normal
43230,80,43230,80,6776,692,6084,16,20,8,8,allow,1,0,Potential Threat
51778,60565,25061,60565,70,70,0,2,8,2,0,allow,1,0,Potential Threat
48354,5222,3961,5222,7786,1403,6383,44,434,15,29,allow,1,0,Potential Threat
63990,53,19922,53,270,94,176,2,30,1,1,allow,0,0,Normal
58638,5900,0,0,62,62,0,1,0,1,0,deny,0,1,Known Attack
57444,53,13400,53,198,94,104,2,29,1,1,allow,0,0,Normal
15530,49718,0,0,146,146,0,1,0,1,0,deny,1,1,High Risk
54992,53,53080,53,195,102,93,2,29,1,1,allow,0,0,Normal
55077,53,19465,53,277,90,187,4,32,2,2,allow,0,0,Normal
60392,445,0,0,70,70,0,1,0,1,0,drop,0,1,Known Attack
63543,445,0,0,66,66,0,1,0,1,0,drop,0,1,Known Attack
55088,445,0,0,70,70,0,1,0,1,0,drop,0,1,Known Attack
60742,443,40207,443,2258,559,1699,22,120,6,16,allow,1,0,Potential Threat
49651,80,48758,80,1854,945,909,13,106,7,6,allow,0,0,Normal
65435,80,40330,80,11239,7307,3932,19,25,10,9,allow,1,0,Potential Threat
55210,53,63664,53,969,86,883,2,30,1,1,allow,1,0,Potential Threat
55070,53,21493,53,195,102,93,2,30,1,1,allow,0,0,Normal
53706,59208,42614,59208,164,70,94,2,8,1,1,allow,1,0,Potential Threat
56645,445,0,0,66,66,0,1,0,1,0,drop,0,1,Known Attack
64882,445,0,0,66,66,0,1,0,1,0,drop,0,1,Known Attack
27745,50584,0,0,62,62,0,1,0,1,0,deny,1,1,High Risk
50033,53,63649,53,533,184,349,6,76,3,3,allow,1,0,Potential Threat
58562,3389,58562,3389,5387,1909,3478,22,21,10,12,allow,1,0,Potential Threat
53602,12395,26422,12395,70,70,0,2,7,2,0,allow,1,0,Potential Threat
54373,443,3920,443,16029,6377,9652,46,37,24,22,allow,1,0,Potential Threat
54701,445,0,0,66,66,0,1,0,1,0,drop,0,1,Known Attack
27005,27017,7063,27017,877,126,751,3,31,2,1,allow,1,0,Potential Threat
41011,443,63172,443,175097,9838,165259,244,106,120,124,allow,1,0,Potential Threat
53960,445,0,0,70,70,0,1,0,1,0,drop,0,1,Known Attack
54987,443,13107,443,7502,2299,5203,37,18,21,16,allow,1,0,Potential Threat
53129,80,16654,80,5318,685,4633,14,15,7,7,allow,1,0,Potential Threat
42034,28189,0,0,62,62,0,1,0,1,0,deny,0,1,Known Attack
58909,443,25795,443,7671,4890,2781,25,17,13,12,allow,1,0,Potential Threat
33651,36237,0,0,146,146,0,1,0,1,0,deny,1,1,High Risk
50916,80,44611,80,11456216,116932,11339284,9298,139,1683,7615,allow,1,0,Potential Threat
64948,25198,0,0,145,145,0,1,0,1,0,deny,1,1,High Risk
52735,443,43904,443,41870,3567,38303,68,15,34,34,allow,1,0,Potential Threat
56318,53,32737,53,183,94,89,2,30,1,1,allow,0,0,Normal
63957,53,57529,53,211,102,109,2,30,1,1,allow,0,0,Normal
55404,443,49426,443,70,70,0,1,5,1,0,allow,0,0,Normal
54560,445,0,0,70,70,0,1,0,1,0,drop,0,1,Known Attack
16387,64075,0,0,60,60,0,1,0,1,0,deny,1,1,High Risk
56454,445,0,0,70,70,0,1,0,1,0,drop,0,1,Known Attack
58955,445,0,0,66,66,0,1,0,1,0,drop,0,1,Known Attack
60403,22114,0,0,66,66,0,1,0,1,0,deny,0,1,Known Attack
57910,445,0,0,66,66,0,1,0,1,0,drop,0,1,Known Attack
53686,445,0,0,66,66,0,1,0,1,0,drop,0,1,Known Attack
50600,53,50600,53,257,101,156,2,34,1,1,allow,0,0,Normal
51000,445,0,0,70,70,0,1,0,1,0,drop,0,1,Known Attack
49488,53,56220,53,194,102,92,2,31,1,1,allow,0,0,Normal
50871,445,0,0,70,70,0,1,0,1,0,drop,0,1,Known Attack
60433,6881,35052,6881,70,70,0,1,5,1,0,allow,1,0,Potential Threat
56310,53,55159,53,760,97,663,2,31,1,1,allow,0,0,Normal
57773,443,16393,443,11544,6888,4656,32,125,17,15,allow,1,0,Potential Threat
6881,55839,0,0,139,139,0,1,0,1,0,deny,1,1,High Risk
56562,53,42626,53,183,94,89,2,30,1,1,allow,0,0,Normal
56374,53,12810,53,177,94,83,2,29,1,1,allow,0,0,Normal
49736,443,65019,443,52574,2783,49791,61,129,19,42,allow,1,0,Potential Threat
62282,445,0,0,66,66,0,1,0,1,0,drop,0,1,Known Attack
51315,445,0,0,66,66,0,1,0,1,0,drop,0,1,Known Attack
50039,53,19771,53,261,110,151,2,30,1,1,allow,0,0,Normal
55605,53,8091,53,190,97,93,2,31,1,1,allow,0,0,Normal
49432,53,5253,53,177,94,83,2,31,1,1,allow,0,0,Normal
64538,443,60340,443,4658,1652,3006,10,121,5,5,allow,1,0,Potential Threat
56082,53,27828,53,182,94,88,2,30,1,1,allow,0,0,Normal
39422,80,48610,80,1057,683,374,10,15,6,4,allow,1,0,Potential Threat
57765,2767,0,0,146,146,0,1,0,1,0,deny,0,1,Known Attack
58511,50584,0,0,146,146,0,1,0,1,0,deny,1,1,High Risk
53853,443,28816,443,3692,2154,1538,25,81,12,13,allow,1,0,Potential Threat
55926,53,56818,53,184,94,90,2,29,1,1,allow,0,0,Normal
55337,53,41001,53,198,102,96,2,29,1,1,allow,0,0,Normal
55399,53,43504,53,180,94,86,2,30,1,1,allow,0,0,Normal
62780,35440,0,0,66,66,0,1,0,1,0,deny,0,1,Known Attack
44847,12269,58091,12269,502,150,352,2,1200,1,1,allow,1,0,Potential Threat
54233,443,10183,443,499,425,74,4,0,3,1,allow,0,0,Normal
60741,445,0,0,70,70,0,1,0,1,0,drop,0,1,Known Attack
17837,62609,0,0,148,148,0,1,0,1,0,deny,1,1,High Risk
50319,53,28862,53,756,95,661,2,30,1,1,allow,0,0,Normal
59416,443,53026,443,10642,3654,6988,26,125,14,12,allow,1,0,Potential Threat
46662,36237,0,0,62,62,0,1,0,1,0,deny,0,1,Known Attack
52569,445,0,0,70,70,0,1,0,1,0,drop,0,1,Known Attack
16403,16385,49252,16385,548,248,300,10,30,5,5,allow,1,0,Potential Threat
57031,445,0,0,70,70,0,1,0,1,0,drop,0,1,Known Attack
50151,53,44129,53,168,94,74,2,30,1,1,allow,0,0,Normal
65449,53,65266,53,507,193,314,6,57,3,3,allow,1,0,Potential Threat
52011,10722,14551,10722,70,70,0,1,4,1,0,allow,1,0,Potential Threat
51983,30472,23592,30472,70,70,0,2,8,2,0,allow,1,0,Potential Threat
63419,53,63419,53,216,90,126,2,30,1,1,allow,1,0,Potential Threat
55806,53,53227,53,200,102,98,2,30,1,1,allow,0,0,Normal
38936,80,38936,80,8429,1098,7331,16,20,8,8,allow,1,0,Potential Threat
54029,445,0,0,66,66,0,1,0,1,0,drop,0,1,Known Attack
39381,53,0,0,82,82,0,1,31,1,0,allow,0,0,Normal
49456,443,8615,443,10956,1757,9199,21,37,10,11,allow,1,0,Potential Threat
64805,53,48699,53,278,102,176,2,31,1,1,allow,0,0,Normal
56395,53,28310,53,177,94,83,2,30,1,1,allow,0,0,Normal
52724,64147,0,0,62,62,0,1,0,1,0,deny,1,1,High Risk
61235,445,0,0,66,66,0,1,0,1,0,drop,0,1,Known Attack
61137,40740,0,0,145,145,0,1,0,1,0,deny,1,1,High Risk
57550,445,0,0,70,70,0,1,0,1,0,drop,0,1,Known Attack
33006,80,33006,80,6582,886,5696,15,16,7,8,allow,1,0,Potential Threat
59168,39004,0,0,62,62,0,1,0,1,0,deny,0,1,Known Attack
50756,445,0,0,66,66,0,1,0,1,0,drop,0,1,Known Attack
55771,53,25077,53,196,102,94,2,30,1,1,allow,0,0,Normal
61637,53,50085,53,246,246,0,4,47,4,0,allow,0,0,Normal
53833,26467,0,0,66,66,0,1,0,1,0,deny,0,1,Known Attack
53222,53,43522,53,165,78,87,2,30,1,1,allow,0,0,Normal
50495,53,24606,53,182,102,80,2,30,1,1,allow,0,0,Normal
45766,35440,0,0,62,62,0,1,0,1,0,deny,0,1,Known Attack
58910,445,0,0,70,70,0,1,0,1,0,drop,0,1,Known Attack
38383,51221,0,0,66,66,0,1,0,1,0,deny,0,1,Known Attack
49756,53,22675,53,243,118,125,2,30,1,1,allow,0,0,Normal
32940,443,60631,443,13056,4233,8823,27,121,12,15,allow,1,0,Potential Threat
51142,80,61764,80,1114,534,580,12,16,7,5,allow,1,0,Potential Threat
26921,57470,0,0,62,62,0,1,0,1,0,deny,1,1,High Risk
19068,37965,0,0,62,62,0,1,0,1,0,deny,1,1,High Risk
0,0,0,0,198,128,70,3,0,2,1,allow,1,0,Potential Threat
57673,445,0,0,66,66,0,1,0,1,0,drop,0,1,Known Attack
59145,445,0,0,66,66,0,1,0,1,0,drop,0,1,Known Attack
55244,53,11760,53,168,78,90,2,30,1,1,allow,0,0,Normal
50584,16453,1503,16453,161,161,0,2,1200,2,0,allow,1,0,Potential Threat
51834,35440,0,0,66,66,0,1,0,1,0,deny,0,1,Known Attack
56408,443,36804,443,17704,1456,16248,25,123,11,14,allow,1,0,Potential Threat
49255,44847,0,0,66,66,0,1,0,1,0,deny,0,1,Known Attack
63976,25725,46114,25725,66,66,0,2,8,2,0,allow,1,0,Potential Threat
55156,53,48355,53,256,87,169,4,37,2,2,allow,0,0,Normal
62153,35440,0,0,62,62,0,1,0,1,0,deny,0,1,Known Attack
2049,32480,0,0,62,62,0,1,0,1,0,deny,1,1,High Risk
61978,445,0,0,66,66,0,1,0,1,0,drop,0,1,Known Attack
49770,80,9129,80,254,128,126,5,15,3,2,allow,0,0,Normal
57554,445,0,0,66,66,0,1,0,1,0,drop,0,1,Known Attack
58990,53,6423,53,168,78,90,2,30,1,1,allow,0,0,Normal
13825,443,28678,443,8844,949,7895,19,75,9,10,allow,1,0,Potential Threat
58468,57587,0,0,66,66,0,1,0,1,0,deny,1,1,High Risk
61711,35440,0,0,62,62,0,1,0,1,0,deny,0,1,Known Attack
57044,53,24810,53,197,102,95,2,30,1,1,allow,0,0,Normal
64133,53,49082,53,225,110,115,2,30,1,1,allow,0,0,Normal
56592,53,12698,53,200,102,98,2,29,1,1,allow,0,0,Normal
59226,53,59226,53,194,87,107,2,30,1,1,allow,0,0,Normal
53768,19067,20998,19067,70,70,0,1,5,1,0,allow,1,0,Potential Threat
43516,53,56876,53,168,78,90,2,30,1,1,allow,0,0,Normal
63021,443,34609,443,512,166,346,2,30,1,1,allow,0,0,Normal
58638,5900,0,0,62,62,0,1,0,1,0,deny,0,1,Known Attack
59357,445,0,0,66,66,0,1,0,1,0,drop,0,1,Known Attack
44674,25174,0,0,146,146,0,1,0,1,0,deny,1,1,High Risk
52802,56205,0,0,62,62,0,1,0,1,0,deny,0,1,Known Attack
58839,443,35385,443,8595,2118,6477,40,179,22,18,allow,1,0,Potential Threat
49195,8108,53972,8108,70,70,0,1,5,1,0,allow,1,0,Potential Threat
2267,53,1505,53,204,118,86,2,30,1,1,allow,1,0,Potential Threat
60479,25174,0,0,62,62,0,1,0,1,0,deny,0,1,Known Attack
55727,445,0,0,70,70,0,1,0,1,0,drop,0,1,Known Attack
51610,443,19441,443,6952,3608,3344,27,21,14,13,allow,1,0,Potential Threat
5914,10214,0,0,100,100,0,1,0,1,0,deny,1,1,High Risk
10406,35440,0,0,146,146,0,1,0,1,0,deny,1,1,High Risk
42108,80,8576,80,8370,1025,7345,18,80,10,8,allow,1,0,Potential Threat
55262,44847,0,0,62,62,0,1,0,1,0,deny,0,1,Known Attack
55321,53,63193,53,193,102,91,2,30,1,1,allow,1,0,Potential Threat
53813,445,0,0,70,70,0,1,0,1,0,drop,0,1,Known Attack
57142,53,15103,53,165,86,79,2,30,1,1,allow,0,0,Normal
51192,15503,0,0,66,66,0,1,0,1,0,deny,0,1,Known Attack
56315,123,48493,123,184,94,90,2,30,1,1,allow,0,0,Normal
64968,445,0,0,70,70,0,1,0,1,0,drop,0,1,Known Attack
59999,445,0,0,70,70,0,1,0,1,0,drop,0,1,Known Attack
60957,445,0,0,70,70,0,1,0,1,0,drop,0,1,Known Attack
23306,25174,0,0,146,146,0,1,0,1,0,deny,1,1,High Risk
52917,443,43916,443,7148,2358,4790,40,116,18,22,allow,1,0,Potential Threat
56801,443,16437,443,8022,2002,6020,20,15,11,9,allow,1,0,Potential Threat
60720,23718,0,0,66,66,0,1,0,1,0,deny,0,1,Known Attack
58638,5900,0,0,62,62,0,1,0,1,0,deny,0,1,Known Attack
55122,443,57128,443,17936,14273,3663,59,122,33,26,allow,1,0,Potential Threat
42429,22114,0,0,146,146,0,1,0,1,0,deny,1,1,High Risk
33359,30188,0,0,66,66,0,1,0,1,0,deny,0,1,Known Attack
55066,53,62750,53,180,94,86,2,30,1,1,allow,0,0,Normal
62952,443,20995,443,1304,612,692,18,120,9,9,allow,1,0,Potential Threat
59106,443,57756,443,7398,2209,5189,23,35,11,12,allow,1,0,Potential Threat
58854,443,18047,443,5202,3361,1841,19,16,10,9,allow,1,0,Potential Threat
64019,53,58991,53,267,94,173,2,30,1,1,allow,0,0,Normal
50453,445,0,0,70,70,0,1,0,1,0,drop,0,1,Known Attack
52321,26467,0,0,62,62,0,1,0,1,0,deny,0,1,Known Attack
41037,55839,0,0,157,157,0,1,0,1,0,deny,1,1,High Risk
62064,443,63626,443,11582,2503,9079,33,47,17,16,allow,1,0,Potential Threat
50524,53,62327,53,193,102,91,2,30,1,1,allow,0,0,Normal
65039,53,3857,53,302,102,200,2,30,1,1,allow,0,0,Normal
2437,23117,0,0,62,62,0,1,0,1,0,deny,1,1,High Risk
43770,53,60550,53,199,94,105,2,30,1,1,allow,0,0,Normal
27005,27015,49303,27015,868,126,742,2,30,1,1,allow,1,0,Potential Threat
56765,53,1940,53,188,96,92,2,31,1,1,allow,0,0,Normal
54819,443,59534,443,3429,1188,2241,13,134,6,7,allow,1,0,Potential Threat
39840,443,35916,443,6097,1540,4557,25,191,13,12,allow,1,0,Potential Threat
47089,443,11846,443,172,172,0,2,5,2,0,allow,0,0,Normal
58638,5900,0,0,62,62,0,1,0,1,0,deny,0,1,Known Attack
42044,60043,0,0,66,66,0,1,0,1,0,deny,1,1,High Risk
34995,443,34995,443,1542,489,1053,8,20,5,3,allow,1,0,Potential Threat
47173,35440,0,0,62,62,0,1,0,1,0,deny,0,1,Known Attack
50327,80,7970,80,366,180,186,7,47,4,3,allow,0,0,Normal
55033,445,0,0,70,70,0,1,0,1,0,drop,0,1,Known Attack
50673,445,0,0,66,66,0,1,0,1,0,drop,0,1,Known Attack
60420,2924,28301,2924,320,140,180,6,7,3,3,allow,1,0,Potential Threat
51226,7275,28428,7275,416,210,206,7,16,4,3,allow,1,0,Potential Threat
57470,20014,49843,20014,528,528,0,9,1200,9,0,allow,1,0,Potential Threat
56102,443,1329,443,8577,3450,5127,23,30,13,10,allow,1,0,Potential Threat
52069,53446,32796,53446,70,70,0,1,5,1,0,allow,1,0,Potential Threat
50106,53,56744,53,296,94,202,2,30,1,1,allow,0,0,Normal
50478,445,0,0,66,66,0,1,0,1,0,drop,0,1,Known Attack
14070,62413,0,0,66,66,0,1,0,1,0,deny,1,1,High Risk
64755,31573,0,0,62,62,0,1,0,1,0,deny,0,1,Known Attack
5179,50265,0,0,62,62,0,1,0,1,0,deny,1,1,High Risk
56504,53,4684,53,196,100,96,2,30,1,1,allow,0,0,Normal
58856,80,5930,80,1614,1300,314,10,15,5,5,allow,1,0,Potential Threat
56816,53,22918,53,233,94,139,2,30,1,1,allow,0,0,Normal
56255,44847,0,0,66,66,0,1,0,1,0,deny,0,1,Known Attack
55082,25174,0,0,66,66,0,1,0,1,0,deny,0,1,Known Attack
35515,80,62151,80,841,715,126,5,15,3,2,allow,1,0,Potential Threat
57432,53,35465,53,193,102,91,2,29,1,1,allow,0,0,Normal
60133,1,0,0,66,66,0,1,0,1,0,deny,0,1,Known Attack
61494,445,0,0,66,66,0,1,0,1,0,drop,0,1,Known Attack
64166,35440,0,0,66,66,0,1,0,1,0,deny,0,1,Known Attack
56403,445,0,0,70,70,0,1,0,1,0,drop,0,1,Known Attack
51540,443,24638,443,957715,36759,920956,1075,161,378,697,allow,1,0,Potential Threat
48839,37807,0,0,146,146,0,1,0,1,0,deny,1,1,High Risk
1695,30349,0,0,148,148,0,1,0,1,0,deny,1,1,High Risk
62045,445,0,0,70,70,0,1,0,1,0,drop,0,1,Known Attack
51471,445,0,0,70,70,0,1,0,1,0,drop,0,1,Known Attack
50725,445,0,0,66,66,0,1,0,1,0,drop,0,1,Known Attack
61357,64147,0,0,62,62,0,1,0,1,0,deny,1,1,High Risk
52882,445,0,0,70,70,0,1,0,1,0,drop,0,1,Known Attack
60957,445,0,0,70,70,0,1,0,1,0,drop,0,1,Known Attack
57009,80,12239,80,214,140,74,4,30,3,1,allow,0,0,Normal
55581,53,6275,53,167,86,81,2,30,1,1,allow,0,0,Normal
49909,443,16969,443,6754,2219,4535,21,75,11,10,allow,1,0,Potential Threat
52314,445,0,0,70,70,0,1,0,1,0,drop,0,1,Known Attack
59857,445,0,0,66,66,0,1,0,1,0,drop,0,1,Known Attack
21870,53,21870,53,209,77,132,2,32,1,1,allow,0,0,Normal
58492,443,51321,443,5611,1560,4051,22,266,13,9,allow,1,0,Potential Threat
53209,445,0,0,70,70,0,1,0,1,0,drop,0,1,Known Attack
64911,53,65363,53,232,86,146,2,30,1,1,allow,1,0,Potential Threat
62767,57470,0,0,74,74,0,1,0,1,0,deny,1,1,High Risk
37643,443,56932,443,10517,2926,7591,29,20,16,13,allow,1,0,Potential Threat
56738,53,8511,53,264,87,177,4,37,2,2,allow,0,0,Normal
47943,50584,0,0,74,74,0,1,0,1,0,deny,0,1,Known Attack
65486,53,53853,53,193,102,91,2,30,1,1,allow,0,0,Normal
55283,53,5653,53,754,94,660,2,31,1,1,allow,0,0,Normal
56045,445,0,0,70,70,0,1,0,1,0,drop,0,1,Known Attack
53490,80,9100,80,2577,1278,1299,14,267,8,6,allow,1,0,Potential Threat
56708,443,4344,443,8059,2039,6020,20,15,11,9,allow,1,0,Potential Threat
55241,443,32846,443,8080,2630,5450,24,45,12,12,allow,1,0,Potential Threat
55732,53,61011,53,194,102,92,2,30,1,1,allow,0,0,Normal
57094,53,64941,53,192,98,94,2,31,1,1,allow,1,0,Potential Threat
54423,445,0,0,66,66,0,1,0,1,0,drop,0,1,Known Attack
62173,445,0,0,70,70,0,1,0,1,0,drop,0,1,Known Attack
49300,443,63188,443,6101,848,5253,17,21,9,8,allow,1,0,Potential Threat
54058,445,0,0,70,70,0,1,0,1,0,drop,0,1,Known Attack
49886,443,58788,443,77867,2411,75456,82,87,27,55,allow,1,0,Potential Threat
49717,57470,0,0,62,62,0,1,0,1,0,deny,0,1,Known Attack
50211,51050,0,0,62,62,0,1,0,1,0,deny,0,1,Known Attack
52056,50328,8366,50328,70,70,0,1,5,1,0,allow,1,0,Potential Threat
60316,445,0,0,66,66,0,1,0,1,0,drop,0,1,Known Attack
61415,445,0,0,70,70,0,1,0,1,0,drop,0,1,Known Attack
49429,53,36318,53,210,110,100,2,30,1,1,allow,0,0,Normal
53844,22114,0,0,62,62,0,1,0,1,0,deny,0,1,Known Attack
56416,445,0,0,70,70,0,1,0,1,0,drop,0,1,Known Attack
53886,49618,46889,49618,492,306,186,8,16,5,3,allow,1,0,Potential Threat
55286,53,17426,53,268,87,181,4,35,2,2,allow,0,0,Normal
65252,445,0,0,70,70,0,1,0,1,0,drop,0,1,Known Attack
27505,25174,0,0,62,62,0,1,0,1,0,deny,0,1,Known Attack
40471,80,40471,80,1917,1468,449,10,20,6,4,allow,1,0,Potential Threat
49217,53,30696,53,282,93,189,4,45,2,2,allow,0,0,Normal
60248,30188,0,0,62,62,0,1,0,1,0,deny,0,1,Known Attack
49396,80,45610,80,13738839,196158,13542681,11272,248,2231,9041,allow,1,0,Potential Threat
64992,53,56297,53,177,94,83,2,30,1,1,allow,0,0,Normal
64847,22114,0,0,66,66,0,1,0,1,0,deny,0,1,Known Attack
61279,443,45971,443,4076,1378,2698,14,136,7,7,allow,1,0,Potential Threat
55354,53,26809,53,212,108,104,2,31,1,1,allow,0,0,Normal
49347,443,51852,443,611644,29314,582330,793,132,333,460,allow,1,0,Potential Threat
50286,443,3120,443,8773,1538,7235,25,15,14,11,allow,1,0,Potential Threat
53292,445,0,0,70,70,0,1,0,1,0,drop,0,1,Known Attack
42298,51408,45869,51408,725,325,400,12,31,6,6,allow,1,0,Potential Threat
54194,445,0,0,70,70,0,1,0,1,0,drop,0,1,Known Attack
50113,51505,0,0,66,66,0,1,0,1,0,deny,0,1,Known Attack
7686,25174,0,0,62,62,0,1,0,1,0,deny,1,1,High Risk
65250,22114,0,0,66,66,0,1,0,1,0,deny,0,1,Known Attack
44928,443,35200,443,9345,2224,7121,40,112,22,18,allow,1,0,Potential Threat
54005,443,23305,443,4253,726,3527,13,15,7,6,allow,0,0,Normal
50949,445,0,0,70,70,0,1,0,1,0,drop,0,1,Known Attack
50981,443,28253,443,8407,3736,4671,19,101,11,8,allow,1,0,Potential Threat
60213,445,0,0,70,70,0,1,0,1,0,drop,0,1,Known Attack
62381,445,0,0,66,66,0,1,0,1,0,drop,0,1,Known Attack
50488,22114,0,0,66,66,0,1,0,1,0,deny,0,1,Known Attack
41694,26296,0,0,145,145,0,1,0,1,0,deny,1,1,High Risk
50194,443,13497,443,50338,5239,45099,54,165,19,35,allow,1,0,Potential Threat
53160,39001,22070,39001,70,70,0,2,8,2,0,allow,1,0,Potential Threat
61550,5529,0,0,145,145,0,1,0,1,0,deny,0,1,Known Attack
56428,30317,0,0,66,66,0,1,0,1,0,deny,0,1,Known Attack
50574,80,15293,80,61763,2941,58822,75,135,33,42,allow,1,0,Potential Threat
57479,56205,0,0,66,66,0,1,0,1,0,deny,0,1,Known Attack
1811,35440,0,0,62,62,0,1,0,1,0,deny,1,1,High Risk
64080,443,11837,443,75064,64938,10126,147,277,71,76,allow,1,0,Potential Threat
55211,53,36249,53,183,94,89,2,30,1,1,allow,0,0,Normal
62250,23117,0,0,66,66,0,1,0,1,0,deny,0,1,Known Attack
63595,51050,0,0,66,66,0,1,0,1,0,deny,1,1,High Risk
10965,22114,0,0,146,146,0,1,0,1,0,deny,1,1,High Risk
20706,23718,0,0,66,66,0,1,0,1,0,deny,0,1,Known Attack
53322,445,0,0,70,70,0,1,0,1,0,drop,0,1,Known Attack
52056,50328,41814,50328,70,70,0,1,4,1,0,allow,1,0,Potential Threat
17010,57470,0,0,62,62,0,1,0,1,0,deny,1,1,High Risk
44258,25,0,0,74,74,0,1,0,1,0,deny,0,1,Known Attack
35078,443,18726,443,78,78,0,1,5,1,0,allow,0,0,Normal
56850,53,62960,53,763,101,662,2,31,1,1,allow,1,0,Potential Threat
49808,445,0,0,70,70,0,1,0,1,0,drop,0,1,Known Attack
29972,50584,0,0,62,62,0,1,0,1,0,deny,1,1,High Risk
9312,443,24938,443,4618,840,3778,16,26,9,7,allow,1,0,Potential Threat
49936,53,17708,53,168,94,74,2,30,1,1,allow,0,0,Normal
49767,53,3628,53,177,94,83,2,29,1,1,allow,0,0,Normal
60485,13314,55482,13314,70,70,0,1,5,1,0,allow,1,0,Potential Threat
50308,443,46748,443,44311,4535,39776,55,121,21,34,allow,1,0,Potential Threat
58638,5900,0,0,62,62,0,1,0,1,0,deny,0,1,Known Attack
56655,53,28955,53,168,86,82,2,29,1,1,allow,0,0,Normal
60793,53733,0,0,66,66,0,1,0,1,0,deny,1,1,High Risk
51652,445,0,0,70,70,0,1,0,1,0,drop,0,1,Known Attack
49704,80,31664,80,217502,6597,210905,211,109,62,149,allow,1,0,Potential Threat
64509,9571,0,0,62,62,0,1,0,1,0,deny,0,1,Known Attack
60475,443,52273,443,585392,18731,566661,623,119,209,414,allow,1,0,Potential Threat
49586,443,54181,443,5879,870,5009,18,53,9,9,allow,1,0,Potential Threat
59964,445,0,0,70,70,0,1,0,1,0,drop,0,1,Known Attack
50352,445,0,0,70,70,0,1,0,1,0,drop,0,1,Known Attack
54588,445,0,0,66,66,0,1,0,1,0,drop,0,1,Known Attack
49603,80,3315,80,378,192,186,7,41,4,3,allow,0,0,Normal
58638,5900,0,0,62,62,0,1,0,1,0,deny,0,1,Known Attack
53419,28189,0,0,60,60,0,1,0,1,0,deny,0,1,Known Attack
1045,36237,0,0,62,62,0,1,0,1,0,deny,1,1,High Risk
55688,53,29682,53,183,94,89,2,31,1,1,allow,0,0,Normal
56953,80,31471,80,37311,3340,33971,52,65,26,26,allow,1,0,Potential Threat
52998,445,0,0,70,70,0,1,0,1,0,drop,0,1,Known Attack
63895,43729,7105,43729,70,70,0,1,4,1,0,allow,1,0,Potential Threat
20743,23,0,0,60,60,0,1,0,1,0,deny,0,1,Known Attack
65249,25864,0,0,72,72,0,1,0,1,0,deny,0,1,Known Attack
53245,443,1855,443,28206,2737,25469,45,323,18,27,allow,1,0,Potential Threat
53801,47933,40487,47933,320,140,180,6,6,3,3,allow,1,0,Potential Threat
51443,443,10966,443,1048,1048,0,9,16,9,0,allow,1,0,Potential Threat
56414,53,33736,53,178,94,84,2,31,1,1,allow,0,0,Normal
62423,445,0,0,66,66,0,1,0,1,0,drop,0,1,Known Attack
10701,11392,0,0,62,62,0,1,0,1,0,deny,0,1,Known Attack
18116,37807,0,0,66,66,0,1,0,1,0,deny,1,1,High Risk
57018,53,4073,53,209,110,99,2,30,1,1,allow,0,0,Normal
2886,35440,0,0,66,66,0,1,0,1,0,deny,1,1,High Risk
64444,53,59792,53,93,93,0,1,30,1,0,allow,1,0,Potential Threat
49484,7000,49484,7000,2958,1567,1391,15,15,8,7,allow,1,0,Potential Threat
6881,6881,26676,6881,238,118,120,2,1200,1,1,allow,1,0,Potential Threat
49348,53,24608,53,194,102,92,2,31,1,1,allow,0,0,Normal
65516,53,26116,53,202,103,99,2,31,1,1,allow,0,0,Normal
61394,445,0,0,66,66,0,1,0,1,0,drop,0,1,Known Attack
49671,53,50695,53,335,117,218,4,36,2,2,allow,0,0,Normal
34305,80,22535,80,2443,1794,649,11,76,6,5,allow,1,0,Potential Threat
37738,443,1957,443,6470,1931,4539,27,32,14,13,allow,1,0,Potential Threat
55616,42929,18894,42929,70,70,0,2,8,2,0,allow,1,0,Potential Threat
53539,44847,0,0,66,66,0,1,0,1,0,deny,0,1,Known Attack
64276,445,0,0,66,66,0,1,0,1,0,drop,0,1,Known Attack
42722,56448,0,0,70,70,0,1,0,1,0,deny,0,1,Known Attack
53305,50584,0,0,66,66,0,1,0,1,0,deny,0,1,Known Attack
31281,57470,0,0,145,145,0,1,0,1,0,deny,1,1,High Risk
54579,445,0,0,70,70,0,1,0,1,0,drop,0,1,Known Attack
62288,445,0,0,66,66,0,1,0,1,0,drop,0,1,Known Attack
50789,445,0,0,70,70,0,1,0,1,0,drop,0,1,Known Attack
20741,64147,0,0,62,62,0,1,0,1,0,deny,1,1,High Risk
58455,445,0,0,66,66,0,1,0,1,0,drop,0,1,Known Attack
55704,53,62671,53,193,102,91,2,30,1,1,allow,0,0,Normal
58632,445,0,0,70,70,0,1,0,1,0,drop,0,1,Known Attack
59486,443,24695,443,9161,2202,6959,28,374,14,14,allow,1,0,Potential Threat
53211,22114,0,0,66,66,0,1,0,1,0,deny,0,1,Known Attack
55582,445,0,0,70,70,0,1,0,1,0,drop,0,1,Known Attack
50399,445,0,0,70,70,0,1,0,1,0,drop,0,1,Known Attack
60825,445,0,0,70,70,0,1,0,1,0,drop,0,1,Known Attack
38645,51221,0,0,62,62,0,1,0,1,0,deny,0,1,Known Attack
49343,445,0,0,66,66,0,1,0,1,0,drop,0,1,Known Attack
43460,80,58949,80,23394,1667,21727,38,18,20,18,allow,1,0,Potential Threat
63811,443,59225,443,25707,7559,18148,53,121,24,29,allow,1,0,Potential Threat
55931,53,41701,53,294,118,176,2,29,1,1,allow,0,0,Normal
49923,443,51816,443,466,392,74,4,1,3,1,allow,0,0,Normal
60232,443,3016,443,1868,1229,639,18,151,11,7,allow,1,0,Potential Threat
50071,53,62204,53,458,188,270,6,30,3,3,allow,1,0,Potential Threat
56089,445,0,0,70,70,0,1,0,1,0,drop,0,1,Known Attack
52361,53,7907,53,186,78,108,2,29,1,1,allow,0,0,Normal
51859,7700,19893,7700,8425,6015,2410,73,34,37,36,allow,1,0,Potential Threat
45184,5228,38008,5228,9107,2358,6749,24,3600,13,11,allow,1,0,Potential Threat
55236,445,0,0,70,70,0,1,0,1,0,drop,0,1,Known Attack
60304,445,0,0,66,66,0,1,0,1,0,drop,0,1,Known Attack
42811,80,59018,80,1114,534,580,12,16,7,5,allow,1,0,Potential Threat
56432,35253,0,0,66,66,0,1,0,1,0,deny,0,1,Known Attack
50907,80,50964,80,16037318,218904,15818414,13595,136,2976,10619,allow,1,0,Potential Threat
65497,53,55657,53,197,102,95,2,29,1,1,allow,0,0,Normal
65176,445,0,0,66,66,0,1,0,1,0,drop,0,1,Known Attack
58207,51505,0,0,66,66,0,1,0,1,0,deny,0,1,Known Attack
44154,22114,0,0,62,62,0,1,0,1,0,deny,0,1,Known Attack
49937,443,1883,443,240,240,0,5,338,5,0,allow,1,0,Potential Threat
55955,445,0,0,66,66,0,1,0,1,0,drop,0,1,Known Attack
50905,443,13622,443,124,64,60,2,15,1,1,allow,0,0,Normal
59690,445,0,0,66,66,0,1,0,1,0,drop,0,1,Known Attack
60527,445,0,0,70,70,0,1,0,1,0,drop,0,1,Known Attack
58895,445,0,0,66,66,0,1,0,1,0,drop,0,1,Known Attack
21750,39004,0,0,66,66,0,1,0,1,0,deny,1,1,High Risk
57400,445,0,0,66,66,0,1,0,1,0,drop,0,1,Known Attack
51518,443,15866,443,38155,33545,4610,79,26,42,37,allow,1,0,Potential Threat
65353,53,55498,53,351,105,246,4,57,2,2,allow,0,0,Normal
49954,445,0,0,66,66,0,1,0,1,0,drop,0,1,Known Attack
56711,445,0,0,66,66,0,1,0,1,0,drop,0,1,Known Attack
54438,62413,0,0,66,66,0,1,0,1,0,deny,1,1,High Risk
64314,445,0,0,70,70,0,1,0,1,0,drop,0,1,Known Attack
24270,53,24270,53,825,99,726,2,30,1,1,allow,1,0,Potential Threat
64841,53,24677,53,165,86,79,2,30,1,1,allow,0,0,Normal
57782,445,0,0,66,66,0,1,0,1,0,drop,0,1,Known Attack
50450,53,9173,53,209,110,99,2,30,1,1,allow,0,0,Normal
55542,53,5269,53,711,87,624,2,31,1,1,allow,0,0,Normal
57292,445,0,0,66,66,0,1,0,1,0,drop,0,1,Known Attack
60413,443,19866,443,9398,2320,7078,24,77,13,11,allow,1,0,Potential Threat
64406,25174,0,0,66,66,0,1,0,1,0,deny,0,1,Known Attack
46315,443,19188,443,5571,2240,3331,28,87,14,14,allow,1,0,Potential Threat
58023,47808,0,0,60,60,0,1,0,1,0,deny,0,1,Known Attack
56177,445,0,0,66,66,0,1,0,1,0,drop,0,1,Known Attack
3376,35440,0,0,66,66,0,1,0,1,0,deny,1,1,High Risk
11878,37807,0,0,62,62,0,1,0,1,0,deny,1,1,High Risk
32381,50584,0,0,66,66,0,1,0,1,0,deny,1,1,High Risk
19394,44847,0,0,62,62,0,1,0,1,0,deny,1,1,High Risk
2849,30188,0,0,62,62,0,1,0,1,0,deny,1,1,High Risk
46053,443,15914,443,6999,1563,5436,18,186,3,15,allow,1,0,Potential Threat
53353,26467,0,0,62,62,0,1,0,1,0,deny,0,1,Known Attack
57269,53,5905,53,183,94,89,2,30,1,1,allow,0,0,Normal
5664,36237,0,0,62,62,0,1,0,1,0,deny,1,1,High Risk
11228,25174,0,0,66,66,0,1,0,1,0,deny,0,1,Known Attack
65487,53,2041,53,210,110,100,2,29,1,1,allow,0,0,Normal
61435,445,0,0,70,70,0,1,0,1,0,drop,0,1,Known Attack
58638,5900,0,0,62,62,0,1,0,1,0,deny,0,1,Known Attack
57169,53,44732,53,170,87,83,2,30,1,1,allow,0,0,Normal
5729,22114,0,0,66,66,0,1,0,1,0,deny,1,1,High Risk
40403,53,40667,53,199,94,105,2,30,1,1,allow,0,0,Normal
65318,53,17829,53,184,94,90,2,31,1,1,allow,0,0,Normal
59046,443,4447,443,8279,2876,5403,22,155,9,13,allow,1,0,Potential Threat
56386,53,9835,53,177,94,83,2,31,1,1,allow,0,0,Normal
53830,445,0,0,70,70,0,1,0,1,0,drop,0,1,Known Attack
56336,53,36932,53,198,93,105,2,30,1,1,allow,0,0,Normal
63930,443,21272,443,2940,669,2271,13,122,6,7,allow,1,0,Potential Threat
50584,443,50316,443,36457,2308,34149,52,98,23,29,allow,1,0,Potential Threat
59660,445,0,0,66,66,0,1,0,1,0,drop,0,1,Known Attack
46349,51505,0,0,74,74,0,1,0,1,0,deny,1,1,High Risk
50975,445,0,0,66,66,0,1,0,1,0,drop,0,1,Known Attack
50523,53,46429,53,376,78,298,2,31,1,1,allow,0,0,Normal
64884,53,27376,53,195,102,93,2,31,1,1,allow,0,0,Normal
49418,27025,19302,27025,71,71,0,1,30,1,0,allow,1,0,Potential Threat
57990,445,0,0,70,70,0,1,0,1,0,drop,0,1,Known Attack
60617,445,0,0,70,70,0,1,0,1,0,drop,0,1,Known Attack
34245,443,35232,443,11441,6765,4676,40,792,19,21,allow,1,0,Potential Threat
7912,35440,0,0,146,146,0,1,0,1,0,deny,1,1,High Risk
52043,80,36469,80,4185,3462,723,14,15,7,7,allow,1,0,Potential Threat
10169,80,10169,80,450,246,204,8,24,5,3,allow,1,0,Potential Threat
58747,443,20889,443,5167,700,4467,16,15,7,9,allow,1,0,Potential Threat
57598,443,10245,443,12463,6762,5701,28,31,14,14,allow,1,0,Potential Threat
51233,43890,0,0,66,66,0,1,0,1,0,deny,0,1,Known Attack
55075,8080,0,0,60,60,0,1,0,1,0,deny,0,1,Known Attack
51609,37807,0,0,66,66,0,1,0,1,0,deny,0,1,Known Attack
58398,44847,0,0,66,66,0,1,0,1,0,deny,0,1,Known Attack
53255,445,0,0,70,70,0,1,0,1,0,drop,0,1,Known Attack
54931,445,0,0,70,70,0,1,0,1,0,drop,0,1,Known Attack
60380,55125,53805,55125,70,70,0,2,8,2,0,allow,1,0,Potential Threat
56869,445,0,0,70,70,0,1,0,1,0,drop,0,1,Known Attack
58638,5900,0,0,62,62,0,1,0,1,0,deny,0,1,Known Attack
57132,53,36267,53,177,94,83,2,30,1,1,allow,0,0,Normal
53792,1,64543,1,70,70,0,1,4,1,0,allow,1,0,Potential Threat
56387,53,17582,53,183,94,89,2,30,1,1,allow,0,0,Normal
64872,445,0,0,70,70,0,1,0,1,0,drop,0,1,Known Attack
50000,53,16568,53,502,115,387,4,52,2,2,allow,0,0,Normal
56827,53,56181,53,195,102,93,2,30,1,1,allow,0,0,Normal
53064,443,10926,443,8095,2586,5509,38,90,19,19,allow,1,0,Potential Threat
56233,80,56233,80,44955,1023,43932,48,15,15,33,allow,1,0,Potential Threat
41648,56205,0,0,66,66,0,1,0,1,0,deny,0,1,Known Attack
56289,25174,0,0,66,66,0,1,0,1,0,deny,0,1,Known Attack
55576,445,0,0,66,66,0,1,0,1,0,drop,0,1,Known Attack
49899,443,6307,443,1820,1101,719,18,72,10,8,allow,1,0,Potential Threat
32806,7275,35238,7275,130,70,60,2,15,1,1,allow,1,0,Potential Threat
58794,443,62373,443,5166,700,4466,16,15,7,9,allow,1,0,Potential Threat
56177,53,3037,53,807,94,713,2,31,1,1,allow,0,0,Normal
51847,32112,38487,32112,70,70,0,2,9,2,0,allow,1,0,Potential Threat
55146,1433,0,0,60,60,0,1,0,1,0,deny,0,1,Known Attack
50633,80,7997,80,1717,1247,470,9,15,5,4,allow,1,0,Potential Threat
60302,443,30801,443,39850,4375,35475,73,80,31,42,allow,1,0,Potential Threat
56111,53,53180,53,174,89,85,2,31,1,1,allow,0,0,Normal
58226,52848,0,0,62,62,0,1,0,1,0,deny,0,1,Known Attack
52729,443,62575,443,9026,3447,5579,50,45,26,24,allow,1,0,Potential Threat
60527,35440,0,0,66,66,0,1,0,1,0,deny,0,1,Known Attack
53146,443,41053,443,29874004,955051,28918953,31844,303,10580,21264,allow,1,0,Potential Threat
50107,53,50107,53,216,89,127,2,30,1,1,allow,0,0,Normal
49379,53,24029,53,199,102,97,2,30,1,1,allow,0,0,Normal
49724,53,16397,53,183,94,89,2,30,1,1,allow,0,0,Normal
58799,445,0,0,70,70,0,1,0,1,0,drop,0,1,Known Attack
58685,445,0,0,66,66,0,1,0,1,0,drop,0,1,Known Attack
52607,445,0,0,70,70,0,1,0,1,0,drop,0,1,Known Attack
57203,53,26707,53,199,102,97,2,30,1,1,allow,0,0,Normal
6929,35440,0,0,66,66,0,1,0,1,0,deny,1,1,High Risk
49798,53,59765,53,365,97,268,4,40,2,2,allow,0,0,Normal
41502,443,22197,443,1053,566,487,10,48,6,4,allow,0,0,Normal
52336,64097,0,0,66,66,0,1,0,1,0,deny,1,1,High Risk
56639,53,16587,53,168,86,82,2,36,1,1,allow,0,0,Normal
35201,443,64123,443,291,171,120,4,15,2,2,allow,1,0,Potential Threat
65422,443,52517,443,2494,1643,851,17,23,9,8,allow,1,0,Potential Threat
64835,53,33008,53,200,102,98,2,29,1,1,allow,0,0,Normal
49044,443,55687,443,5150,853,4297,16,27,9,7,allow,1,0,Potential Threat
60417,445,0,0,66,66,0,1,0,1,0,drop,0,1,Known Attack
52874,443,59388,443,392514,41757,350757,626,118,209,417,allow,1,0,Potential Threat
55095,445,0,0,70,70,0,1,0,1,0,drop,0,1,Known Attack
50390,443,34358,443,1328,876,452,11,29,6,5,allow,0,0,Normal
56673,445,0,0,70,70,0,1,0,1,0,drop,0,1,Known Attack
49972,53,55153,53,216,110,106,2,30,1,1,allow,0,0,Normal
29139,64147,0,0,62,62,0,1,0,1,0,deny,1,1,High Risk
56272,53,1689,53,167,86,81,2,30,1,1,allow,0,0,Normal
55726,27015,8012,27015,628,462,166,4,31,2,2,allow,1,0,Potential Threat
64882,53,29551,53,230,102,128,2,29,1,1,allow,0,0,Normal
59815,443,31852,443,4586,955,3631,17,28,9,8,allow,1,0,Potential Threat
57545,35440,0,0,66,66,0,1,0,1,0,deny,0,1,Known Attack
64837,53,23710,53,196,94,102,2,30,1,1,allow,0,0,Normal
54525,445,0,0,66,66,0,1,0,1,0,drop,0,1,Known Attack
53811,443,28685,443,499,425,74,4,0,3,1,allow,0,0,Normal
62870,445,0,0,66,66,0,1,0,1,0,drop,0,1,Known Attack
56047,443,45831,443,126,60,66,3,4,2,1,allow,0,0,Normal
64359,53,44275,53,196,102,94,2,30,1,1,allow,0,0,Normal
12531,22114,0,0,146,146,0,1,0,1,0,deny,1,1,High Risk
49196,25174,0,0,66,66,0,1,0,1,0,deny,0,1,Known Attack
63933,443,50085,443,6822,3370,3452,21,135,10,11,allow,1,0,Potential Threat
42298,40015,12335,40015,140,78,62,2,31,1,1,allow,1,0,Potential Threat
60593,80,31498,80,123436,6053,117383,165,241,83,82,allow,1,0,Potential Threat
64353,445,0,0,70,70,0,1,0,1,0,drop,0,1,Known Attack
49257,53,51275,53,166,86,80,2,29,1,1,allow,0,0,Normal
2323,23117,0,0,146,146,0,1,0,1,0,deny,1,1,High Risk
56310,445,0,0,70,70,0,1,0,1,0,drop,0,1,Known Attack
56331,443,61535,443,1786,172,1614,7,121,3,4,allow,1,0,Potential Threat
50669,443,37355,443,12463,2350,10113,46,20,19,27,allow,1,0,Potential Threat
4752,30188,0,0,62,62,0,1,0,1,0,deny,1,1,High Risk
49202,80,38617,80,3223,605,2618,13,15,7,6,allow,1,0,Potential Threat
37576,443,21717,443,11777,4005,7772,35,44,15,20,allow,1,0,Potential Threat
57490,80,59652,80,1614,1300,314,10,15,5,5,allow,1,0,Potential Threat
64626,50584,0,0,62,62,0,1,0,1,0,deny,1,1,High Risk
61639,37965,0,0,66,66,0,1,0,1,0,deny,0,1,Known Attack
52461,443,54450,443,16541,4900,11641,62,131,26,36,allow,1,0,Potential Threat
55587,43890,0,0,66,66,0,1,0,1,0,deny,0,1,Known Attack
49760,80,15959,80,2113,1181,932,10,127,6,4,allow,1,0,Potential Threat
59663,37965,0,0,66,66,0,1,0,1,0,deny,0,1,Known Attack
65047,53,60656,53,184,102,82,2,30,1,1,allow,0,0,Normal
63818,19291,56455,19291,66,66,0,2,7,2,0,allow,1,0,Potential Threat
51918,443,34743,443,28031,11553,16478,122,108,61,61,allow,1,0,Potential Threat
50100,53,17377,53,734,94,640,2,30,1,1,allow,0,0,Normal
64929,53,16910,53,168,86,82,2,31,1,1,allow,0,0,Normal
58731,443,5711,443,2383,1460,923,18,201,10,8,allow,1,0,Potential Threat
64559,445,0,0,70,70,0,1,0,1,0,drop,0,1,Known Attack
61712,443,30612,443,7443,2692,4751,19,76,11,8,allow,1,0,Potential Threat
58079,50584,0,0,66,66,0,1,0,1,0,deny,0,1,Known Attack
49708,80,56764,80,179277,5324,173953,171,108,49,122,allow,1,0,Potential Threat
54394,445,0,0,66,66,0,1,0,1,0,drop,0,1,Known Attack
1036,64147,0,0,145,145,0,1,0,1,0,deny,1,1,High Risk
49418,27111,53348,27111,258,78,180,2,30,1,1,allow,1,0,Potential Threat
49981,44847,0,0,62,62,0,1,0,1,0,deny,0,1,Known Attack
58638,5900,0,0,62,62,0,1,0,1,0,deny,0,1,Known Attack
65462,53,18628,53,98,98,0,1,30,1,0,allow,0,0,Normal
51298,57470,0,0,66,66,0,1,0,1,0,deny,0,1,Known Attack
50137,53,54059,53,183,94,89,2,31,1,1,allow,0,0,Normal
56724,53,52473,53,195,102,93,2,30,1,1,allow,0,0,Normal
49326,53,31358,53,193,102,91,2,31,1,1,allow,0,0,Normal
64758,445,0,0,70,70,0,1,0,1,0,drop,0,1,Known Attack
55483,445,0,0,70,70,0,1,0,1,0,drop,0,1,Known Attack
62666,445,0,0,66,66,0,1,0,1,0,drop,0,1,Known Attack
55360,80,13495,80,130,70,60,2,15,1,1,allow,0,0,Normal
65115,50584,0,0,62,62,0,1,0,1,0,deny,1,1,High Risk
52158,3841,65016,3841,70,70,0,2,7,2,0,allow,1,0,Potential Threat
50445,445,0,0,70,70,0,1,0,1,0,drop,0,1,Known Attack
43063,57470,0,0,62,62,0,1,0,1,0,deny,0,1,Known Attack
57044,53,54820,53,177,94,83,2,31,1,1,allow,0,0,Normal
65238,53,22542,53,168,86,82,2,29,1,1,allow,0,0,Normal
30179,57470,0,0,60,60,0,1,0,1,0,deny,1,1,High Risk
443,35385,0,0,66,66,0,1,0,1,0,deny,1,1,High Risk
55046,53,59080,53,300,102,198,4,40,2,2,allow,0,0,Normal
65229,53,28081,53,195,102,93,2,30,1,1,allow,0,0,Normal
443,46569,0,0,66,66,0,1,0,1,0,deny,1,1,High Risk
58638,5900,0,0,62,62,0,1,0,1,0,deny,0,1,Known Attack
50884,443,50884,443,187790,7733,180057,229,128,90,139,allow,1,0,Potential Threat
61784,445,0,0,70,70,0,1,0,1,0,drop,0,1,Known Attack
57031,53,9800,53,170,87,83,2,31,1,1,allow,0,0,Normal
5588,5588,0,0,3354,1792,1562,46,194,23,23,allow,1,0,Potential Threat
51341,445,0,0,66,66,0,1,0,1,0,drop,0,1,Known Attack
64034,53,27312,53,194,102,92,2,30,1,1,allow,0,0,Normal
54653,445,0,0,66,66,0,1,0,1,0,drop,0,1,Known Attack
50470,61463,0,0,86,86,0,1,0,1,0,deny,1,1,High Risk
49394,443,40363,443,7129,1853,5276,27,316,13,14,allow,1,0,Potential Threat
53532,22114,0,0,62,62,0,1,0,1,0,deny,0,1,Known Attack
51438,445,0,0,66,66,0,1,0,1,0,drop,0,1,Known Attack
62779,445,0,0,70,70,0,1,0,1,0,drop,0,1,Known Attack
50265,33734,14802,33734,132,132,0,3,1200,3,0,allow,1,0,Potential Threat
58664,64147,0,0,66,66,0,1,0,1,0,deny,1,1,High Risk
49516,35894,0,0,62,62,0,1,0,1,0,deny,0,1,Known Attack
55935,445,0,0,70,70,0,1,0,1,0,drop,0,1,Known Attack
17873,23117,0,0,66,66,0,1,0,1,0,deny,0,1,Known Attack
27005,27015,4147,27015,869,126,743,2,30,1,1,allow,1,0,Potential Threat
56778,445,0,0,66,66,0,1,0,1,0,drop,0,1,Known Attack
53320,445,0,0,66,66,0,1,0,1,0,drop,0,1,Known Attack
56494,15503,0,0,146,146,0,1,0,1,0,deny,0,1,Known Attack
57689,445,0,0,70,70,0,1,0,1,0,drop,0,1,Known Attack
49212,80,1671,80,1013,566,447,8,134,5,3,allow,1,0,Potential Threat
34916,51185,0,0,62,62,0,1,0,1,0,deny,0,1,Known Attack
17004,64147,0,0,66,66,0,1,0,1,0,deny,1,1,High Risk
9092,26672,0,0,60,60,0,1,0,1,0,deny,1,1,High Risk
28121,443,57798,443,9075,2662,6413,34,462,16,18,allow,1,0,Potential Threat
62709,445,0,0,70,70,0,1,0,1,0,drop,0,1,Known Attack
36261,443,56856,443,1269784,41489,1228295,1339,37,478,861,allow,1,0,Potential Threat
64912,53,22829,53,258,102,156,2,30,1,1,allow,0,0,Normal
60386,9136,45378,9136,624,318,306,10,16,5,5,allow,1,0,Potential Threat
43112,443,57880,443,7192,1772,5420,25,305,13,12,allow,1,0,Potential Threat
55126,53,18152,53,193,102,91,2,30,1,1,allow,0,0,Normal
50013,445,0,0,70,70,0,1,0,1,0,drop,0,1,Known Attack
56827,53,43714,53,190,97,93,2,31,1,1,allow,0,0,Normal
64074,53,19017,53,209,110,99,2,30,1,1,allow,0,0,Normal
49706,53,34348,53,258,110,148,2,30,1,1,allow,0,0,Normal
53020,443,6371,443,3183,2180,1003,16,15,8,8,allow,1,0,Potential Threat
65304,53,22589,53,308,97,211,4,33,2,2,allow,0,0,Normal
41653,21247,0,0,62,62,0,1,0,1,0,deny,0,1,Known Attack
55059,80,26318,80,306,180,126,6,26,4,2,allow,0,0,Normal
56836,1,16144,1,130,70,60,2,5,1,1,allow,0,0,Normal
49996,53,6579,53,183,94,89,2,30,1,1,allow,0,0,Normal
52044,5824,26075,5824,70,70,0,1,5,1,0,allow,1,0,Potential Threat
49965,53,21038,53,285,110,175,2,30,1,1,allow,0,0,Normal
27005,27016,52333,27016,892,126,766,2,30,1,1,allow,1,0,Potential Threat
49679,53,54923,53,166,86,80,2,30,1,1,allow,0,0,Normal
53259,443,6892,443,5513,929,4584,20,360,10,10,allow,1,0,Potential Threat
53839,15000,61295,15000,130,70,60,2,5,1,1,allow,1,0,Potential Threat
57736,445,0,0,66,66,0,1,0,1,0,drop,0,1,Known Attack
51560,445,0,0,70,70,0,1,0,1,0,drop,0,1,Known Attack
50373,443,36496,443,4695,859,3836,17,30,9,8,allow,0,0,Normal
53756,443,48419,443,499,425,74,4,0,3,1,allow,0,0,Normal
49425,53,61081,53,772,102,670,2,30,1,1,allow,1,0,Potential Threat
65469,53,49560,53,195,102,93,2,30,1,1,allow,0,0,Normal
1847,64147,0,0,62,62,0,1,0,1,0,deny,1,1,High Risk
56381,51505,0,0,146,146,0,1,0,1,0,deny,1,1,High Risk
15605,50265,0,0,62,62,0,1,0,1,0,deny,1,1,High Risk
46162,25174,0,0,146,146,0,1,0,1,0,deny,1,1,High Risk
49301,443,5775,443,6550,1836,4714,25,46,15,10,allow,1,0,Potential Threat
21892,15503,0,0,62,62,0,1,0,1,0,deny,0,1,Known Attack
62363,445,0,0,66,66,0,1,0,1,0,drop,0,1,Known Attack
55890,445,0,0,70,70,0,1,0,1,0,drop,0,1,Known Attack
15180,26467,0,0,62,62,0,1,0,1,0,deny,0,1,Known Attack
33761,25174,0,0,62,62,0,1,0,1,0,deny,0,1,Known Attack
55867,53,60176,53,178,94,84,2,31,1,1,allow,0,0,Normal
57138,443,50278,443,498,210,288,8,26,4,4,allow,0,0,Normal
55012,25174,0,0,66,66,0,1,0,1,0,deny,0,1,Known Attack
58638,5900,0,0,62,62,0,1,0,1,0,deny,0,1,Known Attack
64588,53,18701,53,211,102,109,2,30,1,1,allow,0,0,Normal
33108,22,33108,22,7930,3351,4579,56,38,27,29,allow,1,0,Potential Threat
49384,53,28172,53,181,94,87,2,29,1,1,allow,0,0,Normal
60399,443,57774,443,8061,1926,6135,24,361,11,13,allow,1,0,Potential Threat
37672,443,48728,443,3338,2337,1001,18,45,11,7,allow,1,0,Potential Threat
62149,22114,0,0,66,66,0,1,0,1,0,deny,0,1,Known Attack
49907,443,59724,443,5895,728,5167,16,47,8,8,allow,1,0,Potential Threat
51830,443,51830,443,17899,5015,12884,33,36,14,19,allow,1,0,Potential Threat
56468,53,1634,53,180,94,86,2,30,1,1,allow,0,0,Normal
55461,53,35895,53,198,110,88,2,30,1,1,allow,0,0,Normal
56622,443,37505,443,3575,1079,2496,15,155,7,8,allow,1,0,Potential Threat
54164,445,0,0,66,66,0,1,0,1,0,drop,0,1,Known Attack
57470,53250,48963,53250,491,150,341,2,1199,1,1,allow,1,0,Potential Threat
21424,53,21424,53,225,90,135,2,29,1,1,allow,0,0,Normal
54105,443,23340,443,2227,1018,1209,17,16,8,9,allow,0,0,Normal
55556,53,12940,53,302,78,224,2,30,1,1,allow,0,0,Normal
34066,36829,0,0,146,146,0,1,0,1,0,deny,1,1,High Risk
49646,53,18495,53,199,102,97,2,30,1,1,allow,0,0,Normal
64502,53,56214,53,199,102,97,2,30,1,1,allow,0,0,Normal
57232,445,0,0,70,70,0,1,0,1,0,drop,0,1,Known Attack
123,123,4169,123,184,94,90,2,31,1,1,allow,1,0,Potential Threat
56964,53,51072,53,174,89,85,2,31,1,1,allow,0,0,Normal
53821,7788,19069,7788,70,70,0,2,8,2,0,allow,1,0,Potential Threat
62326,443,62326,443,1210,637,573,14,51,7,7,allow,1,0,Potential Threat
63631,443,40886,443,8640,5157,3483,17,120,10,7,allow,1,0,Potential Threat
50298,53,22376,53,172,94,78,2,30,1,1,allow,0,0,Normal
51977,18504,24364,18504,70,70,0,2,8,2,0,allow,1,0,Potential Threat
51667,443,62904,443,1203,703,500,14,42,8,6,allow,1,0,Potential Threat
10627,23117,0,0,62,62,0,1,0,1,0,deny,0,1,Known Attack
19875,30170,0,0,145,145,0,1,0,1,0,deny,1,1,High Risk
56266,53,65060,53,193,102,91,2,30,1,1,allow,1,0,Potential Threat
48817,32897,48817,32897,152,152,0,1,1200,1,0,allow,1,0,Potential Threat
52417,443,14213,443,8376,6877,1499,27,31,15,12,allow,1,0,Potential Threat
55955,53,39332,53,164,86,78,2,30,1,1,allow,0,0,Normal
6881,6881,0,0,62,62,0,1,0,1,0,deny,0,1,Known Attack
49923,445,0,0,70,70,0,1,0,1,0,drop,0,1,Known Attack
50006,53,41506,53,994,86,908,2,29,1,1,allow,0,0,Normal
61712,80,5502,80,1864,1024,840,10,16,6,4,allow,1,0,Potential Threat
56496,53,60823,53,186,95,91,2,30,1,1,allow,0,0,Normal
55657,443,55657,443,30650,11103,19547,66,51,40,26,allow,1,0,Potential Threat
57870,445,0,0,66,66,0,1,0,1,0,drop,0,1,Known Attack
55528,445,0,0,66,66,0,1,0,1,0,drop,0,1,Known Attack
57470,6881,10823,6881,132,132,0,3,1200,3,0,allow,1,0,Potential Threat
49366,443,23124,443,14668,3601,11067,34,19,19,15,allow,1,0,Potential Threat
65386,53,35268,53,197,102,95,2,33,1,1,allow,0,0,Normal
53663,80,16666,80,149148,7515,141633,197,20,95,102,allow,1,0,Potential Threat
62296,445,0,0,66,66,0,1,0,1,0,drop,0,1,Known Attack
49929,53,13431,53,260,124,136,2,31,1,1,allow,0,0,Normal
52144,49344,0,0,62,62,0,1,0,1,0,deny,0,1,Known Attack
50200,44847,0,0,74,74,0,1,0,1,0,deny,0,1,Known Attack
59324,445,0,0,66,66,0,1,0,1,0,drop,0,1,Known Attack
22240,22114,0,0,146,146,0,1,0,1,0,deny,1,1,High Risk
50168,53,56159,53,211,78,133,2,30,1,1,allow,0,0,Normal
19473,61397,60276,61397,323,150,173,2,1200,1,1,allow,1,0,Potential Threat
40356,9192,0,0,145,145,0,1,0,1,0,deny,0,1,Known Attack
26085,51221,0,0,72,72,0,1,0,1,0,deny,1,1,High Risk
1582,56205,0,0,62,62,0,1,0,1,0,deny,1,1,High Risk
55941,53,18127,53,184,94,90,2,30,1,1,allow,0,0,Normal
55283,445,0,0,70,70,0,1,0,1,0,drop,0,1,Known Attack
49933,53,6937,53,178,94,84,2,31,1,1,allow,0,0,Normal
53703,16426,38652,16426,70,70,0,1,4,1,0,allow,1,0,Potential Threat
44564,22,44564,22,5130,2103,3027,28,21,16,12,allow,1,0,Potential Threat
61477,57470,0,0,62,62,0,1,0,1,0,deny,1,1,High Risk
26054,80,26054,80,1798,540,1258,10,15,6,4,allow,1,0,Potential Threat
58638,5900,0,0,62,62,0,1,0,1,0,deny,0,1,Known Attack
52361,445,0,0,66,66,0,1,0,1,0,drop,0,1,Known Attack
47595,33436,0,0,106,106,0,1,60,1,0,allow,1,0,Potential Threat
51922,44847,0,0,62,62,0,1,0,1,0,deny,0,1,Known Attack
10090,443,45576,443,20612,7872,12740,57,643,21,36,allow,1,0,Potential Threat
53358,23,0,0,60,60,0,1,0,1,0,deny,0,1,Known Attack
18423,51505,0,0,66,66,0,1,0,1,0,deny,1,1,High Risk
36781,443,37104,443,1798,1223,575,13,26,8,5,allow,1,0,Potential Threat
56015,53,29304,53,195,102,93,2,30,1,1,allow,0,0,Normal
54642,445,0,0,70,70,0,1,0,1,0,drop,0,1,Known Attack
44496,57470,0,0,66,66,0,1,0,1,0,deny,0,1,Known Attack
57131,35776,0,0,145,145,0,1,0,1,0,deny,1,1,High Risk
50808,445,0,0,66,66,0,1,0,1,0,drop,0,1,Known Attack
64340,53,64340,53,847,110,737,2,30,1,1,allow,1,0,Potential Threat
55097,53,14648,53,177,94,83,2,29,1,1,allow,0,0,Normal
55069,44847,0,0,66,66,0,1,0,1,0,deny,0,1,Known Attack
52221,33166,38901,33166,66,66,0,1,5,1,0,allow,1,0,Potential Threat
52265,32078,35097,32078,70,70,0,2,7,2,0,allow,1,0,Potential Threat
53513,445,0,0,70,70,0,1,0,1,0,drop,0,1,Known Attack
58638,5900,0,0,62,62,0,1,0,1,0,deny,0,1,Known Attack
59884,443,34275,443,1401,864,537,12,28,6,6,allow,1,0,Potential Threat
65385,53,41370,53,259,110,149,2,30,1,1,allow,0,0,Normal
54011,44847,0,0,66,66,0,1,0,1,0,deny,0,1,Known Attack
52049,52557,23041,52557,70,70,0,1,5,1,0,allow,1,0,Potential Threat
54280,3398,0,0,60,60,0,1,0,1,0,deny,0,1,Known Attack
61723,445,0,0,70,70,0,1,0,1,0,drop,0,1,Known Attack
55651,445,0,0,70,70,0,1,0,1,0,drop,0,1,Known Attack
62424,37965,0,0,62,62,0,1,0,1,0,deny,0,1,Known Attack
1024,48817,0,0,145,145,0,1,0,1,0,deny,1,1,High Risk
55199,445,0,0,70,70,0,1,0,1,0,drop,0,1,Known Attack
8560,50584,0,0,66,66,0,1,0,1,0,deny,1,1,High Risk
27005,1106,55769,1106,903,126,777,2,30,1,1,allow,1,0,Potential Threat
53775,8999,38559,8999,320,140,180,6,5,3,3,allow,1,0,Potential Threat
37965,1,53190,1,330,330,0,6,1199,6,0,allow,1,0,Potential Threat
49835,53,19938,53,194,102,92,2,30,1,1,allow,0,0,Normal
52136,42939,50885,42939,70,70,0,2,8,2,0,allow,1,0,Potential Threat
6943,59353,0,0,100,100,0,1,0,1,0,deny,1,1,High Risk
63924,26328,47247,26328,70,70,0,1,4,1,0,allow,1,0,Potential Threat
65393,445,0,0,66,66,0,1,0,1,0,drop,0,1,Known Attack
55529,445,0,0,66,66,0,1,0,1,0,drop,0,1,Known Attack
43744,53,43744,53,235,90,145,2,32,1,1,allow,0,0,Normal
55491,445,0,0,70,70,0,1,0,1,0,drop,0,1,Known Attack
56127,37965,0,0,66,66,0,1,0,1,0,deny,0,1,Known Attack
50095,445,0,0,70,70,0,1,0,1,0,drop,0,1,Known Attack
39661,53733,0,0,146,146,0,1,0,1,0,deny,1,1,High Risk
57343,53,32639,53,181,94,87,2,31,1,1,allow,0,0,Normal
64171,53,17588,53,179,94,85,2,30,1,1,allow,0,0,Normal
50265,65535,43978,65535,222,132,90,4,1210,3,1,allow,1,0,Potential Threat
49944,53,20178,53,192,98,94,2,31,1,1,allow,0,0,Normal
5617,64147,0,0,62,62,0,1,0,1,0,deny,1,1,High Risk
55893,45711,0,0,78,78,0,1,0,1,0,deny,0,1,Known Attack
50901,26467,0,0,66,66,0,1,0,1,0,deny,0,1,Known Attack
57470,44573,53035,44573,883,288,595,4,1200,2,2,allow,1,0,Potential Threat
52549,445,0,0,70,70,0,1,0,1,0,drop,0,1,Known Attack
55306,53,44864,53,177,94,83,2,31,1,1,allow,0,0,Normal
57741,445,0,0,70,70,0,1,0,1,0,drop,0,1,Known Attack
49253,53,58276,53,199,102,97,2,30,1,1,allow,0,0,Normal
56014,445,0,0,70,70,0,1,0,1,0,drop,0,1,Known Attack
49449,80,5830,80,1948,912,1036,13,56,7,6,allow,1,0,Potential Threat
48941,443,53829,443,10085,3487,6598,21,120,9,12,allow,1,0,Potential Threat
51936,17650,3009,17650,70,70,0,2,8,2,0,allow,1,0,Potential Threat
55746,53,54887,53,216,110,106,2,30,1,1,allow,0,0,Normal
56609,53,56720,53,198,101,97,2,30,1,1,allow,0,0,Normal
51414,22,0,0,60,60,0,1,0,1,0,deny,0,1,Known Attack
52985,80,52009,80,3111,1364,1747,28,112,15,13,allow,1,0,Potential Threat
443,62732,0,0,332,332,0,1,0,1,0,deny,1,1,High Risk
61308,443,22375,443,44341,5858,38483,102,195,42,60,allow,1,0,Potential Threat
57025,53,16250,53,168,86,82,2,30,1,1,allow,0,0,Normal
27005,26259,57804,26259,889,126,763,2,31,1,1,allow,1,0,Potential Threat
38384,443,38384,443,4609,1702,2907,19,29,11,8,allow,1,0,Potential Threat
57775,445,0,0,70,70,0,1,0,1,0,drop,0,1,Known Attack
49521,443,49521,443,25081,3001,22080,55,75,29,26,allow,1,0,Potential Threat
123,123,34455,123,184,94,90,2,30,1,1,allow,1,0,Potential Threat
49777,53,52771,53,216,110,106,2,30,1,1,allow,0,0,Normal
1024,57470,0,0,72,72,0,1,0,1,0,deny,1,1,High Risk
58193,445,0,0,66,66,0,1,0,1,0,drop,0,1,Known Attack
64685,53,55702,53,193,102,91,2,30,1,1,allow,0,0,Normal
49679,445,0,0,70,70,0,1,0,1,0,drop,0,1,Known Attack
52749,64147,0,0,66,66,0,1,0,1,0,deny,1,1,High Risk
55611,58049,54667,58049,504,318,186,8,15,5,3,allow,1,0,Potential Threat
52900,445,0,0,70,70,0,1,0,1,0,drop,0,1,Known Attack
51417,443,60924,443,25865,7151,18714,36,15,19,17,allow,1,0,Potential Threat
9544,11392,0,0,62,62,0,1,0,1,0,deny,0,1,Known Attack
56621,50584,0,0,62,62,0,1,0,1,0,deny,0,1,Known Attack
64643,443,21220,443,3433,1192,2241,13,136,6,7,allow,1,0,Potential Threat
58700,443,30626,443,8124,1079,7045,16,26,8,8,allow,1,0,Potential Threat
23131,25174,0,0,62,62,0,1,0,1,0,deny,0,1,Known Attack
51959,42269,57888,42269,70,70,0,2,8,2,0,allow,1,0,Potential Threat
59623,161,0,0,11212,5520,5692,58,30,29,29,allow,1,0,Potential Threat
42960,443,37505,443,5057,2448,2609,27,544,12,15,allow,1,0,Potential Threat
40687,64147,0,0,62,62,0,1,0,1,0,deny,1,1,High Risk
64751,53,29777,53,172,88,84,2,30,1,1,allow,0,0,Normal
60504,445,0,0,70,70,0,1,0,1,0,drop,0,1,Known Attack
56546,53,1301,53,177,94,83,2,30,1,1,allow,0,0,Normal
65494,443,61063,443,92044,4379,87665,102,16,37,65,allow,1,0,Potential Threat
51085,56205,0,0,66,66,0,1,0,1,0,deny,0,1,Known Attack
55893,45711,0,0,78,78,0,1,0,1,0,deny,0,1,Known Attack
10850,53,10850,53,237,91,146,2,34,1,1,allow,1,0,Potential Threat
55962,53,39113,53,186,95,91,2,31,1,1,allow,0,0,Normal
64820,53,31810,53,195,102,93,2,30,1,1,allow,0,0,Normal
62025,445,0,0,70,70,0,1,0,1,0,drop,0,1,Known Attack
57944,80,62722,80,1718,1404,314,11,15,6,5,allow,1,0,Potential Threat
64287,53,53632,53,181,94,87,2,30,1,1,allow,0,0,Normal
51028,445,0,0,70,70,0,1,0,1,0,drop,0,1,Known Attack
58317,445,0,0,70,70,0,1,0,1,0,drop,0,1,Known Attack
34059,80,37168,80,1151,711,440,10,15,5,5,allow,1,0,Potential Threat
59931,80,27664,80,1272,786,486,8,31,5,3,allow,1,0,Potential Threat
53120,445,0,0,70,70,0,1,0,1,0,drop,0,1,Known Attack
64321,53,31319,53,190,97,93,2,31,1,1,allow,0,0,Normal
61257,445,0,0,70,70,0,1,0,1,0,drop,0,1,Known Attack
59096,57866,0,0,62,62,0,1,0,1,0,deny,1,1,High Risk
55206,443,55206,443,18965,2061,16904,35,17,18,17,allow,1,0,Potential Threat
47652,51505,0,0,62,62,0,1,0,1,0,deny,0,1,Known Attack
62172,445,0,0,70,70,0,1,0,1,0,drop,0,1,Known Attack
52829,80,23872,80,2078,726,1352,10,15,5,5,allow,0,0,Normal
55571,445,0,0,70,70,0,1,0,1,0,drop,0,1,Known Attack
64968,53,21697,53,250,102,148,2,31,1,1,allow,0,0,Normal
56651,80,31520,80,11855,7269,4586,28,115,15,13,allow,1,0,Potential Threat
64854,53,60425,53,178,94,84,2,30,1,1,allow,0,0,Normal
50270,445,0,0,70,70,0,1,0,1,0,drop,0,1,Known Attack
51244,445,0,0,70,70,0,1,0,1,0,drop,0,1,Known Attack
54361,445,0,0,70,70,0,1,0,1,0,drop,0,1,Known Attack
57204,53,13761,53,183,94,89,2,30,1,1,allow,0,0,Normal
60646,11392,0,0,66,66,0,1,0,1,0,deny,0,1,Known Attack
50007,445,0,0,70,70,0,1,0,1,0,drop,0,1,Known Attack
49779,445,0,0,66,66,0,1,0,1,0,drop,0,1,Known Attack
58395,445,0,0,70,70,0,1,0,1,0,drop,0,1,Known Attack
7176,53,7176,53,233,91,142,2,31,1,1,allow,1,0,Potential Threat
51988,53,22023,53,78,78,0,1,30,1,0,allow,0,0,Normal
49349,443,17096,443,5282,1090,4192,17,25,10,7,allow,1,0,Potential Threat
64306,445,0,0,70,70,0,1,0,1,0,drop,0,1,Known Attack
64517,53,41461,53,211,102,109,2,30,1,1,allow,0,0,Normal
55031,445,0,0,70,70,0,1,0,1,0,drop,0,1,Known Attack
20544,5223,0,0,148,148,0,1,0,1,0,deny,1,1,High Risk
9412,7302,0,0,62,62,0,1,0,1,0,deny,0,1,Known Attack
54972,80,43170,80,1074,691,383,12,66,7,5,allow,0,0,Normal
49456,53,39013,53,198,101,97,2,31,1,1,allow,0,0,Normal
44252,443,6888,443,14455,6007,8448,45,120,26,19,allow,1,0,Potential Threat
15164,53,15164,53,217,82,135,2,31,1,1,allow,0,0,Normal
62062,443,21250,443,134,60,74,3,5,2,1,allow,0,0,Normal
48817,38081,48817,38081,863,363,500,4,1200,2,2,allow,1,0,Potential Threat
63965,11785,30846,11785,66,66,0,1,5,1,0,allow,1,0,Potential Threat
56782,53,60829,53,227,94,133,2,29,1,1,allow,0,0,Normal
49774,53,5014,53,236,94,142,2,30,1,1,allow,0,0,Normal
49782,53,28643,53,228,86,142,2,30,1,1,allow,0,0,Normal
58638,5900,0,0,62,62,0,1,0,1,0,deny,0,1,Known Attack
58942,443,33385,443,5168,700,4468,16,15,7,9,allow,1,0,Potential Threat
49908,445,0,0,70,70,0,1,0,1,0,drop,0,1,Known Attack
42567,80,40138,80,2161,1178,983,16,17,10,6,allow,1,0,Potential Threat
65035,53,56043,53,234,102,132,2,30,1,1,allow,0,0,Normal
63660,445,0,0,70,70,0,1,0,1,0,drop,0,1,Known Attack
58131,15503,0,0,146,146,0,1,0,1,0,deny,0,1,Known Attack
57925,445,0,0,70,70,0,1,0,1,0,drop,0,1,Known Attack
27005,27017,53290,27017,881,126,755,2,31,1,1,allow,1,0,Potential Threat
49836,443,16827,443,6611,2169,4442,20,123,12,8,allow,1,0,Potential Threat
49627,53,57352,53,288,110,178,2,31,1,1,allow,0,0,Normal
57370,6969,42046,6969,70,70,0,2,8,2,0,allow,1,0,Potential Threat
49531,53,3594,53,182,93,89,2,31,1,1,allow,0,0,Normal
55024,53,59987,53,179,94,85,2,30,1,1,allow,0,0,Normal
53750,25174,0,0,66,66,0,1,0,1,0,deny,0,1,Known Attack
61733,445,0,0,70,70,0,1,0,1,0,drop,0,1,Known Attack
56640,445,0,0,70,70,0,1,0,1,0,drop,0,1,Known Attack
56595,445,0,0,66,66,0,1,0,1,0,drop,0,1,Known Attack
62829,445,0,0,66,66,0,1,0,1,0,drop,0,1,Known Attack
52281,161,0,0,550,550,0,6,35,6,0,allow,1,0,Potential Threat
55728,445,0,0,70,70,0,1,0,1,0,drop,0,1,Known Attack
57470,22646,6893,22646,353,166,187,2,1200,1,1,allow,1,0,Potential Threat
49493,445,0,0,70,70,0,1,0,1,0,drop,0,1,Known Attack
43560,443,3098,443,8964,2125,6839,34,120,18,16,allow,1,0,Potential Threat
64991,53,4692,53,779,86,693,2,30,1,1,allow,0,0,Normal
57186,53,42967,53,177,94,83,2,30,1,1,allow,0,0,Normal
57985,443,21475,443,140109,5229,134880,159,46,59,100,allow,1,0,Potential Threat
34203,443,27925,443,33068,2556,30512,48,81,21,27,allow,1,0,Potential Threat
63050,57470,0,0,74,74,0,1,0,1,0,deny,1,1,High Risk
52159,80,40700,80,1278,731,547,10,15,6,4,allow,0,0,Normal
39890,443,25429,443,18127,8010,10117,41,116,24,17,allow,1,0,Potential Threat
52232,35126,34717,35126,70,70,0,1,5,1,0,allow,1,0,Potential Threat
55057,80,24701,80,306,180,126,6,26,4,2,allow,0,0,Normal
64303,53,3497,53,212,102,110,2,30,1,1,allow,0,0,Normal
65480,443,49360,443,310863,9840,301023,323,16,115,208,allow,1,0,Potential Threat
65118,53,14399,53,539,91,448,4,43,2,2,allow,0,0,Normal
56518,53,9121,53,177,94,83,2,30,1,1,allow,0,0,Normal
58392,445,0,0,70,70,0,1,0,1,0,drop,0,1,Known Attack
49675,53,62009,53,78,78,0,1,30,1,0,allow,1,0,Potential Threat
50927,445,0,0,70,70,0,1,0,1,0,drop,0,1,Known Attack
56356,53,2062,53,758,96,662,2,31,1,1,allow,0,0,Normal
53038,445,0,0,70,70,0,1,0,1,0,drop,0,1,Known Attack
49464,443,43565,443,4555,2472,2083,20,119,11,9,allow,1,0,Potential Threat
59828,443,59390,443,7083,2786,4297,24,81,14,10,allow,1,0,Potential Threat
58185,445,0,0,66,66,0,1,0,1,0,drop,0,1,Known Attack
51728,55504,11641,55504,316,136,180,6,6,3,3,allow,1,0,Potential Threat
43260,41615,0,0,145,145,0,1,0,1,0,deny,1,1,High Risk
50486,443,8859,443,5791,3692,2099,21,78,13,8,allow,1,0,Potential Threat
50705,445,0,0,70,70,0,1,0,1,0,drop,0,1,Known Attack
58202,445,0,0,70,70,0,1,0,1,0,drop,0,1,Known Attack
60557,23117,0,0,66,66,0,1,0,1,0,deny,0,1,Known Attack
27005,4444,11098,4444,881,126,755,2,30,1,1,allow,1,0,Potential Threat
64154,53,29072,53,188,96,92,2,30,1,1,allow,0,0,Normal
50555,445,0,0,70,70,0,1,0,1,0,drop,0,1,Known Attack
55025,80,12764,80,1142,626,516,8,180,5,3,allow,1,0,Potential Threat
56422,53,35593,53,716,95,621,2,30,1,1,allow,0,0,Normal
3456,11392,0,0,66,66,0,1,0,1,0,deny,1,1,High Risk
61208,445,0,0,66,66,0,1,0,1,0,drop,0,1,Known Attack
52734,445,0,0,70,70,0,1,0,1,0,drop,0,1,Known Attack
57074,53,27906,53,259,78,181,2,30,1,1,allow,0,0,Normal
6590,80,6590,80,326,186,140,6,29,4,2,allow,1,0,Potential Threat
49867,53,28958,53,232,110,122,2,30,1,1,allow,0,0,Normal
55379,443,27244,443,13679,7277,6402,35,262,15,20,allow,1,0,Potential Threat
48817,1024,48817,1024,152,152,0,1,1200,1,0,allow,1,0,Potential Threat
58566,445,0,0,70,70,0,1,0,1,0,drop,0,1,Known Attack
63140,30685,24929,30685,70,70,0,1,5,1,0,allow,1,0,Potential Threat
50784,52952,0,0,66,66,0,1,0,1,0,deny,0,1,Known Attack
64695,445,0,0,70,70,0,1,0,1,0,drop,0,1,Known Attack
57411,443,31872,443,214,140,74,4,15,3,1,allow,0,0,Normal
49426,53,14946,53,492,91,401,4,56,2,2,allow,0,0,Normal
58724,43890,0,0,66,66,0,1,0,1,0,deny,0,1,Known Attack
55218,443,17111,443,17915,7421,10494,39,61,21,18,allow,1,0,Potential Threat
46838,443,19080,443,10876,3774,7102,12,145,5,7,allow,1,0,Potential Threat
58363,443,44841,443,46992,4773,42219,89,160,36,53,allow,1,0,Potential Threat
57470,40870,29859,40870,535,163,372,2,1200,1,1,allow,1,0,Potential Threat
56081,53,46764,53,186,102,84,2,29,1,1,allow,0,0,Normal
57441,53,33174,53,177,94,83,2,30,1,1,allow,0,0,Normal
58638,5900,0,0,62,62,0,1,0,1,0,deny,0,1,Known Attack
45402,80,27119,80,573,499,74,6,15,5,1,allow,0,0,Normal
62257,2767,0,0,66,66,0,1,0,1,0,deny,0,1,Known Attack
52652,443,14258,443,14511,4628,9883,29,559,15,14,allow,1,0,Potential Threat
25565,38308,0,0,60,60,0,1,0,1,0,deny,1,1,High Risk
55539,53,25818,53,249,94,155,2,31,1,1,allow,0,0,Normal
49848,445,0,0,70,70,0,1,0,1,0,drop,0,1,Known Attack
58872,443,35466,443,5166,700,4466,16,15,7,9,allow,1,0,Potential Threat
59032,25174,0,0,66,66,0,1,0,1,0,deny,0,1,Known Attack
5180,80,5180,80,33443,797,32646,33,16,9,24,allow,1,0,Potential Threat
57346,53,32731,53,210,110,100,2,30,1,1,allow,0,0,Normal
37965,30982,7359,30982,528,528,0,9,1199,9,0,allow,1,0,Potential Threat
62211,445,0,0,70,70,0,1,0,1,0,drop,0,1,Known Attack
58751,9571,0,0,62,62,0,1,0,1,0,deny,0,1,Known Attack
64853,445,0,0,70,70,0,1,0,1,0,drop,0,1,Known Attack
37840,53,37840,53,216,90,126,2,30,1,1,allow,0,0,Normal
59464,443,49741,443,7333,1933,5400,27,16,15,12,allow,1,0,Potential Threat
39583,37965,0,0,66,66,0,1,0,1,0,deny,0,1,Known Attack
56200,53,9546,53,206,105,101,2,30,1,1,allow,0,0,Normal
7877,22114,0,0,66,66,0,1,0,1,0,deny,1,1,High Risk
50324,80,23988,80,1083,653,430,8,15,5,3,allow,0,0,Normal
9156,443,14551,443,5734,498,5236,14,15,7,7,allow,1,0,Potential Threat
49487,53,55528,53,183,94,89,2,30,1,1,allow,0,0,Normal
33166,53,0,0,82,82,0,2,40,2,0,allow,0,0,Normal
62485,445,0,0,70,70,0,1,0,1,0,drop,0,1,Known Attack
56524,443,14904,443,344632,9074,335558,354,121,122,232,allow,1,0,Potential Threat
54592,80,24898,80,1113,534,579,12,16,7,5,allow,0,0,Normal
52003,80,9765,80,88807,5957,82850,113,15,54,59,allow,1,0,Potential Threat
12945,53,12945,53,233,90,143,2,32,1,1,allow,0,0,Normal
50277,443,65171,443,268,120,148,5,11,3,2,allow,1,0,Potential Threat
58638,5900,0,0,62,62,0,1,0,1,0,deny,0,1,Known Attack
22539,53,19206,53,86,86,0,1,30,1,0,allow,0,0,Normal
57884,443,11734,443,7668,2540,5128,22,155,12,10,allow,1,0,Potential Threat
60045,445,0,0,66,66,0,1,0,1,0,drop,0,1,Known Attack
54588,445,0,0,70,70,0,1,0,1,0,drop,0,1,Known Attack
39622,53,25768,53,168,78,90,2,30,1,1,allow,0,0,Normal
60331,443,58220,443,1867,1228,639,18,87,11,7,allow,1,0,Potential Threat
